,f0,f1,t0,t1,dB0,dB1,dist,utime,ufreq
0,6,90,0.11609977324263039,1.9736961451247166,6.0,20.0,116,2.0,84
1,6,71,0.11609977324263039,2.716734693877551,6.0,29.0,129,3.0,65
2,6,218,0.11609977324263039,1.9272562358276644,6.0,20.0,226,2.0,212
3,6,217,0.11609977324263039,2.066575963718821,6.0,18.0,227,2.0,211
4,6,492,0.11609977324263039,1.9040362811791383,6.0,0.0,492,2.0,486
5,6,471,0.11609977324263039,2.043356009070295,6.0,3.0,472,2.0,465
6,90,120,1.9736961451247166,3.575873015873016,20.0,30.0,75,2.0,30
7,90,88,1.9736961451247166,4.133151927437642,20.0,29.0,93,2.0,2
8,90,238,1.9736961451247166,3.5526530612244898,20.0,23.0,163,2.0,148
9,90,228,1.9736961451247166,4.017052154195011,20.0,27.0,164,2.0,138
10,90,450,1.9736961451247166,3.4597732426303858,20.0,19.0,366,1.0,360
11,90,589,1.9736961451247166,3.9938321995464854,20.0,3.0,507,2.0,499
12,71,88,2.716734693877551,4.133151927437642,29.0,29.0,63,1.0,17
13,71,144,2.716734693877551,5.61922902494331,29.0,36.0,145,3.0,73
14,71,228,2.716734693877551,4.017052154195011,29.0,27.0,167,1.0,157
15,71,227,2.716734693877551,5.61922902494331,29.0,26.0,200,3.0,156
16,71,523,2.716734693877551,5.596009070294785,29.0,16.0,469,3.0,452
17,120,144,3.575873015873016,5.61922902494331,30.0,36.0,91,2.0,24
18,120,227,3.575873015873016,5.61922902494331,30.0,26.0,139,2.0,107
19,120,236,3.575873015873016,6.362267573696145,30.0,26.0,167,3.0,116
20,120,523,3.575873015873016,5.596009070294785,30.0,16.0,412,2.0,403
21,120,609,3.575873015873016,6.03718820861678,30.0,22.0,500,2.0,489
22,88,144,4.133151927437642,5.61922902494331,29.0,36.0,85,1.0,56
23,88,23,4.133151927437642,6.849886621315193,29.0,26.0,134,3.0,65
24,88,227,4.133151927437642,5.61922902494331,29.0,26.0,153,1.0,139
25,88,236,4.133151927437642,6.362267573696145,29.0,26.0,176,2.0,148
26,88,523,4.133151927437642,5.596009070294785,29.0,16.0,440,1.0,435
27,88,444,4.133151927437642,6.989206349206349,29.0,6.0,377,3.0,356
28,144,23,5.61922902494331,6.849886621315193,36.0,26.0,132,1.0,121
29,144,23,5.61922902494331,7.198185941043084,36.0,26.0,139,2.0,121
30,144,154,5.61922902494331,8.289523809523809,36.0,28.0,115,3.0,10
31,144,225,5.61922902494331,7.9412244897959186,36.0,20.0,129,2.0,81
32,144,239,5.61922902494331,8.266303854875284,36.0,19.0,148,3.0,95
33,144,444,5.61922902494331,6.989206349206349,36.0,6.0,306,1.0,300
34,144,624,5.61922902494331,7.9412244897959186,36.0,1.0,490,2.0,480
35,23,154,6.849886621315193,8.289523809523809,26.0,28.0,145,1.0,131
36,23,31,6.849886621315193,9.1718820861678,26.0,30.0,100,2.0,8
37,23,225,6.849886621315193,7.9412244897959186,26.0,20.0,207,1.0,202
38,23,239,6.849886621315193,8.266303854875284,26.0,19.0,224,1.0,216
39,23,381,6.849886621315193,9.798820861678005,26.0,20.0,380,3.0,358
40,23,433,6.849886621315193,8.846802721088435,26.0,26.0,419,2.0,410
41,23,432,6.849886621315193,9.798820861678005,26.0,21.0,428,3.0,409
42,23,154,7.198185941043084,8.289523809523809,26.0,28.0,139,1.0,131
43,23,31,7.198185941043084,9.1718820861678,26.0,30.0,85,2.0,8
44,23,239,7.198185941043084,8.266303854875284,26.0,19.0,221,1.0,216
45,23,381,7.198185941043084,9.798820861678005,26.0,20.0,375,3.0,358
46,23,237,7.198185941043084,10.100680272108844,26.0,20.0,248,3.0,214
47,23,433,7.198185941043084,8.846802721088435,26.0,26.0,416,2.0,410
48,23,432,7.198185941043084,9.798820861678005,26.0,21.0,424,3.0,409
49,154,83,8.289523809523809,10.820498866213152,28.0,23.0,130,3.0,71
50,154,381,8.289523809523809,9.798820861678005,28.0,20.0,236,2.0,227
51,154,237,8.289523809523809,10.100680272108844,28.0,20.0,114,2.0,83
52,154,432,8.289523809523809,9.798820861678005,28.0,21.0,285,2.0,278
53,154,472,8.289523809523809,10.565079365079365,28.0,22.0,333,2.0,318
54,154,636,8.289523809523809,9.798820861678005,28.0,18.0,486,2.0,482
55,154,646,8.289523809523809,10.634739229024943,28.0,18.0,502,2.0,492
56,31,83,9.1718820861678,10.820498866213152,30.0,23.0,88,2.0,52
57,31,108,9.1718820861678,11.331337868480725,30.0,30.0,121,2.0,77
58,31,218,9.1718820861678,11.331337868480725,30.0,33.0,209,2.0,187
59,31,472,9.1718820861678,10.565079365079365,30.0,22.0,445,1.0,441
60,31,464,9.1718820861678,11.331337868480725,30.0,17.0,443,2.0,433
61,83,81,10.820498866213152,12.538775510204083,23.0,25.0,74,2.0,2
62,83,246,10.820498866213152,12.561995464852608,23.0,1.0,179,2.0,163
63,108,81,11.331337868480725,12.538775510204083,30.0,25.0,59,1.0,27
64,108,64,11.331337868480725,13.931972789115646,30.0,32.0,120,3.0,44
65,108,246,11.331337868480725,12.561995464852608,30.0,1.0,148,1.0,138
66,108,237,11.331337868480725,13.955192743764172,30.0,32.0,171,3.0,129
67,108,466,11.331337868480725,13.955192743764172,30.0,12.0,375,3.0,358
68,81,64,12.538775510204083,13.931972789115646,25.0,32.0,62,1.0,17
69,81,138,12.538775510204083,14.930430839002268,25.0,35.0,118,2.0,57
70,81,237,12.538775510204083,13.955192743764172,25.0,32.0,168,1.0,156
71,81,235,12.538775510204083,14.535691609977324,25.0,34.0,176,2.0,154
72,81,242,12.538775510204083,15.371609977324264,25.0,35.0,202,3.0,161
73,81,466,12.538775510204083,13.955192743764172,25.0,12.0,390,1.0,385
74,81,429,12.538775510204083,14.97687074829932,25.0,20.0,363,2.0,348
75,81,456,12.538775510204083,15.000090702947846,25.0,20.0,390,2.0,375
76,64,81,13.931972789115646,15.000090702947846,32.0,37.0,49,1.0,17
77,64,195,13.931972789115646,16.27718820861678,32.0,26.0,165,2.0,131
78,64,242,13.931972789115646,15.371609977324264,32.0,35.0,188,1.0,178
79,64,248,13.931972789115646,16.253968253968253,32.0,31.0,209,2.0,184
80,64,429,13.931972789115646,14.97687074829932,32.0,20.0,368,1.0,365
81,64,456,13.931972789115646,15.000090702947846,32.0,20.0,395,1.0,392
82,138,195,14.930430839002268,16.27718820861678,35.0,26.0,81,1.0,57
83,138,63,14.930430839002268,17.57750566893424,35.0,33.0,136,3.0,75
84,138,248,14.930430839002268,16.253968253968253,35.0,31.0,124,1.0,110
85,138,239,14.930430839002268,17.57750566893424,35.0,34.0,152,3.0,101
86,138,600,14.930430839002268,16.137868480725626,35.0,23.0,465,1.0,462
87,138,466,14.930430839002268,17.60072562358277,35.0,15.0,348,3.0,328
88,138,623,14.930430839002268,16.114648526077097,35.0,19.0,488,1.0,485
89,81,195,15.000090702947846,16.27718820861678,37.0,26.0,127,1.0,114
90,81,63,15.000090702947846,17.57750566893424,37.0,33.0,112,3.0,18
91,81,248,15.000090702947846,16.253968253968253,37.0,31.0,176,1.0,167
92,81,239,15.000090702947846,17.57750566893424,37.0,34.0,193,3.0,158
93,81,466,15.000090702947846,17.60072562358277,37.0,15.0,401,3.0,385
94,195,63,16.27718820861678,17.57750566893424,26.0,33.0,143,1.0,132
95,195,194,16.27718820861678,18.18122448979592,26.0,31.0,82,2.0,1
96,195,239,16.27718820861678,17.57750566893424,26.0,34.0,71,1.0,44
97,195,241,16.27718820861678,18.204444444444444,26.0,34.0,95,2.0,46
98,195,466,16.27718820861678,17.60072562358277,26.0,15.0,277,1.0,271
99,195,607,16.27718820861678,18.808163265306124,26.0,20.0,426,3.0,412
100,195,623,16.27718820861678,18.808163265306124,26.0,19.0,442,3.0,428
101,63,190,17.57750566893424,19.551201814058956,33.0,32.0,153,2.0,127
102,63,237,17.57750566893424,19.574421768707484,33.0,34.0,194,2.0,174
103,194,190,18.18122448979592,19.551201814058956,31.0,32.0,59,1.0,4
104,194,195,18.18122448979592,20.735419501133787,31.0,34.0,110,3.0,1
105,194,237,18.18122448979592,19.574421768707484,31.0,34.0,74,1.0,43
106,194,247,18.18122448979592,20.735419501133787,31.0,34.0,122,3.0,53
107,194,237,18.18122448979592,21.0140589569161,31.0,35.0,129,3.0,43
108,194,613,18.18122448979592,19.969160997732427,31.0,20.0,426,2.0,419
109,194,607,18.18122448979592,20.01560090702948,31.0,21.0,420,2.0,413
110,194,626,18.18122448979592,19.969160997732427,31.0,20.0,439,2.0,432
111,194,631,18.18122448979592,19.99238095238095,31.0,21.0,444,2.0,437
112,190,195,19.551201814058956,20.735419501133787,32.0,34.0,51,1.0,5
113,190,30,19.551201814058956,21.5481179138322,32.0,31.0,182,2.0,160
114,190,70,19.551201814058956,22.151836734693877,32.0,33.0,164,3.0,120
115,190,247,19.551201814058956,20.735419501133787,32.0,34.0,76,1.0,57
116,190,237,19.551201814058956,21.0140589569161,32.0,35.0,79,1.0,47
117,190,244,19.551201814058956,22.38403628117914,32.0,27.0,133,3.0,54
118,190,456,19.551201814058956,21.199818594104308,32.0,14.0,275,2.0,266
119,190,467,19.551201814058956,22.175056689342405,32.0,7.0,299,3.0,277
120,190,679,19.551201814058956,21.24625850340136,32.0,3.0,494,2.0,489
121,195,70,20.735419501133787,22.151836734693877,34.0,33.0,139,1.0,125
122,195,63,20.735419501133787,23.45215419501134,34.0,33.0,176,3.0,132
123,195,244,20.735419501133787,22.38403628117914,34.0,27.0,86,2.0,49
124,195,233,20.735419501133787,23.359274376417233,34.0,24.0,119,3.0,38
125,195,467,20.735419501133787,22.175056689342405,34.0,7.0,279,1.0,272
126,195,430,20.735419501133787,23.38249433106576,34.0,10.0,261,3.0,235
127,195,654,20.735419501133787,22.84843537414966,34.0,1.0,468,2.0,459
128,195,657,20.735419501133787,23.38249433106576,34.0,-4.0,476,3.0,462
129,30,63,21.5481179138322,23.45215419501134,31.0,33.0,88,2.0,33
130,30,81,21.5481179138322,24.49705215419501,31.0,31.0,137,3.0,51
131,30,233,21.5481179138322,23.359274376417233,31.0,24.0,217,2.0,203
132,30,430,21.5481179138322,23.38249433106576,31.0,10.0,408,2.0,400
133,70,63,22.151836734693877,23.45215419501134,33.0,33.0,56,1.0,7
134,70,81,22.151836734693877,24.49705215419501,33.0,31.0,102,2.0,11
135,70,233,22.151836734693877,23.359274376417233,33.0,24.0,171,1.0,163
136,70,241,22.151836734693877,24.845351473922904,33.0,19.0,207,3.0,171
137,70,430,22.151836734693877,23.38249433106576,33.0,10.0,364,1.0,360
138,70,462,22.151836734693877,24.845351473922904,33.0,17.0,409,3.0,392
139,63,81,23.45215419501134,24.49705215419501,33.0,31.0,48,1.0,18
140,63,81,23.45215419501134,25.21687074829932,33.0,29.0,78,2.0,18
141,63,30,23.45215419501134,26.076009070294784,33.0,27.0,118,3.0,33
142,63,241,23.45215419501134,24.845351473922904,33.0,19.0,188,1.0,178
143,63,219,23.45215419501134,25.193650793650793,33.0,20.0,173,2.0,156
144,63,462,23.45215419501134,24.845351473922904,33.0,17.0,403,1.0,399
145,63,451,23.45215419501134,25.193650793650793,33.0,17.0,395,2.0,388
146,81,30,24.49705215419501,26.076009070294784,31.0,27.0,85,2.0,51
147,81,145,24.49705215419501,27.353106575963718,31.0,33.0,139,3.0,64
148,81,241,24.49705215419501,26.470748299319727,31.0,0.0,181,2.0,160
149,81,462,24.49705215419501,26.470748299319727,31.0,-5.0,390,2.0,381
150,81,145,25.21687074829932,27.353106575963718,29.0,33.0,112,2.0,64
151,81,241,25.21687074829932,26.470748299319727,29.0,0.0,169,1.0,160
152,81,233,25.21687074829932,27.724625850340136,29.0,35.0,186,3.0,152
153,81,462,25.21687074829932,26.470748299319727,29.0,-5.0,385,1.0,381
154,30,145,26.076009070294784,27.353106575963718,27.0,33.0,127,1.0,115
155,30,193,26.076009070294784,28.65342403628118,27.0,37.0,197,3.0,163
156,30,233,26.076009070294784,27.724625850340136,27.0,35.0,215,2.0,203
157,30,242,26.076009070294784,28.699863945578233,27.0,36.0,240,3.0,212
158,30,462,26.076009070294784,28.95528344671202,27.0,15.0,449,3.0,432
159,145,193,27.353106575963718,28.65342403628118,33.0,37.0,74,1.0,48
160,145,22,27.353106575963718,29.164263038548754,33.0,27.0,146,2.0,123
161,145,242,27.353106575963718,28.699863945578233,33.0,36.0,113,1.0,97
162,145,228,27.353106575963718,29.326802721088438,33.0,34.0,119,2.0,83
163,145,462,27.353106575963718,28.95528344671202,33.0,15.0,324,2.0,317
164,145,418,27.353106575963718,29.489342403628118,33.0,27.0,288,2.0,273
165,145,615,27.353106575963718,29.489342403628118,33.0,21.0,479,2.0,470
166,193,30,28.65342403628118,30.72,37.0,32.0,186,2.0,163
167,193,204,28.65342403628118,31.32371882086168,37.0,35.0,116,3.0,11
168,193,226,28.65342403628118,30.95219954648526,37.0,31.0,104,2.0,33
169,193,227,28.65342403628118,31.2540589569161,37.0,37.0,117,3.0,34
170,193,450,28.65342403628118,30.928979591836736,37.0,18.0,275,2.0,257
171,193,611,28.65342403628118,31.277278911564625,37.0,13.0,433,3.0,418
172,193,620,28.65342403628118,30.743219954648527,37.0,14.0,436,2.0,427
173,193,658,28.65342403628118,31.32371882086168,37.0,14.0,479,3.0,465
174,22,30,29.164263038548754,30.72,27.0,32.0,67,2.0,8
175,22,204,29.164263038548754,31.32371882086168,27.0,35.0,204,2.0,182
176,22,226,29.164263038548754,30.95219954648526,27.0,31.0,218,2.0,204
177,22,227,29.164263038548754,31.2540589569161,27.0,37.0,224,2.0,205
178,22,450,29.164263038548754,30.928979591836736,27.0,18.0,435,2.0,428
179,30,71,30.72,32.55437641723356,32.0,39.0,89,2.0,41
180,30,22,30.72,33.01877551020408,32.0,27.0,99,2.0,8
181,30,238,30.72,32.60081632653061,32.0,38.0,223,2.0,208
182,30,249,30.72,33.01877551020408,32.0,21.0,240,2.0,219
183,30,450,30.72,32.57759637188209,32.0,13.0,428,2.0,420
184,30,431,30.72,32.995555555555555,32.0,6.0,413,2.0,401
185,204,71,31.32371882086168,32.55437641723356,35.0,39.0,143,1.0,133
186,204,22,31.32371882086168,33.01877551020408,35.0,27.0,196,2.0,182
187,204,238,31.32371882086168,32.60081632653061,35.0,38.0,65,1.0,34
188,204,249,31.32371882086168,33.01877551020408,35.0,21.0,86,2.0,45
189,204,450,31.32371882086168,32.57759637188209,35.0,13.0,252,1.0,246
190,204,431,31.32371882086168,32.995555555555555,35.0,6.0,238,2.0,227
191,204,643,31.32371882086168,32.62403628117914,35.0,11.0,443,1.0,439
192,204,657,31.32371882086168,32.995555555555555,35.0,-4.0,459,2.0,453
193,71,65,32.55437641723356,34.62095238095238,39.0,29.0,89,2.0,6
194,71,73,32.55437641723356,35.50331065759637,39.0,28.0,127,3.0,2
195,71,236,32.55437641723356,34.71383219954649,39.0,35.0,189,2.0,165
196,71,236,32.55437641723356,35.131791383219955,39.0,30.0,199,3.0,165
197,71,544,32.55437641723356,34.57451247165533,39.0,13.0,481,2.0,473
198,71,445,32.55437641723356,35.41043083900227,39.0,22.0,394,3.0,374
199,22,65,33.01877551020408,34.62095238095238,27.0,29.0,81,2.0,43
200,22,73,33.01877551020408,35.50331065759637,27.0,28.0,119,2.0,51
201,22,236,33.01877551020408,34.71383219954649,27.0,35.0,226,2.0,214
202,22,236,33.01877551020408,35.131791383219955,27.0,30.0,233,2.0,214
203,22,445,33.01877551020408,35.41043083900227,27.0,22.0,435,2.0,423
204,65,81,34.62095238095238,36.52498866213152,29.0,26.0,84,2.0,16
205,65,232,34.62095238095238,36.78040816326531,29.0,28.0,191,2.0,167
206,65,467,34.62095238095238,36.57142857142857,29.0,25.0,411,2.0,402
207,73,81,35.50331065759637,36.52498866213152,28.0,26.0,45,1.0,8
208,73,80,35.50331065759637,37.964625850340134,28.0,30.0,106,2.0,7
209,73,80,35.50331065759637,37.987845804988666,28.0,32.0,107,2.0,7
210,73,232,35.50331065759637,36.78040816326531,28.0,28.0,168,1.0,159
211,73,237,35.50331065759637,37.94140589569161,28.0,31.0,195,2.0,164
212,73,232,35.50331065759637,38.05750566893424,28.0,31.0,193,3.0,159
213,73,467,35.50331065759637,36.57142857142857,28.0,25.0,397,1.0,394
214,73,508,35.50331065759637,37.94140589569161,28.0,12.0,447,2.0,435
215,81,80,36.52498866213152,37.964625850340134,26.0,30.0,62,1.0,1
216,81,80,36.52498866213152,37.987845804988666,26.0,32.0,63,1.0,1
217,81,31,36.52498866213152,39.450702947845805,26.0,31.0,136,3.0,50
218,81,237,36.52498866213152,37.94140589569161,26.0,31.0,168,1.0,156
219,81,232,36.52498866213152,38.05750566893424,26.0,31.0,165,2.0,151
220,81,508,36.52498866213152,37.94140589569161,26.0,12.0,431,1.0,427
221,81,449,36.52498866213152,38.684444444444445,26.0,14.0,380,2.0,368
222,80,31,37.964625850340134,39.450702947845805,30.0,31.0,81,1.0,49
223,80,67,37.964625850340134,40.216961451247165,30.0,27.0,98,2.0,13
224,80,242,37.964625850340134,39.7990022675737,30.0,19.0,180,2.0,162
225,80,237,37.964625850340134,40.14730158730159,30.0,24.0,183,2.0,157
226,80,468,37.964625850340134,39.891882086167804,30.0,25.0,397,2.0,388
227,80,461,37.964625850340134,39.9847619047619,30.0,16.0,391,2.0,381
228,80,31,37.987845804988666,39.450702947845805,32.0,31.0,80,1.0,49
229,80,67,37.987845804988666,40.216961451247165,32.0,27.0,97,2.0,13
230,80,242,37.987845804988666,39.7990022675737,32.0,19.0,180,2.0,162
231,80,237,37.987845804988666,40.14730158730159,32.0,24.0,182,2.0,157
232,80,468,37.987845804988666,39.891882086167804,32.0,25.0,397,2.0,388
233,80,461,37.987845804988666,39.9847619047619,32.0,16.0,391,2.0,381
234,31,30,39.450702947845805,41.05287981859411,31.0,-6.0,69,2.0,1
235,67,136,40.216961451247165,42.58539682539683,27.0,33.0,123,2.0,69
236,67,250,40.216961451247165,42.91047619047619,27.0,33.0,217,3.0,183
237,67,425,40.216961451247165,42.60861678004535,27.0,20.0,373,2.0,358
238,30,136,41.05287981859411,42.58539682539683,-6.0,33.0,125,2.0,106
239,30,189,41.05287981859411,43.444535147392294,-6.0,31.0,189,2.0,159
240,30,250,41.05287981859411,42.91047619047619,-6.0,33.0,234,2.0,220
241,30,228,41.05287981859411,43.83927437641724,-6.0,35.0,232,3.0,198
242,30,425,41.05287981859411,42.60861678004535,-6.0,20.0,401,2.0,395
243,30,432,41.05287981859411,43.444535147392294,-6.0,21.0,415,2.0,402
244,136,69,42.58539682539683,44.30367346938775,33.0,35.0,100,2.0,67
245,136,72,42.58539682539683,45.11637188208617,33.0,31.0,126,3.0,64
246,136,228,42.58539682539683,43.83927437641724,33.0,35.0,107,1.0,92
247,136,233,42.58539682539683,44.0714739229025,33.0,34.0,116,1.0,97
248,136,236,42.58539682539683,45.2324716553288,33.0,27.0,152,3.0,100
249,136,432,42.58539682539683,44.419773242630384,33.0,17.0,306,2.0,296
250,136,432,42.58539682539683,45.00027210884354,33.0,12.0,314,2.0,296
251,136,627,42.58539682539683,43.885714285714286,33.0,15.0,494,1.0,491
252,189,72,43.444535147392294,45.11637188208617,31.0,31.0,137,2.0,117
253,189,236,43.444535147392294,45.2324716553288,31.0,27.0,90,2.0,47
254,189,432,43.444535147392294,45.00027210884354,31.0,12.0,252,2.0,243
255,189,642,43.444535147392294,44.88417233560091,31.0,12.0,457,1.0,453
256,189,641,43.444535147392294,45.069931972789114,31.0,5.0,457,2.0,452
257,69,63,44.30367346938775,46.57922902494331,35.0,33.0,98,2.0,6
258,69,66,44.30367346938775,47.275827664399095,35.0,34.0,128,3.0,3
259,69,238,44.30367346938775,46.625668934240366,35.0,35.0,196,2.0,169
260,69,241,44.30367346938775,47.113287981859415,35.0,35.0,210,3.0,172
261,69,451,44.30367346938775,46.69532879818594,35.0,16.0,396,2.0,382
262,69,432,44.30367346938775,47.13650793650794,35.0,11.0,383,3.0,363
263,72,63,45.11637188208617,46.57922902494331,31.0,33.0,64,1.0,9
264,72,66,45.11637188208617,47.275827664399095,31.0,34.0,93,2.0,6
265,72,238,45.11637188208617,46.625668934240366,31.0,35.0,178,2.0,166
266,72,241,45.11637188208617,47.113287981859415,31.0,35.0,190,2.0,169
267,72,451,45.11637188208617,46.69532879818594,31.0,16.0,385,2.0,379
268,72,432,45.11637188208617,47.13650793650794,31.0,11.0,370,2.0,360
269,72,465,45.11637188208617,48.06530612244898,31.0,19.0,413,3.0,393
270,63,68,46.57922902494331,48.87800453514739,33.0,36.0,99,2.0,5
271,63,62,46.57922902494331,49.08698412698413,33.0,27.0,108,3.0,1
272,63,247,46.57922902494331,48.34394557823129,33.0,22.0,199,2.0,184
273,63,235,46.57922902494331,48.99410430839002,33.0,19.0,201,2.0,172
274,63,465,46.57922902494331,48.06530612244898,33.0,19.0,407,1.0,402
275,63,455,46.57922902494331,49.08698412698413,33.0,1.0,407,3.0,392
276,66,68,47.275827664399095,48.87800453514739,34.0,36.0,69,2.0,2
277,66,62,47.275827664399095,49.08698412698413,34.0,27.0,78,2.0,4
278,66,247,47.275827664399095,48.34394557823129,34.0,22.0,187,1.0,181
279,66,235,47.275827664399095,48.99410430839002,34.0,19.0,184,2.0,169
280,66,455,47.275827664399095,49.08698412698413,34.0,1.0,397,2.0,389
281,68,69,48.87800453514739,50.85170068027211,36.0,32.0,85,2.0,1
282,68,81,48.87800453514739,51.45541950113379,36.0,33.0,112,3.0,13
283,68,219,48.87800453514739,50.549841269841274,36.0,27.0,167,2.0,151
284,68,234,48.87800453514739,51.57151927437642,36.0,35.0,203,3.0,166
285,68,411,48.87800453514739,51.757278911564626,36.0,20.0,365,3.0,343
286,62,69,49.08698412698413,50.85170068027211,27.0,32.0,76,2.0,7
287,62,81,49.08698412698413,51.45541950113379,27.0,33.0,104,2.0,19
288,62,219,49.08698412698413,50.549841269841274,27.0,27.0,169,1.0,157
289,62,234,49.08698412698413,51.57151927437642,27.0,35.0,203,2.0,172
290,62,411,49.08698412698413,51.757278911564626,27.0,20.0,367,3.0,349
291,69,22,50.85170068027211,52.10557823129252,32.0,31.0,72,1.0,47
292,69,22,50.85170068027211,53.54521541950113,32.0,32.0,125,3.0,47
293,69,228,50.85170068027211,52.523537414965986,32.0,31.0,175,2.0,159
294,69,228,50.85170068027211,53.10403628117914,32.0,21.0,186,2.0,159
295,69,452,50.85170068027211,52.33777777777778,32.0,19.0,388,1.0,383
296,69,499,50.85170068027211,53.823854875283445,32.0,29.0,449,3.0,430
297,81,22,51.45541950113379,53.54521541950113,33.0,32.0,108,2.0,59
298,81,63,51.45541950113379,54.03283446712018,33.0,30.0,112,3.0,18
299,81,228,51.45541950113379,52.523537414965986,33.0,31.0,154,1.0,147
300,81,228,51.45541950113379,53.10403628117914,33.0,21.0,163,2.0,147
301,81,234,51.45541950113379,54.00961451247166,33.0,16.0,188,3.0,153
302,81,499,51.45541950113379,53.823854875283445,33.0,29.0,430,2.0,418
303,81,570,51.45541950113379,53.98639455782313,33.0,14.0,501,3.0,489
304,22,63,52.10557823129252,54.03283446712018,31.0,30.0,93,2.0,41
305,22,234,52.10557823129252,54.00961451247166,31.0,16.0,227,2.0,212
306,22,499,52.10557823129252,53.823854875283445,31.0,29.0,483,2.0,477
307,22,30,53.54521541950113,55.33315192743764,32.0,25.0,77,2.0,8
308,22,36,53.54521541950113,55.98331065759637,32.0,12.0,106,2.0,14
309,22,239,53.54521541950113,55.33315192743764,32.0,26.0,230,2.0,217
310,22,412,53.54521541950113,55.193832199546485,32.0,1.0,396,2.0,390
311,63,30,54.03283446712018,55.33315192743764,30.0,25.0,65,1.0,33
312,63,36,54.03283446712018,55.98331065759637,30.0,12.0,88,2.0,27
313,63,239,54.03283446712018,55.33315192743764,30.0,26.0,185,1.0,176
314,63,250,54.03283446712018,56.95854875283447,30.0,12.0,225,3.0,187
315,63,412,54.03283446712018,55.193832199546485,30.0,1.0,353,1.0,349
316,30,22,55.33315192743764,57.12108843537415,25.0,33.0,77,2.0,8
317,30,22,55.33315192743764,58.2356462585034,25.0,27.0,125,3.0,8
318,30,250,55.33315192743764,56.95854875283447,25.0,12.0,231,2.0,220
319,30,230,55.33315192743764,57.23718820861678,25.0,26.0,216,2.0,200
320,30,407,55.33315192743764,58.18920634920635,25.0,15.0,397,3.0,377
321,30,417,55.33315192743764,58.16598639455783,25.0,18.0,406,3.0,387
322,36,22,55.98331065759637,57.12108843537415,12.0,33.0,51,1.0,14
323,36,22,55.98331065759637,58.2356462585034,12.0,27.0,98,2.0,14
324,36,230,55.98331065759637,57.23718820861678,12.0,26.0,201,1.0,194
325,36,407,55.98331065759637,58.18920634920635,12.0,15.0,383,2.0,371
326,36,417,55.98331065759637,58.16598639455783,12.0,18.0,392,2.0,381
327,22,73,57.12108843537415,59.97714285714286,33.0,40.0,133,3.0,51
328,22,407,57.12108843537415,58.18920634920635,33.0,15.0,388,1.0,385
329,22,238,57.12108843537415,59.93070294784581,33.0,28.0,248,3.0,216
330,22,417,57.12108843537415,58.16598639455783,33.0,18.0,398,1.0,395
331,22,412,57.12108843537415,59.953922902494334,33.0,10.0,409,3.0,390
332,22,73,58.2356462585034,59.97714285714286,27.0,40.0,91,2.0,51
333,22,238,58.2356462585034,59.93070294784581,27.0,28.0,228,2.0,216
334,22,412,58.2356462585034,59.953922902494334,27.0,10.0,397,2.0,390
335,235,90,0.06965986394557823,1.9736961451247166,-2.0,20.0,167,2.0,145
336,235,71,0.06965986394557823,2.716734693877551,-2.0,29.0,200,3.0,164
337,235,218,0.06965986394557823,1.9272562358276644,-2.0,20.0,82,2.0,17
338,235,217,0.06965986394557823,2.066575963718821,-2.0,18.0,88,2.0,18
339,235,492,0.06965986394557823,1.9040362811791383,-2.0,0.0,269,2.0,257
340,235,471,0.06965986394557823,2.043356009070295,-2.0,3.0,251,2.0,236
341,235,618,0.06965986394557823,1.9040362811791383,-2.0,-6.0,391,2.0,383
342,235,633,0.06965986394557823,2.2523356009070294,-2.0,-5.0,409,2.0,398
343,218,120,1.9272562358276644,3.575873015873016,20.0,30.0,121,2.0,98
344,218,88,1.9272562358276644,4.133151927437642,20.0,29.0,161,2.0,130
345,218,238,1.9272562358276644,3.5526530612244898,20.0,23.0,73,2.0,20
346,218,228,1.9272562358276644,4.017052154195011,20.0,27.0,91,2.0,10
347,218,450,1.9272562358276644,3.4597732426303858,20.0,19.0,241,2.0,232
348,218,589,1.9272562358276644,3.9938321995464854,20.0,3.0,382,2.0,371
349,218,620,1.9272562358276644,3.4597732426303858,20.0,13.0,407,2.0,402
350,218,632,1.9272562358276644,4.017052154195011,20.0,3.0,424,2.0,414
351,217,120,2.066575963718821,3.575873015873016,18.0,30.0,117,2.0,97
352,217,88,2.066575963718821,4.133151927437642,18.0,29.0,157,2.0,129
353,217,238,2.066575963718821,3.5526530612244898,18.0,23.0,67,1.0,21
354,217,228,2.066575963718821,4.017052154195011,18.0,27.0,85,2.0,11
355,217,450,2.066575963718821,3.4597732426303858,18.0,19.0,241,1.0,233
356,217,589,2.066575963718821,3.9938321995464854,18.0,3.0,381,2.0,372
357,217,620,2.066575963718821,3.4597732426303858,18.0,13.0,407,1.0,403
358,217,632,2.066575963718821,4.017052154195011,18.0,3.0,423,2.0,415
359,238,144,3.5526530612244898,5.61922902494331,23.0,36.0,129,2.0,94
360,238,227,3.5526530612244898,5.61922902494331,23.0,26.0,90,2.0,11
361,238,236,3.5526530612244898,6.362267573696145,23.0,26.0,121,3.0,2
362,238,523,3.5526530612244898,5.596009070294785,23.0,16.0,298,2.0,285
363,238,609,3.5526530612244898,6.03718820861678,23.0,22.0,386,2.0,371
364,238,626,3.5526530612244898,5.61922902494331,23.0,9.0,398,2.0,388
365,238,621,3.5526530612244898,6.060408163265306,23.0,20.0,398,3.0,383
366,228,144,4.017052154195011,5.61922902494331,27.0,36.0,109,2.0,84
367,228,23,4.017052154195011,6.849886621315193,27.0,26.0,239,3.0,205
368,228,227,4.017052154195011,5.61922902494331,27.0,26.0,69,2.0,1
369,228,236,4.017052154195011,6.362267573696145,27.0,26.0,101,2.0,8
370,228,523,4.017052154195011,5.596009070294785,27.0,16.0,303,2.0,295
371,228,609,4.017052154195011,6.03718820861678,27.0,22.0,391,2.0,381
372,228,444,4.017052154195011,6.989206349206349,27.0,6.0,251,3.0,216
373,228,626,4.017052154195011,5.61922902494331,27.0,9.0,404,2.0,398
374,228,621,4.017052154195011,6.060408163265306,27.0,20.0,403,2.0,393
375,227,23,5.61922902494331,6.849886621315193,26.0,26.0,211,1.0,204
376,227,23,5.61922902494331,7.198185941043084,26.0,26.0,215,2.0,204
377,227,154,5.61922902494331,8.289523809523809,26.0,28.0,136,3.0,73
378,227,225,5.61922902494331,7.9412244897959186,26.0,20.0,100,2.0,2
379,227,239,5.61922902494331,8.266303854875284,26.0,19.0,115,3.0,12
380,227,444,5.61922902494331,6.989206349206349,26.0,6.0,225,1.0,217
381,227,624,5.61922902494331,7.9412244897959186,26.0,1.0,409,2.0,397
382,236,154,6.362267573696145,8.289523809523809,26.0,28.0,117,2.0,82
383,236,31,6.362267573696145,9.1718820861678,26.0,30.0,238,3.0,205
384,236,225,6.362267573696145,7.9412244897959186,26.0,20.0,69,2.0,11
385,236,239,6.362267573696145,8.266303854875284,26.0,19.0,82,2.0,3
386,236,433,6.362267573696145,8.846802721088435,26.0,26.0,224,2.0,197
387,236,624,6.362267573696145,7.9412244897959186,26.0,1.0,394,2.0,388
388,236,621,6.362267573696145,8.846802721088435,26.0,15.0,400,2.0,385
389,225,31,7.9412244897959186,9.1718820861678,20.0,30.0,201,1.0,194
390,225,83,7.9412244897959186,10.820498866213152,20.0,23.0,189,3.0,142
391,225,381,7.9412244897959186,9.798820861678005,20.0,20.0,175,2.0,156
392,225,237,7.9412244897959186,10.100680272108844,20.0,20.0,94,2.0,12
393,225,432,7.9412244897959186,9.798820861678005,20.0,21.0,222,2.0,207
394,225,472,7.9412244897959186,10.565079365079365,20.0,22.0,272,3.0,247
395,225,636,7.9412244897959186,9.798820861678005,20.0,18.0,419,2.0,411
396,225,646,7.9412244897959186,10.634739229024943,20.0,18.0,437,3.0,421
397,239,83,8.266303854875284,10.820498866213152,19.0,23.0,191,3.0,156
398,239,381,8.266303854875284,9.798820861678005,19.0,20.0,157,2.0,142
399,239,237,8.266303854875284,10.100680272108844,19.0,20.0,79,2.0,2
400,239,432,8.266303854875284,9.798820861678005,19.0,21.0,204,2.0,193
401,239,472,8.266303854875284,10.565079365079365,19.0,22.0,253,2.0,233
402,239,636,8.266303854875284,9.798820861678005,19.0,18.0,402,2.0,397
403,239,646,8.266303854875284,10.634739229024943,19.0,18.0,420,2.0,407
404,381,83,9.798820861678005,10.820498866213152,20.0,23.0,301,1.0,298
405,381,108,9.798820861678005,11.331337868480725,20.0,30.0,281,2.0,273
406,381,81,9.798820861678005,12.538775510204083,20.0,25.0,322,3.0,300
407,381,218,9.798820861678005,11.331337868480725,20.0,33.0,176,2.0,163
408,381,246,9.798820861678005,12.561995464852608,20.0,1.0,180,3.0,135
409,381,464,9.798820861678005,11.331337868480725,20.0,17.0,106,2.0,83
410,381,619,9.798820861678005,11.331337868480725,20.0,7.0,247,2.0,238
411,237,108,10.100680272108844,11.331337868480725,20.0,30.0,139,1.0,129
412,237,81,10.100680272108844,12.538775510204083,20.0,25.0,188,2.0,156
413,237,218,10.100680272108844,11.331337868480725,20.0,33.0,56,1.0,19
414,237,246,10.100680272108844,12.561995464852608,20.0,1.0,106,2.0,9
415,237,464,10.100680272108844,11.331337868480725,20.0,17.0,233,1.0,227
416,237,619,10.100680272108844,11.331337868480725,20.0,7.0,386,1.0,382
417,218,81,11.331337868480725,12.538775510204083,33.0,25.0,147,1.0,137
418,218,64,11.331337868480725,13.931972789115646,33.0,32.0,190,3.0,154
419,218,246,11.331337868480725,12.561995464852608,33.0,1.0,60,1.0,28
420,218,237,11.331337868480725,13.955192743764172,33.0,32.0,115,3.0,19
421,218,466,11.331337868480725,13.955192743764172,33.0,12.0,273,3.0,248
422,218,632,11.331337868480725,13.955192743764172,33.0,9.0,429,3.0,414
423,218,645,11.331337868480725,14.071292517006803,33.0,13.0,443,3.0,427
424,246,64,12.561995464852608,13.931972789115646,1.0,32.0,191,1.0,182
425,246,138,12.561995464852608,14.930430839002268,1.0,35.0,149,2.0,108
426,246,81,12.561995464852608,15.000090702947846,1.0,37.0,196,2.0,165
427,246,237,12.561995464852608,13.955192743764172,1.0,32.0,61,1.0,9
428,246,235,12.561995464852608,14.535691609977324,1.0,34.0,86,2.0,11
429,246,242,12.561995464852608,15.371609977324264,1.0,35.0,121,3.0,4
430,246,466,12.561995464852608,13.955192743764172,1.0,12.0,228,1.0,220
431,246,429,12.561995464852608,14.97687074829932,1.0,20.0,210,2.0,183
432,246,456,12.561995464852608,15.000090702947846,1.0,20.0,235,2.0,210
433,246,632,12.561995464852608,13.955192743764172,1.0,9.0,391,1.0,386
434,246,645,12.561995464852608,14.071292517006803,1.0,13.0,404,2.0,399
435,246,643,12.561995464852608,15.000090702947846,1.0,13.0,411,2.0,397
436,237,81,13.955192743764172,15.000090702947846,32.0,37.0,162,1.0,156
437,237,195,13.955192743764172,16.27718820861678,32.0,26.0,108,2.0,42
438,237,242,13.955192743764172,15.371609977324264,32.0,35.0,61,1.0,5
439,237,248,13.955192743764172,16.253968253968253,32.0,31.0,100,2.0,11
440,237,429,13.955192743764172,14.97687074829932,32.0,20.0,197,1.0,192
441,237,456,13.955192743764172,15.000090702947846,32.0,20.0,224,1.0,219
442,237,600,13.955192743764172,16.137868480725626,32.0,23.0,375,2.0,363
443,237,643,13.955192743764172,15.000090702947846,32.0,13.0,408,1.0,406
444,237,623,13.955192743764172,16.114648526077097,32.0,19.0,397,2.0,386
445,235,195,14.535691609977324,16.27718820861678,34.0,26.0,85,2.0,40
446,235,248,14.535691609977324,16.253968253968253,34.0,31.0,75,2.0,13
447,235,600,14.535691609977324,16.137868480725626,34.0,23.0,371,2.0,365
448,235,623,14.535691609977324,16.114648526077097,34.0,19.0,394,2.0,388
449,242,63,15.371609977324264,17.57750566893424,35.0,33.0,203,2.0,179
450,242,194,15.371609977324264,18.18122448979592,35.0,31.0,130,3.0,48
451,242,239,15.371609977324264,17.57750566893424,35.0,34.0,95,2.0,3
452,242,241,15.371609977324264,18.204444444444444,35.0,34.0,122,3.0,1
453,242,466,15.371609977324264,17.60072562358277,35.0,15.0,244,2.0,224
454,242,695,15.371609977324264,17.57750566893424,35.0,8.0,463,2.0,453
455,248,63,16.253968253968253,17.57750566893424,31.0,33.0,194,1.0,185
456,248,194,16.253968253968253,18.18122448979592,31.0,31.0,99,2.0,54
457,248,239,16.253968253968253,17.57750566893424,31.0,34.0,58,1.0,9
458,248,241,16.253968253968253,18.204444444444444,31.0,34.0,84,2.0,7
459,248,466,16.253968253968253,17.60072562358277,31.0,15.0,226,1.0,218
460,248,607,16.253968253968253,18.808163265306124,31.0,20.0,375,3.0,359
461,248,695,16.253968253968253,17.57750566893424,31.0,8.0,451,1.0,447
462,248,623,16.253968253968253,18.808163265306124,31.0,19.0,391,3.0,375
463,239,190,17.57750566893424,19.551201814058956,34.0,32.0,98,2.0,49
464,239,237,17.57750566893424,19.574421768707484,34.0,34.0,86,2.0,2
465,239,607,17.57750566893424,18.808163265306124,34.0,20.0,372,1.0,368
466,239,613,17.57750566893424,19.969160997732427,34.0,20.0,388,2.0,374
467,239,607,17.57750566893424,20.01560090702948,34.0,21.0,383,2.0,368
468,239,623,17.57750566893424,18.808163265306124,34.0,19.0,388,1.0,384
469,239,626,17.57750566893424,19.969160997732427,34.0,20.0,400,2.0,387
470,239,631,17.57750566893424,19.99238095238095,34.0,21.0,406,2.0,392
471,241,190,18.204444444444444,19.551201814058956,34.0,32.0,77,1.0,51
472,241,195,18.204444444444444,20.735419501133787,34.0,34.0,118,3.0,46
473,241,237,18.204444444444444,19.574421768707484,34.0,34.0,59,1.0,4
474,241,247,18.204444444444444,20.735419501133787,34.0,34.0,109,3.0,6
475,241,237,18.204444444444444,21.0140589569161,34.0,35.0,121,3.0,4
476,241,613,18.204444444444444,19.969160997732427,34.0,20.0,380,2.0,372
477,241,607,18.204444444444444,20.01560090702948,34.0,21.0,374,2.0,366
478,241,626,18.204444444444444,19.969160997732427,34.0,20.0,392,2.0,385
479,241,631,18.204444444444444,19.99238095238095,34.0,21.0,398,2.0,390
480,237,195,19.574421768707484,20.735419501133787,34.0,34.0,65,1.0,42
481,237,30,19.574421768707484,21.5481179138322,34.0,31.0,224,2.0,207
482,237,70,19.574421768707484,22.151836734693877,34.0,33.0,201,3.0,167
483,237,247,19.574421768707484,20.735419501133787,34.0,34.0,51,1.0,10
484,237,244,19.574421768707484,22.38403628117914,34.0,27.0,121,3.0,7
485,237,456,19.574421768707484,21.199818594104308,34.0,14.0,230,2.0,219
486,237,467,19.574421768707484,22.175056689342405,34.0,7.0,256,3.0,230
487,237,679,19.574421768707484,21.24625850340136,34.0,3.0,448,2.0,442
488,247,70,20.735419501133787,22.151836734693877,34.0,33.0,187,1.0,177
489,247,63,20.735419501133787,23.45215419501134,34.0,33.0,218,3.0,184
490,247,244,20.735419501133787,22.38403628117914,34.0,27.0,71,2.0,3
491,247,233,20.735419501133787,23.359274376417233,34.0,24.0,114,3.0,14
492,247,467,20.735419501133787,22.175056689342405,34.0,7.0,229,1.0,220
493,247,430,20.735419501133787,23.38249433106576,34.0,10.0,216,3.0,183
494,247,654,20.735419501133787,22.84843537414966,34.0,1.0,417,2.0,407
495,247,657,20.735419501133787,23.38249433106576,34.0,-4.0,426,3.0,410
496,237,70,21.0140589569161,22.151836734693877,35.0,33.0,174,1.0,167
497,237,63,21.0140589569161,23.45215419501134,35.0,33.0,203,2.0,174
498,237,244,21.0140589569161,22.38403628117914,35.0,27.0,59,1.0,7
499,237,233,21.0140589569161,23.359274376417233,35.0,24.0,101,2.0,4
500,237,467,21.0140589569161,22.175056689342405,35.0,7.0,235,1.0,230
501,237,430,21.0140589569161,23.38249433106576,35.0,10.0,218,2.0,193
502,237,654,21.0140589569161,22.84843537414966,35.0,1.0,424,2.0,417
503,237,657,21.0140589569161,23.38249433106576,35.0,-4.0,432,2.0,420
504,244,63,22.38403628117914,23.45215419501134,27.0,33.0,187,1.0,181
505,244,81,22.38403628117914,24.49705215419501,27.0,31.0,187,2.0,163
506,244,81,22.38403628117914,25.21687074829932,27.0,29.0,204,3.0,163
507,244,241,22.38403628117914,24.845351473922904,27.0,19.0,106,2.0,3
508,244,219,22.38403628117914,25.193650793650793,27.0,20.0,124,3.0,25
509,244,462,22.38403628117914,24.845351473922904,27.0,17.0,242,2.0,218
510,244,451,22.38403628117914,25.193650793650793,27.0,17.0,240,3.0,207
511,244,620,22.38403628117914,25.193650793650793,27.0,9.0,395,3.0,376
512,233,81,23.359274376417233,24.49705215419501,24.0,31.0,160,1.0,152
513,233,81,23.359274376417233,25.21687074829932,24.0,29.0,172,2.0,152
514,233,30,23.359274376417233,26.076009070294784,24.0,27.0,234,3.0,203
515,233,241,23.359274376417233,24.845351473922904,24.0,19.0,64,1.0,8
516,233,219,23.359274376417233,25.193650793650793,24.0,20.0,80,2.0,14
517,233,462,23.359274376417233,24.845351473922904,24.0,17.0,238,1.0,229
518,233,451,23.359274376417233,25.193650793650793,24.0,17.0,232,2.0,218
519,233,620,23.359274376417233,25.193650793650793,24.0,9.0,395,2.0,387
520,241,30,24.845351473922904,26.076009070294784,19.0,27.0,218,1.0,211
521,241,145,24.845351473922904,27.353106575963718,19.0,33.0,144,3.0,96
522,241,233,24.845351473922904,27.724625850340136,19.0,35.0,124,3.0,8
523,241,462,24.845351473922904,26.470748299319727,19.0,-5.0,232,2.0,221
524,241,603,24.845351473922904,27.608526077097505,19.0,14.0,381,3.0,362
525,241,618,24.845351473922904,27.538866213151927,19.0,15.0,394,3.0,377
526,219,145,25.193650793650793,27.353106575963718,20.0,33.0,119,2.0,74
527,219,241,25.193650793650793,26.470748299319727,20.0,0.0,59,1.0,22
528,219,233,25.193650793650793,27.724625850340136,20.0,35.0,110,3.0,14
529,219,462,25.193650793650793,26.470748299319727,20.0,-5.0,249,1.0,243
530,219,603,25.193650793650793,27.608526077097505,20.0,14.0,398,2.0,384
531,219,618,25.193650793650793,27.538866213151927,20.0,15.0,412,2.0,399
532,241,193,26.470748299319727,28.65342403628118,0.0,37.0,106,2.0,48
533,241,22,26.470748299319727,29.164263038548754,0.0,27.0,248,3.0,219
534,241,233,26.470748299319727,27.724625850340136,0.0,35.0,55,1.0,8
535,241,242,26.470748299319727,28.699863945578233,0.0,36.0,96,2.0,1
536,241,228,26.470748299319727,29.326802721088438,0.0,34.0,124,3.0,13
537,241,603,26.470748299319727,27.608526077097505,0.0,14.0,365,1.0,362
538,241,462,26.470748299319727,28.95528344671202,0.0,15.0,246,2.0,221
539,241,618,26.470748299319727,27.538866213151927,0.0,15.0,380,1.0,377
540,241,654,26.470748299319727,28.699863945578233,0.0,13.0,424,2.0,413
541,233,22,27.724625850340136,29.164263038548754,35.0,27.0,220,1.0,211
542,233,228,27.724625850340136,29.326802721088438,35.0,34.0,69,2.0,5
543,233,462,27.724625850340136,28.95528344671202,35.0,15.0,235,1.0,229
544,233,418,27.724625850340136,29.489342403628118,35.0,27.0,200,2.0,185
545,233,615,27.724625850340136,29.489342403628118,35.0,21.0,389,2.0,382
546,242,30,28.699863945578233,30.72,36.0,32.0,229,2.0,212
547,242,204,28.699863945578233,31.32371882086168,36.0,35.0,119,3.0,38
548,242,226,28.699863945578233,30.95219954648526,36.0,31.0,98,2.0,16
549,242,227,28.699863945578233,31.2540589569161,36.0,37.0,111,3.0,15
550,242,450,28.699863945578233,30.928979591836736,36.0,18.0,229,2.0,208
551,242,611,28.699863945578233,31.277278911564625,36.0,13.0,385,3.0,369
552,242,620,28.699863945578233,30.743219954648527,36.0,14.0,388,2.0,378
553,242,658,28.699863945578233,31.32371882086168,36.0,14.0,431,3.0,416
554,228,30,29.326802721088438,30.72,34.0,32.0,207,1.0,198
555,228,204,29.326802721088438,31.32371882086168,34.0,35.0,89,2.0,24
556,228,226,29.326802721088438,30.95219954648526,34.0,31.0,70,2.0,2
557,228,227,29.326802721088438,31.2540589569161,34.0,37.0,83,2.0,1
558,228,450,29.326802721088438,30.928979591836736,34.0,18.0,232,2.0,222
559,228,611,29.326802721088438,31.277278911564625,34.0,13.0,392,2.0,383
560,228,620,29.326802721088438,30.743219954648527,34.0,14.0,397,1.0,392
561,228,658,29.326802721088438,31.32371882086168,34.0,14.0,439,2.0,430
562,226,71,30.95219954648526,32.55437641723356,31.0,39.0,170,2.0,155
563,226,22,30.95219954648526,33.01877551020408,31.0,27.0,223,2.0,204
564,226,238,30.95219954648526,32.60081632653061,31.0,38.0,72,2.0,12
565,226,249,30.95219954648526,33.01877551020408,31.0,21.0,92,2.0,23
566,226,450,30.95219954648526,32.57759637188209,31.0,13.0,235,2.0,224
567,226,431,30.95219954648526,32.995555555555555,31.0,6.0,223,2.0,205
568,226,643,30.95219954648526,32.62403628117914,31.0,11.0,423,2.0,417
569,226,657,30.95219954648526,32.995555555555555,31.0,-4.0,440,2.0,431
570,227,71,31.2540589569161,32.55437641723356,37.0,39.0,166,1.0,156
571,227,22,31.2540589569161,33.01877551020408,37.0,27.0,219,2.0,205
572,227,238,31.2540589569161,32.60081632653061,37.0,38.0,59,1.0,11
573,227,249,31.2540589569161,33.01877551020408,37.0,21.0,79,2.0,22
574,227,450,31.2540589569161,32.57759637188209,37.0,13.0,230,1.0,223
575,227,431,31.2540589569161,32.995555555555555,37.0,6.0,217,2.0,204
576,227,643,31.2540589569161,32.62403628117914,37.0,11.0,420,1.0,416
577,227,657,31.2540589569161,32.995555555555555,37.0,-4.0,436,2.0,430
578,238,65,32.60081632653061,34.62095238095238,38.0,29.0,194,2.0,173
579,238,73,32.60081632653061,35.50331065759637,38.0,28.0,207,3.0,165
580,238,236,32.60081632653061,34.71383219954649,38.0,35.0,91,2.0,2
581,238,236,32.60081632653061,35.131791383219955,38.0,30.0,109,3.0,2
582,238,544,32.60081632653061,34.57451247165533,38.0,13.0,318,2.0,306
583,238,445,32.60081632653061,35.41043083900227,38.0,22.0,240,3.0,207
584,238,635,32.60081632653061,34.59773242630386,38.0,10.0,406,2.0,397
585,238,622,32.60081632653061,35.41043083900227,38.0,20.0,403,3.0,384
586,249,65,33.01877551020408,34.62095238095238,21.0,29.0,197,2.0,184
587,249,73,33.01877551020408,35.50331065759637,21.0,28.0,206,2.0,176
588,249,236,33.01877551020408,34.71383219954649,21.0,35.0,74,2.0,13
589,249,236,33.01877551020408,35.131791383219955,21.0,30.0,92,2.0,13
590,249,544,33.01877551020408,34.57451247165533,21.0,13.0,303,2.0,295
591,249,445,33.01877551020408,35.41043083900227,21.0,22.0,221,2.0,196
592,249,635,33.01877551020408,34.59773242630386,21.0,10.0,392,2.0,386
593,249,622,33.01877551020408,35.41043083900227,21.0,20.0,387,2.0,373
594,236,81,34.71383219954649,36.52498866213152,35.0,26.0,174,2.0,155
595,236,232,34.71383219954649,36.78040816326531,35.0,28.0,89,2.0,4
596,236,467,34.71383219954649,36.57142857142857,35.0,25.0,244,2.0,231
597,236,625,34.71383219954649,36.5946485260771,35.0,19.0,397,2.0,389
598,236,81,35.131791383219955,36.52498866213152,30.0,26.0,166,1.0,155
599,236,80,35.131791383219955,37.964625850340134,30.0,30.0,198,3.0,156
600,236,80,35.131791383219955,37.987845804988666,30.0,32.0,199,3.0,156
601,236,232,35.131791383219955,36.78040816326531,30.0,28.0,71,2.0,4
602,236,237,35.131791383219955,37.94140589569161,30.0,31.0,121,3.0,1
603,236,232,35.131791383219955,38.05750566893424,30.0,31.0,126,3.0,4
604,236,467,35.131791383219955,36.57142857142857,30.0,25.0,239,1.0,231
605,236,508,35.131791383219955,37.94140589569161,30.0,12.0,298,3.0,272
606,236,625,35.131791383219955,36.5946485260771,30.0,19.0,394,1.0,389
607,236,636,35.131791383219955,37.94140589569161,30.0,-5.0,418,3.0,400
608,232,80,36.78040816326531,37.964625850340134,28.0,30.0,160,1.0,152
609,232,80,36.78040816326531,37.987845804988666,28.0,32.0,161,1.0,152
610,232,31,36.78040816326531,39.450702947845805,28.0,31.0,232,3.0,201
611,232,237,36.78040816326531,37.94140589569161,28.0,31.0,50,1.0,5
612,232,508,36.78040816326531,37.94140589569161,28.0,12.0,280,1.0,276
613,232,449,36.78040816326531,38.684444444444445,28.0,14.0,232,2.0,217
614,232,636,36.78040816326531,37.94140589569161,28.0,-5.0,407,1.0,404
615,232,632,36.78040816326531,38.684444444444445,28.0,11.0,408,2.0,400
616,237,31,37.94140589569161,39.450702947845805,31.0,31.0,216,2.0,206
617,237,67,37.94140589569161,40.216961451247165,31.0,27.0,196,2.0,170
618,237,242,37.94140589569161,39.7990022675737,31.0,19.0,80,2.0,5
619,237,468,37.94140589569161,39.891882086167804,31.0,25.0,246,2.0,231
620,237,461,37.94140589569161,39.9847619047619,31.0,16.0,241,2.0,224
621,237,631,37.94140589569161,39.86866213151927,31.0,25.0,403,2.0,394
622,237,625,37.94140589569161,39.9847619047619,31.0,14.0,398,2.0,388
623,232,31,38.05750566893424,39.450702947845805,31.0,31.0,210,1.0,201
624,232,67,38.05750566893424,40.216961451247165,31.0,27.0,189,2.0,165
625,232,242,38.05750566893424,39.7990022675737,31.0,19.0,76,2.0,10
626,232,237,38.05750566893424,40.14730158730159,31.0,24.0,90,2.0,5
627,232,468,38.05750566893424,39.891882086167804,31.0,25.0,249,2.0,236
628,232,461,38.05750566893424,39.9847619047619,31.0,16.0,244,2.0,229
629,232,631,38.05750566893424,39.86866213151927,31.0,25.0,407,2.0,399
630,232,625,38.05750566893424,39.9847619047619,31.0,14.0,402,2.0,393
631,242,30,39.7990022675737,41.05287981859411,19.0,-6.0,219,1.0,212
632,242,136,39.7990022675737,42.58539682539683,19.0,33.0,160,3.0,106
633,242,425,39.7990022675737,42.60861678004535,19.0,20.0,219,3.0,183
634,237,136,40.14730158730159,42.58539682539683,24.0,33.0,146,2.0,101
635,237,250,40.14730158730159,42.91047619047619,24.0,33.0,120,3.0,13
636,237,425,40.14730158730159,42.60861678004535,24.0,20.0,216,2.0,188
637,237,693,40.14730158730159,42.93369614512472,24.0,11.0,472,3.0,456
638,250,69,42.91047619047619,44.30367346938775,33.0,35.0,191,1.0,181
639,250,72,42.91047619047619,45.11637188208617,33.0,31.0,202,2.0,178
640,250,233,42.91047619047619,44.0714739229025,33.0,34.0,53,1.0,17
641,250,236,42.91047619047619,45.2324716553288,33.0,27.0,101,2.0,14
642,250,432,42.91047619047619,44.419773242630384,33.0,17.0,193,2.0,182
643,250,432,42.91047619047619,45.00027210884354,33.0,12.0,203,2.0,182
644,250,642,42.91047619047619,44.88417233560091,33.0,12.0,401,2.0,392
645,250,641,42.91047619047619,45.069931972789114,33.0,5.0,402,2.0,391
646,228,72,43.83927437641724,45.11637188208617,35.0,31.0,165,1.0,156
647,228,63,43.83927437641724,46.57922902494331,35.0,33.0,203,3.0,165
648,228,236,43.83927437641724,45.2324716553288,35.0,27.0,61,1.0,8
649,228,238,43.83927437641724,46.625668934240366,35.0,35.0,120,3.0,10
650,228,432,43.83927437641724,45.00027210884354,35.0,12.0,210,1.0,204
651,228,451,43.83927437641724,46.69532879818594,35.0,16.0,255,3.0,223
652,228,642,43.83927437641724,44.88417233560091,35.0,12.0,416,1.0,414
653,228,641,43.83927437641724,45.069931972789114,35.0,5.0,416,1.0,413
654,228,640,43.83927437641724,46.556009070294785,35.0,13.0,428,3.0,412
655,233,72,44.0714739229025,45.11637188208617,34.0,31.0,167,1.0,161
656,233,63,44.0714739229025,46.57922902494331,34.0,33.0,201,3.0,170
657,233,236,44.0714739229025,45.2324716553288,34.0,27.0,50,1.0,3
658,233,238,44.0714739229025,46.625668934240366,34.0,35.0,110,3.0,5
659,233,451,44.0714739229025,46.69532879818594,34.0,16.0,246,3.0,218
660,233,640,44.0714739229025,46.556009070294785,34.0,13.0,421,2.0,407
661,236,63,45.2324716553288,46.57922902494331,27.0,33.0,182,1.0,173
662,236,66,45.2324716553288,47.275827664399095,27.0,34.0,191,2.0,170
663,236,238,45.2324716553288,46.625668934240366,27.0,35.0,60,1.0,2
664,236,241,45.2324716553288,47.113287981859415,27.0,35.0,81,2.0,5
665,236,451,45.2324716553288,46.69532879818594,27.0,16.0,224,1.0,215
666,236,432,45.2324716553288,47.13650793650794,27.0,11.0,212,2.0,196
667,236,465,45.2324716553288,48.06530612244898,27.0,19.0,259,3.0,229
668,236,640,45.2324716553288,46.556009070294785,27.0,13.0,408,1.0,404
669,236,649,45.2324716553288,47.113287981859415,27.0,-0.0,421,2.0,413
670,236,644,45.2324716553288,48.11174603174603,27.0,16.0,426,3.0,408
671,238,68,46.625668934240366,48.87800453514739,35.0,36.0,196,2.0,170
672,238,62,46.625668934240366,49.08698412698413,35.0,27.0,205,2.0,176
673,238,247,46.625668934240366,48.34394557823129,35.0,22.0,75,2.0,9
674,238,235,46.625668934240366,48.99410430839002,35.0,19.0,102,2.0,3
675,238,465,46.625668934240366,48.06530612244898,35.0,19.0,235,1.0,227
676,238,455,46.625668934240366,49.08698412698413,35.0,1.0,242,2.0,217
677,238,644,46.625668934240366,48.11174603174603,35.0,16.0,411,1.0,406
678,241,68,47.113287981859415,48.87800453514739,35.0,36.0,189,2.0,173
679,241,62,47.113287981859415,49.08698412698413,35.0,27.0,198,2.0,179
680,241,247,47.113287981859415,48.34394557823129,35.0,22.0,53,1.0,6
681,241,235,47.113287981859415,48.99410430839002,35.0,19.0,81,2.0,6
682,241,455,47.113287981859415,49.08698412698413,35.0,1.0,230,2.0,214
683,247,69,48.34394557823129,50.85170068027211,22.0,32.0,208,3.0,178
684,247,219,48.34394557823129,50.549841269841274,22.0,27.0,99,2.0,28
685,247,610,48.34394557823129,50.665941043083905,22.0,24.0,377,2.0,363
686,247,622,48.34394557823129,50.665941043083905,22.0,24.0,388,2.0,375
687,235,69,48.99410430839002,50.85170068027211,19.0,32.0,184,2.0,166
688,235,81,48.99410430839002,51.45541950113379,19.0,33.0,187,2.0,154
689,235,219,48.99410430839002,50.549841269841274,19.0,27.0,69,2.0,16
690,235,234,48.99410430839002,51.57151927437642,19.0,35.0,111,3.0,1
691,235,610,48.99410430839002,50.665941043083905,19.0,24.0,382,2.0,375
692,235,411,48.99410430839002,51.757278911564626,19.0,20.0,212,3.0,176
693,235,622,48.99410430839002,50.665941043083905,19.0,24.0,394,2.0,387
694,235,643,48.99410430839002,51.478639455782314,19.0,20.0,422,2.0,408
695,219,22,50.549841269841274,52.10557823129252,27.0,31.0,208,2.0,197
696,219,234,50.549841269841274,51.57151927437642,27.0,35.0,46,1.0,15
697,219,228,50.549841269841274,52.523537414965986,27.0,31.0,85,2.0,9
698,219,228,50.549841269841274,53.10403628117914,27.0,21.0,110,3.0,9
699,219,411,50.549841269841274,51.757278911564626,27.0,20.0,199,1.0,192
700,219,452,50.549841269841274,52.33777777777778,27.0,19.0,245,2.0,233
701,219,645,50.549841269841274,52.33777777777778,27.0,12.0,433,2.0,426
702,234,22,51.57151927437642,53.54521541950113,35.0,32.0,228,2.0,212
703,234,63,51.57151927437642,54.03283446712018,35.0,30.0,201,2.0,171
704,234,228,51.57151927437642,53.10403628117914,35.0,21.0,66,2.0,6
705,234,499,51.57151927437642,53.823854875283445,35.0,29.0,282,2.0,265
706,234,570,51.57151927437642,53.98639455782313,35.0,14.0,352,2.0,336
707,234,625,51.57151927437642,53.80063492063492,35.0,25.0,403,2.0,391
708,234,635,51.57151927437642,53.98639455782313,35.0,10.0,414,2.0,401
709,228,22,52.523537414965986,53.54521541950113,31.0,32.0,211,1.0,206
710,228,63,52.523537414965986,54.03283446712018,31.0,30.0,177,2.0,165
711,228,30,52.523537414965986,55.33315192743764,31.0,25.0,232,3.0,198
712,228,234,52.523537414965986,54.00961451247166,31.0,16.0,64,1.0,6
713,228,239,52.523537414965986,55.33315192743764,31.0,26.0,121,3.0,11
714,228,499,52.523537414965986,53.823854875283445,31.0,29.0,277,1.0,271
715,228,570,52.523537414965986,53.98639455782313,31.0,14.0,348,1.0,342
716,228,412,52.523537414965986,55.193832199546485,31.0,1.0,217,3.0,184
717,228,625,52.523537414965986,53.80063492063492,31.0,25.0,401,1.0,397
718,228,635,52.523537414965986,53.98639455782313,31.0,10.0,412,1.0,407
719,228,625,52.523537414965986,55.309931972789116,31.0,-1.0,415,3.0,397
720,228,30,53.10403628117914,55.33315192743764,21.0,25.0,220,2.0,198
721,228,36,53.10403628117914,55.98331065759637,21.0,12.0,229,3.0,192
722,228,239,53.10403628117914,55.33315192743764,21.0,26.0,97,2.0,11
723,228,412,53.10403628117914,55.193832199546485,21.0,1.0,205,2.0,184
724,228,625,53.10403628117914,55.309931972789116,21.0,-1.0,408,2.0,397
725,234,30,54.00961451247166,55.33315192743764,16.0,25.0,212,1.0,204
726,234,36,54.00961451247166,55.98331065759637,16.0,12.0,215,2.0,198
727,234,239,54.00961451247166,55.33315192743764,16.0,26.0,57,1.0,5
728,234,250,54.00961451247166,56.95854875283447,16.0,12.0,128,3.0,16
729,234,412,54.00961451247166,55.193832199546485,16.0,1.0,185,1.0,178
730,234,609,54.00961451247166,56.95854875283447,16.0,5.0,396,3.0,375
731,234,625,54.00961451247166,55.309931972789116,16.0,-1.0,395,1.0,391
732,234,635,54.00961451247166,56.95854875283447,16.0,8.0,421,3.0,401
733,234,622,54.00961451247166,56.98176870748299,16.0,8.0,409,3.0,388
734,239,22,55.33315192743764,57.12108843537415,26.0,33.0,230,2.0,217
735,239,22,55.33315192743764,58.2356462585034,26.0,27.0,250,3.0,217
736,239,250,55.33315192743764,56.95854875283447,26.0,12.0,71,2.0,11
737,239,230,55.33315192743764,57.23718820861678,26.0,26.0,82,2.0,9
738,239,407,55.33315192743764,58.18920634920635,26.0,15.0,208,3.0,168
739,239,609,55.33315192743764,56.95854875283447,26.0,5.0,377,2.0,370
740,239,597,55.33315192743764,57.283628117913835,26.0,7.0,368,2.0,358
741,239,417,55.33315192743764,58.16598639455783,26.0,18.0,216,3.0,178
742,239,635,55.33315192743764,56.95854875283447,26.0,8.0,402,2.0,396
743,239,622,55.33315192743764,56.98176870748299,26.0,8.0,390,2.0,383
744,239,637,55.33315192743764,58.16598639455783,26.0,10.0,416,3.0,398
745,250,22,56.95854875283447,58.2356462585034,12.0,27.0,235,1.0,228
746,250,407,56.95854875283447,58.18920634920635,12.0,15.0,166,1.0,157
747,250,238,56.95854875283447,59.93070294784581,12.0,28.0,129,3.0,12
748,250,417,56.95854875283447,58.16598639455783,12.0,18.0,175,1.0,167
749,250,637,56.95854875283447,58.16598639455783,12.0,10.0,390,1.0,387
750,250,632,56.95854875283447,59.93070294784581,12.0,-3.0,403,3.0,382
751,230,73,57.23718820861678,59.97714285714286,26.0,40.0,196,3.0,157
752,230,238,57.23718820861678,59.93070294784581,26.0,28.0,116,3.0,8
753,230,412,57.23718820861678,59.953922902494334,26.0,10.0,216,3.0,182
754,230,632,57.23718820861678,59.93070294784581,26.0,-3.0,418,3.0,402
755,407,73,58.18920634920635,59.97714285714286,15.0,40.0,343,2.0,334
756,407,238,58.18920634920635,59.93070294784581,15.0,28.0,185,2.0,169
757,407,412,58.18920634920635,59.953922902494334,15.0,10.0,76,2.0,5
758,407,632,58.18920634920635,59.93070294784581,15.0,-3.0,237,2.0,225
759,492,120,1.9040362811791383,3.575873015873016,0.0,30.0,379,2.0,372
760,492,88,1.9040362811791383,4.133151927437642,0.0,29.0,415,2.0,404
761,492,238,1.9040362811791383,3.5526530612244898,0.0,23.0,264,2.0,254
762,492,228,1.9040362811791383,4.017052154195011,0.0,27.0,279,2.0,264
763,492,450,1.9040362811791383,3.4597732426303858,0.0,19.0,79,2.0,42
764,492,589,1.9040362811791383,3.9938321995464854,0.0,3.0,132,2.0,97
765,492,620,1.9040362811791383,3.4597732426303858,0.0,13.0,144,2.0,128
766,492,632,1.9040362811791383,4.017052154195011,0.0,3.0,167,2.0,140
767,492,857,1.9040362811791383,3.4597732426303858,0.0,0.0,371,2.0,365
768,471,120,2.043356009070295,3.575873015873016,3.0,30.0,357,2.0,351
769,471,88,2.043356009070295,4.133151927437642,3.0,29.0,393,2.0,383
770,471,238,2.043356009070295,3.5526530612244898,3.0,23.0,242,2.0,233
771,471,228,2.043356009070295,4.017052154195011,3.0,27.0,257,2.0,243
772,471,450,2.043356009070295,3.4597732426303858,3.0,19.0,65,1.0,21
773,471,589,2.043356009070295,3.9938321995464854,3.0,3.0,145,2.0,118
774,471,620,2.043356009070295,3.4597732426303858,3.0,13.0,161,1.0,149
775,471,632,2.043356009070295,4.017052154195011,3.0,3.0,182,2.0,161
776,471,857,2.043356009070295,3.4597732426303858,3.0,0.0,391,1.0,386
777,450,144,3.4597732426303858,5.61922902494331,19.0,36.0,320,2.0,306
778,450,227,3.4597732426303858,5.61922902494331,19.0,26.0,242,2.0,223
779,450,236,3.4597732426303858,6.362267573696145,19.0,26.0,248,3.0,214
780,450,523,3.4597732426303858,5.596009070294785,19.0,16.0,117,2.0,73
781,450,609,3.4597732426303858,6.03718820861678,19.0,22.0,194,3.0,159
782,450,626,3.4597732426303858,5.61922902494331,19.0,9.0,199,2.0,176
783,450,621,3.4597732426303858,6.060408163265306,19.0,20.0,204,3.0,171
784,450,850,3.4597732426303858,6.060408163265306,19.0,3.0,415,3.0,400
785,589,144,3.9938321995464854,5.61922902494331,3.0,36.0,450,2.0,445
786,589,227,3.9938321995464854,5.61922902494331,3.0,26.0,369,2.0,362
787,589,236,3.9938321995464854,6.362267573696145,3.0,26.0,367,2.0,353
788,589,523,3.9938321995464854,5.596009070294785,3.0,16.0,95,2.0,66
789,589,609,3.9938321995464854,6.03718820861678,3.0,22.0,90,2.0,20
790,589,626,3.9938321995464854,5.61922902494331,3.0,9.0,79,2.0,37
791,589,621,3.9938321995464854,6.060408163265306,3.0,20.0,95,2.0,32
792,589,850,3.9938321995464854,6.060408163265306,3.0,3.0,276,2.0,261
793,523,154,5.596009070294785,8.289523809523809,16.0,28.0,387,3.0,369
794,523,225,5.596009070294785,7.9412244897959186,16.0,20.0,315,2.0,298
795,523,239,5.596009070294785,8.266303854875284,16.0,19.0,306,3.0,284
796,523,444,5.596009070294785,6.989206349206349,16.0,6.0,99,1.0,79
797,523,624,5.596009070294785,7.9412244897959186,16.0,1.0,143,2.0,101
798,609,154,6.03718820861678,8.289523809523809,22.0,28.0,465,2.0,455
799,609,225,6.03718820861678,7.9412244897959186,22.0,20.0,393,2.0,384
800,609,239,6.03718820861678,8.266303854875284,22.0,19.0,382,2.0,370
801,609,433,6.03718820861678,8.846802721088435,22.0,26.0,214,3.0,176
802,609,624,6.03718820861678,7.9412244897959186,22.0,1.0,83,2.0,15
803,609,621,6.03718820861678,8.846802721088435,22.0,15.0,122,3.0,12
804,609,821,6.03718820861678,8.846802721088435,22.0,-2.0,244,3.0,212
805,444,154,6.989206349206349,8.289523809523809,6.0,28.0,295,1.0,290
806,444,31,6.989206349206349,9.1718820861678,6.0,30.0,424,2.0,413
807,444,239,6.989206349206349,8.266303854875284,6.0,19.0,212,1.0,205
808,444,381,6.989206349206349,9.798820861678005,6.0,20.0,136,3.0,63
809,444,433,6.989206349206349,8.846802721088435,6.0,26.0,81,2.0,11
810,444,432,6.989206349206349,9.798820861678005,6.0,21.0,122,3.0,12
811,444,621,6.989206349206349,8.846802721088435,6.0,15.0,194,2.0,177
812,444,636,6.989206349206349,9.798820861678005,6.0,18.0,227,3.0,192
813,444,821,6.989206349206349,8.846802721088435,6.0,-2.0,385,2.0,377
814,444,830,6.989206349206349,9.798820861678005,6.0,2.0,405,3.0,386
815,433,83,8.846802721088435,10.820498866213152,26.0,23.0,360,2.0,350
816,433,108,8.846802721088435,11.331337868480725,26.0,30.0,342,2.0,325
817,433,237,8.846802721088435,10.100680272108844,26.0,20.0,203,1.0,196
818,433,218,8.846802721088435,11.331337868480725,26.0,33.0,240,2.0,215
819,433,472,8.846802721088435,10.565079365079365,26.0,22.0,84,2.0,39
820,433,464,8.846802721088435,11.331337868480725,26.0,17.0,111,2.0,31
821,433,646,8.846802721088435,10.634739229024943,26.0,18.0,226,2.0,213
822,433,619,8.846802721088435,11.331337868480725,26.0,7.0,215,2.0,186
823,433,826,8.846802721088435,10.634739229024943,26.0,2.0,400,2.0,393
824,432,83,9.798820861678005,10.820498866213152,21.0,23.0,352,1.0,349
825,432,108,9.798820861678005,11.331337868480725,21.0,30.0,331,2.0,324
826,432,81,9.798820861678005,12.538775510204083,21.0,25.0,370,3.0,351
827,432,218,9.798820861678005,11.331337868480725,21.0,33.0,224,2.0,214
828,432,246,9.798820861678005,12.561995464852608,21.0,1.0,221,3.0,186
829,432,464,9.798820861678005,11.331337868480725,21.0,17.0,73,2.0,32
830,432,619,9.798820861678005,11.331337868480725,21.0,7.0,198,2.0,187
831,472,81,10.565079365079365,12.538775510204083,22.0,25.0,400,2.0,391
832,472,246,10.565079365079365,12.561995464852608,22.0,1.0,242,2.0,226
833,464,81,11.331337868480725,12.538775510204083,17.0,25.0,387,1.0,383
834,464,64,11.331337868480725,13.931972789115646,17.0,32.0,415,3.0,400
835,464,246,11.331337868480725,12.561995464852608,17.0,1.0,224,1.0,218
836,464,237,11.331337868480725,13.955192743764172,17.0,32.0,254,3.0,227
837,464,466,11.331337868480725,13.955192743764172,17.0,12.0,113,3.0,2
838,464,632,11.331337868480725,13.955192743764172,17.0,9.0,202,3.0,168
839,464,645,11.331337868480725,14.071292517006803,17.0,13.0,216,3.0,181
840,464,848,11.331337868480725,13.931972789115646,17.0,0.0,400,3.0,384
841,466,81,13.955192743764172,15.000090702947846,12.0,37.0,388,1.0,385
842,466,195,13.955192743764172,16.27718820861678,12.0,26.0,289,2.0,271
843,466,242,13.955192743764172,15.371609977324264,12.0,35.0,232,1.0,224
844,466,248,13.955192743764172,16.253968253968253,12.0,31.0,239,2.0,218
845,466,429,13.955192743764172,14.97687074829932,12.0,20.0,57,1.0,37
846,466,456,13.955192743764172,15.000090702947846,12.0,20.0,46,1.0,10
847,466,600,13.955192743764172,16.137868480725626,12.0,23.0,164,2.0,134
848,466,643,13.955192743764172,15.000090702947846,12.0,13.0,183,1.0,177
849,466,623,13.955192743764172,16.114648526077097,12.0,19.0,182,2.0,157
850,466,832,13.955192743764172,15.371609977324264,12.0,-2.0,371,1.0,366
851,466,828,13.955192743764172,16.62548752834467,12.0,0.0,380,3.0,362
852,429,195,14.97687074829932,16.27718820861678,20.0,26.0,241,1.0,234
853,429,63,14.97687074829932,17.57750566893424,20.0,33.0,383,3.0,366
854,429,248,14.97687074829932,16.253968253968253,20.0,31.0,189,1.0,181
855,429,239,14.97687074829932,17.57750566893424,20.0,34.0,221,3.0,190
856,429,600,14.97687074829932,16.137868480725626,20.0,23.0,178,1.0,171
857,429,466,14.97687074829932,17.60072562358277,20.0,15.0,119,3.0,37
858,429,623,14.97687074829932,16.114648526077097,20.0,19.0,200,1.0,194
859,429,695,14.97687074829932,17.57750566893424,20.0,8.0,289,3.0,266
860,429,828,14.97687074829932,16.62548752834467,20.0,0.0,405,2.0,399
861,429,828,14.97687074829932,17.554285714285715,20.0,-1.0,414,3.0,399
862,456,195,15.000090702947846,16.27718820861678,20.0,26.0,267,1.0,261
863,456,63,15.000090702947846,17.57750566893424,20.0,33.0,408,3.0,393
864,456,248,15.000090702947846,16.253968253968253,20.0,31.0,215,1.0,208
865,456,239,15.000090702947846,17.57750566893424,20.0,34.0,244,3.0,217
866,456,600,15.000090702947846,16.137868480725626,20.0,23.0,152,1.0,144
867,456,466,15.000090702947846,17.60072562358277,20.0,15.0,112,3.0,10
868,456,623,15.000090702947846,16.114648526077097,20.0,19.0,174,1.0,167
869,456,695,15.000090702947846,17.57750566893424,20.0,8.0,264,3.0,239
870,456,828,15.000090702947846,16.62548752834467,20.0,0.0,379,2.0,372
871,456,828,15.000090702947846,17.554285714285715,20.0,-1.0,388,3.0,372
872,600,194,16.137868480725626,18.18122448979592,23.0,31.0,415,2.0,406
873,600,239,16.137868480725626,17.57750566893424,23.0,34.0,366,1.0,361
874,600,241,16.137868480725626,18.204444444444444,23.0,34.0,370,2.0,359
875,600,466,16.137868480725626,17.60072562358277,23.0,15.0,148,1.0,134
876,600,607,16.137868480725626,18.808163265306124,23.0,20.0,115,3.0,7
877,600,695,16.137868480725626,17.57750566893424,23.0,8.0,113,1.0,95
878,600,623,16.137868480725626,18.808163265306124,23.0,19.0,117,3.0,23
879,600,828,16.137868480725626,17.554285714285715,23.0,-1.0,236,1.0,228
880,600,850,16.137868480725626,18.808163265306124,23.0,6.0,275,3.0,250
881,466,190,17.60072562358277,19.551201814058956,15.0,32.0,288,2.0,276
882,466,237,17.60072562358277,19.574421768707484,15.0,34.0,244,2.0,229
883,466,607,17.60072562358277,18.808163265306124,15.0,20.0,150,1.0,141
884,466,613,17.60072562358277,19.969160997732427,15.0,20.0,179,2.0,147
885,466,607,17.60072562358277,20.01560090702948,15.0,21.0,175,2.0,141
886,466,623,17.60072562358277,18.808163265306124,15.0,19.0,165,1.0,157
887,466,626,17.60072562358277,19.969160997732427,15.0,20.0,190,2.0,160
888,466,631,17.60072562358277,19.99238095238095,15.0,21.0,195,2.0,165
889,466,850,17.60072562358277,18.808163265306124,15.0,6.0,388,1.0,384
890,466,828,17.60072562358277,19.945941043083902,15.0,-1.0,376,2.0,362
891,466,830,17.60072562358277,20.06204081632653,15.0,7.0,379,2.0,364
892,607,195,18.808163265306124,20.735419501133787,20.0,34.0,420,2.0,412
893,607,247,18.808163265306124,20.735419501133787,20.0,34.0,369,2.0,360
894,607,237,18.808163265306124,21.0140589569161,20.0,35.0,382,2.0,370
895,607,613,18.808163265306124,19.969160997732427,20.0,20.0,50,1.0,6
896,607,456,18.808163265306124,21.199818594104308,20.0,14.0,183,2.0,151
897,607,626,18.808163265306124,19.969160997732427,20.0,20.0,53,1.0,19
898,607,631,18.808163265306124,19.99238095238095,20.0,21.0,56,1.0,24
899,607,679,18.808163265306124,21.24625850340136,20.0,3.0,127,2.0,72
900,607,828,18.808163265306124,19.945941043083902,20.0,-1.0,226,1.0,221
901,607,830,18.808163265306124,20.06204081632653,20.0,7.0,229,1.0,223
902,613,237,19.969160997732427,21.0140589569161,20.0,35.0,379,1.0,376
903,613,244,19.969160997732427,22.38403628117914,20.0,27.0,383,2.0,369
904,613,456,19.969160997732427,21.199818594104308,20.0,14.0,166,1.0,157
905,613,467,19.969160997732427,22.175056689342405,20.0,7.0,174,2.0,146
906,613,679,19.969160997732427,21.24625850340136,20.0,3.0,86,1.0,66
907,613,654,19.969160997732427,22.84843537414966,20.0,1.0,131,3.0,41
908,613,828,19.969160997732427,22.894875283446712,20.0,-6.0,249,3.0,215
909,607,244,20.01560090702948,22.38403628117914,21.0,27.0,377,2.0,363
910,607,456,20.01560090702948,21.199818594104308,21.0,14.0,159,1.0,151
911,607,467,20.01560090702948,22.175056689342405,21.0,7.0,168,2.0,140
912,607,679,20.01560090702948,21.24625850340136,21.0,3.0,89,1.0,72
913,607,654,20.01560090702948,22.84843537414966,21.0,1.0,131,3.0,47
914,607,828,20.01560090702948,22.894875283446712,21.0,-6.0,253,3.0,221
915,456,63,21.199818594104308,23.45215419501134,14.0,33.0,405,2.0,393
916,456,244,21.199818594104308,22.38403628117914,14.0,27.0,218,1.0,212
917,456,233,21.199818594104308,23.359274376417233,14.0,24.0,242,2.0,223
918,456,430,21.199818594104308,23.38249433106576,14.0,10.0,98,2.0,26
919,456,654,21.199818594104308,22.84843537414966,14.0,1.0,210,2.0,198
920,456,657,21.199818594104308,23.38249433106576,14.0,-4.0,222,2.0,201
921,456,828,21.199818594104308,22.894875283446712,14.0,-6.0,379,2.0,372
922,467,63,22.175056689342405,23.45215419501134,7.0,33.0,408,1.0,404
923,467,81,22.175056689342405,24.49705215419501,7.0,31.0,399,2.0,386
924,467,233,22.175056689342405,23.359274376417233,7.0,24.0,239,1.0,234
925,467,241,22.175056689342405,24.845351473922904,7.0,19.0,254,3.0,226
926,467,430,22.175056689342405,23.38249433106576,7.0,10.0,64,1.0,37
927,467,462,22.175056689342405,24.845351473922904,7.0,17.0,115,3.0,5
928,467,657,22.175056689342405,23.38249433106576,7.0,-4.0,197,1.0,190
929,430,81,23.38249433106576,24.49705215419501,10.0,31.0,352,1.0,349
930,430,81,23.38249433106576,25.21687074829932,10.0,29.0,358,2.0,349
931,430,30,23.38249433106576,26.076009070294784,10.0,27.0,416,3.0,400
932,430,241,23.38249433106576,24.845351473922904,10.0,19.0,199,1.0,189
933,430,219,23.38249433106576,25.193650793650793,10.0,20.0,225,2.0,211
934,430,462,23.38249433106576,24.845351473922904,10.0,17.0,71,1.0,32
935,430,451,23.38249433106576,25.193650793650793,10.0,17.0,81,2.0,21
936,430,620,23.38249433106576,25.193650793650793,10.0,9.0,205,2.0,190
937,462,30,24.845351473922904,26.076009070294784,17.0,27.0,435,1.0,432
938,462,145,24.845351473922904,27.353106575963718,17.0,33.0,335,3.0,317
939,462,241,24.845351473922904,26.470748299319727,17.0,0.0,232,2.0,221
940,462,233,24.845351473922904,27.724625850340136,17.0,35.0,260,3.0,229
941,462,603,24.845351473922904,27.608526077097505,17.0,14.0,185,3.0,141
942,462,618,24.845351473922904,27.538866213151927,17.0,15.0,194,3.0,156
943,462,821,24.845351473922904,27.492426303854877,17.0,-1.0,377,3.0,359
944,451,145,25.193650793650793,27.353106575963718,17.0,33.0,320,2.0,306
945,451,241,25.193650793650793,26.470748299319727,17.0,0.0,217,1.0,210
946,451,233,25.193650793650793,27.724625850340136,17.0,35.0,244,3.0,218
947,451,462,25.193650793650793,26.470748299319727,17.0,-5.0,56,1.0,11
948,451,603,25.193650793650793,27.608526077097505,17.0,14.0,184,2.0,152
949,451,618,25.193650793650793,27.538866213151927,17.0,15.0,195,2.0,167
950,451,821,25.193650793650793,27.492426303854877,17.0,-1.0,383,2.0,370
951,462,193,26.470748299319727,28.65342403628118,-5.0,37.0,285,2.0,269
952,462,22,26.470748299319727,29.164263038548754,-5.0,27.0,455,3.0,440
953,462,233,26.470748299319727,27.724625850340136,-5.0,35.0,235,1.0,229
954,462,242,26.470748299319727,28.699863945578233,-5.0,36.0,240,2.0,220
955,462,228,26.470748299319727,29.326802721088438,-5.0,34.0,264,3.0,234
956,462,603,26.470748299319727,27.608526077097505,-5.0,14.0,149,1.0,141
957,462,618,26.470748299319727,27.538866213151927,-5.0,15.0,163,1.0,156
958,462,654,26.470748299319727,28.699863945578233,-5.0,13.0,215,2.0,192
959,462,821,26.470748299319727,27.492426303854877,-5.0,-1.0,362,1.0,359
960,462,822,26.470748299319727,28.676643990929705,-5.0,-2.0,372,2.0,360
961,603,193,27.608526077097505,28.65342403628118,14.0,37.0,412,1.0,410
962,603,242,27.608526077097505,28.699863945578233,14.0,36.0,364,1.0,361
963,603,228,27.608526077097505,29.326802721088438,14.0,34.0,382,2.0,375
964,603,462,27.608526077097505,28.95528344671202,14.0,15.0,152,1.0,141
965,603,418,27.608526077097505,29.489342403628118,14.0,27.0,202,2.0,185
966,603,654,27.608526077097505,28.699863945578233,14.0,13.0,69,1.0,51
967,603,615,27.608526077097505,29.489342403628118,14.0,21.0,82,2.0,12
968,603,822,27.608526077097505,28.676643990929705,14.0,-2.0,224,1.0,219
969,603,820,27.608526077097505,29.489342403628118,14.0,-1.0,232,2.0,217
970,462,30,28.95528344671202,30.72,15.0,32.0,439,2.0,432
971,462,204,28.95528344671202,31.32371882086168,15.0,35.0,277,2.0,258
972,462,226,28.95528344671202,30.95219954648526,15.0,31.0,251,2.0,236
973,462,227,28.95528344671202,31.2540589569161,15.0,37.0,255,2.0,235
974,462,450,28.95528344671202,30.928979591836736,15.0,18.0,86,2.0,12
975,462,611,28.95528344671202,31.277278911564625,15.0,13.0,179,2.0,149
976,462,620,28.95528344671202,30.743219954648527,15.0,14.0,176,2.0,158
977,462,658,28.95528344671202,31.32371882086168,15.0,14.0,221,2.0,196
978,462,827,28.95528344671202,30.882539682539683,15.0,-4.0,374,2.0,365
979,462,830,28.95528344671202,31.764897959183674,15.0,-4.0,387,3.0,368
980,418,30,29.489342403628118,30.72,27.0,32.0,392,1.0,388
981,418,204,29.489342403628118,31.32371882086168,27.0,35.0,228,2.0,214
982,418,226,29.489342403628118,30.95219954648526,27.0,31.0,202,1.0,192
983,418,227,29.489342403628118,31.2540589569161,27.0,37.0,206,2.0,191
984,418,450,29.489342403628118,30.928979591836736,27.0,18.0,70,1.0,32
985,418,611,29.489342403628118,31.277278911564625,27.0,13.0,208,2.0,193
986,418,620,29.489342403628118,30.743219954648527,27.0,14.0,209,1.0,202
987,418,658,29.489342403628118,31.32371882086168,27.0,14.0,253,2.0,240
988,418,827,29.489342403628118,30.882539682539683,27.0,-4.0,413,1.0,409
989,418,830,29.489342403628118,31.764897959183674,27.0,-4.0,423,2.0,412
990,450,71,30.928979591836736,32.55437641723356,18.0,39.0,385,2.0,379
991,450,22,30.928979591836736,33.01877551020408,18.0,27.0,437,2.0,428
992,450,238,30.928979591836736,32.60081632653061,18.0,38.0,224,2.0,212
993,450,249,30.928979591836736,33.01877551020408,18.0,21.0,220,2.0,201
994,450,431,30.928979591836736,32.995555555555555,18.0,6.0,91,2.0,19
995,450,643,30.928979591836736,32.62403628117914,18.0,11.0,206,2.0,193
996,450,657,30.928979591836736,32.995555555555555,18.0,-4.0,225,2.0,207
997,611,238,31.277278911564625,32.60081632653061,13.0,38.0,377,1.0,373
998,611,249,31.277278911564625,33.01877551020408,13.0,21.0,370,2.0,362
999,611,450,31.277278911564625,32.57759637188209,13.0,13.0,170,1.0,161
1000,611,431,31.277278911564625,32.995555555555555,13.0,6.0,195,2.0,180
1001,611,643,31.277278911564625,32.62403628117914,13.0,11.0,66,1.0,32
1002,611,657,31.277278911564625,32.995555555555555,13.0,-4.0,87,2.0,46
1003,450,65,32.57759637188209,34.62095238095238,13.0,29.0,395,2.0,385
1004,450,73,32.57759637188209,35.50331065759637,13.0,28.0,397,3.0,377
1005,450,236,32.57759637188209,34.71383219954649,13.0,35.0,233,2.0,214
1006,450,236,32.57759637188209,35.131791383219955,13.0,30.0,241,3.0,214
1007,450,544,32.57759637188209,34.57451247165533,13.0,13.0,127,2.0,94
1008,450,445,32.57759637188209,35.41043083900227,13.0,22.0,122,3.0,5
1009,450,635,32.57759637188209,34.59773242630386,13.0,10.0,204,2.0,185
1010,450,622,32.57759637188209,35.41043083900227,13.0,20.0,211,3.0,172
1011,450,940,32.57759637188209,34.59773242630386,13.0,-4.0,498,2.0,490
1012,450,834,32.57759637188209,35.43365079365079,13.0,1.0,403,3.0,384
1013,431,65,32.995555555555555,34.62095238095238,6.0,29.0,373,2.0,366
1014,431,73,32.995555555555555,35.50331065759637,6.0,28.0,374,3.0,358
1015,431,236,32.995555555555555,34.71383219954649,6.0,35.0,209,2.0,195
1016,431,236,32.995555555555555,35.131791383219955,6.0,30.0,216,2.0,195
1017,431,544,32.995555555555555,34.57451247165533,6.0,13.0,132,2.0,113
1018,431,445,32.995555555555555,35.41043083900227,6.0,22.0,105,2.0,14
1019,431,635,32.995555555555555,34.59773242630386,6.0,10.0,215,2.0,204
1020,431,622,32.995555555555555,35.41043083900227,6.0,20.0,217,2.0,191
1021,431,834,32.995555555555555,35.43365079365079,6.0,1.0,416,2.0,403
1022,544,81,34.57451247165533,36.52498866213152,13.0,26.0,471,2.0,463
1023,544,232,34.57451247165533,36.78040816326531,13.0,28.0,326,2.0,312
1024,544,467,34.57451247165533,36.57142857142857,13.0,25.0,115,2.0,77
1025,544,625,34.57451247165533,36.5946485260771,13.0,19.0,119,2.0,81
1026,544,827,34.57451247165533,36.57142857142857,13.0,2.0,296,2.0,283
1027,445,81,35.41043083900227,36.52498866213152,22.0,26.0,367,1.0,364
1028,445,80,35.41043083900227,37.964625850340134,22.0,30.0,381,3.0,365
1029,445,80,35.41043083900227,37.987845804988666,22.0,32.0,382,3.0,365
1030,445,232,35.41043083900227,36.78040816326531,22.0,28.0,221,1.0,213
1031,445,237,35.41043083900227,37.94140589569161,22.0,31.0,235,3.0,208
1032,445,232,35.41043083900227,38.05750566893424,22.0,31.0,242,3.0,213
1033,445,467,35.41043083900227,36.57142857142857,22.0,25.0,55,1.0,22
1034,445,508,35.41043083900227,37.94140589569161,22.0,12.0,126,3.0,63
1035,445,625,35.41043083900227,36.5946485260771,22.0,19.0,187,1.0,180
1036,445,636,35.41043083900227,37.94140589569161,22.0,-5.0,220,3.0,191
1037,445,827,35.41043083900227,36.57142857142857,22.0,2.0,385,1.0,382
1038,445,882,35.41043083900227,38.034285714285716,22.0,-1.0,451,3.0,437
1039,467,80,36.57142857142857,37.964625850340134,25.0,30.0,392,1.0,387
1040,467,80,36.57142857142857,37.987845804988666,25.0,32.0,392,1.0,387
1041,467,31,36.57142857142857,39.450702947845805,25.0,31.0,453,3.0,436
1042,467,237,36.57142857142857,37.94140589569161,25.0,31.0,237,1.0,230
1043,467,232,36.57142857142857,38.05750566893424,25.0,31.0,244,1.0,235
1044,467,508,36.57142857142857,37.94140589569161,25.0,12.0,72,1.0,41
1045,467,449,36.57142857142857,38.684444444444445,25.0,14.0,93,2.0,18
1046,467,636,36.57142857142857,37.94140589569161,25.0,-5.0,179,1.0,169
1047,467,632,36.57142857142857,38.684444444444445,25.0,11.0,188,2.0,165
1048,467,882,36.57142857142857,38.034285714285716,25.0,-1.0,420,1.0,415
1049,508,31,37.94140589569161,39.450702947845805,12.0,31.0,481,2.0,477
1050,508,67,37.94140589569161,40.216961451247165,12.0,27.0,452,2.0,441
1051,508,242,37.94140589569161,39.7990022675737,12.0,19.0,278,2.0,266
1052,508,237,37.94140589569161,40.14730158730159,12.0,24.0,287,2.0,271
1053,508,468,37.94140589569161,39.891882086167804,12.0,25.0,93,2.0,40
1054,508,461,37.94140589569161,39.9847619047619,12.0,16.0,100,2.0,47
1055,508,631,37.94140589569161,39.86866213151927,12.0,25.0,148,2.0,123
1056,508,625,37.94140589569161,39.9847619047619,12.0,14.0,146,2.0,117
1057,508,830,37.94140589569161,39.891882086167804,12.0,6.0,333,2.0,322
1058,508,821,37.94140589569161,39.9847619047619,12.0,-2.0,325,2.0,313
1059,449,67,38.684444444444445,40.216961451247165,14.0,27.0,388,2.0,382
1060,449,30,38.684444444444445,41.05287981859411,14.0,-6.0,431,2.0,419
1061,449,242,38.684444444444445,39.7990022675737,14.0,19.0,212,1.0,207
1062,449,237,38.684444444444445,40.14730158730159,14.0,24.0,221,1.0,212
1063,449,468,38.684444444444445,39.891882086167804,14.0,25.0,55,1.0,19
1064,449,461,38.684444444444445,39.9847619047619,14.0,16.0,57,1.0,12
1065,449,631,38.684444444444445,39.86866213151927,14.0,25.0,189,1.0,182
1066,449,625,38.684444444444445,39.9847619047619,14.0,14.0,185,1.0,176
1067,449,830,38.684444444444445,39.891882086167804,14.0,6.0,385,1.0,381
1068,449,821,38.684444444444445,39.9847619047619,14.0,-2.0,376,1.0,372
1069,468,30,39.891882086167804,41.05287981859411,25.0,-6.0,441,1.0,438
1070,468,136,39.891882086167804,42.58539682539683,25.0,33.0,352,3.0,332
1071,468,425,39.891882086167804,42.60861678004535,25.0,20.0,125,3.0,43
1072,468,831,39.891882086167804,42.58539682539683,25.0,-1.0,381,3.0,363
1073,461,30,39.9847619047619,41.05287981859411,16.0,-6.0,433,1.0,431
1074,461,136,39.9847619047619,42.58539682539683,16.0,33.0,344,3.0,325
1075,461,250,39.9847619047619,42.91047619047619,16.0,33.0,246,3.0,211
1076,461,425,39.9847619047619,42.60861678004535,16.0,20.0,119,3.0,36
1077,461,693,39.9847619047619,42.93369614512472,16.0,11.0,264,3.0,232
1078,461,831,39.9847619047619,42.58539682539683,16.0,-1.0,387,3.0,370
1079,425,69,42.60861678004535,44.30367346938775,20.0,35.0,363,2.0,356
1080,425,72,42.60861678004535,45.11637188208617,20.0,31.0,369,3.0,353
1081,425,228,42.60861678004535,43.83927437641724,20.0,35.0,204,1.0,197
1082,425,233,42.60861678004535,44.0714739229025,20.0,34.0,202,1.0,192
1083,425,236,42.60861678004535,45.2324716553288,20.0,27.0,220,3.0,189
1084,425,432,42.60861678004535,44.419773242630384,20.0,17.0,78,2.0,7
1085,425,432,42.60861678004535,45.00027210884354,20.0,12.0,103,2.0,7
1086,425,627,42.60861678004535,43.885714285714286,20.0,15.0,209,1.0,202
1087,425,642,42.60861678004535,44.88417233560091,20.0,12.0,238,2.0,217
1088,425,641,42.60861678004535,45.069931972789114,20.0,5.0,241,2.0,216
1089,425,826,42.60861678004535,43.81605442176871,20.0,1.0,404,1.0,401
1090,425,824,42.60861678004535,44.02503401360544,20.0,-5.0,404,1.0,399
1091,432,72,43.444535147392294,45.11637188208617,21.0,31.0,367,2.0,360
1092,432,236,43.444535147392294,45.2324716553288,21.0,27.0,211,2.0,196
1093,432,642,43.444535147392294,44.88417233560091,21.0,12.0,219,1.0,210
1094,432,641,43.444535147392294,45.069931972789114,21.0,5.0,220,2.0,209
1095,432,63,44.419773242630384,46.57922902494331,17.0,33.0,381,2.0,369
1096,432,66,44.419773242630384,47.275827664399095,17.0,34.0,386,3.0,366
1097,432,238,44.419773242630384,46.625668934240366,17.0,35.0,216,2.0,194
1098,432,241,44.419773242630384,47.113287981859415,17.0,35.0,223,3.0,191
1099,432,451,44.419773242630384,46.69532879818594,17.0,16.0,100,2.0,19
1100,432,640,44.419773242630384,46.556009070294785,17.0,13.0,227,2.0,208
1101,432,649,44.419773242630384,47.113287981859415,17.0,-0.0,246,3.0,217
1102,432,827,44.419773242630384,46.556009070294785,17.0,-5.0,406,2.0,395
1103,432,63,45.00027210884354,46.57922902494331,12.0,33.0,375,2.0,369
1104,432,66,45.00027210884354,47.275827664399095,12.0,34.0,379,2.0,366
1105,432,238,45.00027210884354,46.625668934240366,12.0,35.0,206,2.0,194
1106,432,241,45.00027210884354,47.113287981859415,12.0,35.0,212,2.0,191
1107,432,451,45.00027210884354,46.69532879818594,12.0,16.0,75,2.0,19
1108,432,640,45.00027210884354,46.556009070294785,12.0,13.0,219,2.0,208
1109,432,649,45.00027210884354,47.113287981859415,12.0,-0.0,235,2.0,217
1110,432,827,45.00027210884354,46.556009070294785,12.0,-5.0,401,2.0,395
1111,451,68,46.69532879818594,48.87800453514739,16.0,36.0,394,2.0,383
1112,451,62,46.69532879818594,49.08698412698413,16.0,27.0,402,2.0,389
1113,451,247,46.69532879818594,48.34394557823129,16.0,22.0,216,2.0,204
1114,451,235,46.69532879818594,48.99410430839002,16.0,19.0,238,2.0,216
1115,451,465,46.69532879818594,48.06530612244898,16.0,19.0,61,1.0,14
1116,451,455,46.69532879818594,49.08698412698413,16.0,1.0,103,2.0,4
1117,451,644,46.69532879818594,48.11174603174603,16.0,16.0,202,1.0,193
1118,451,851,46.69532879818594,48.11174603174603,16.0,2.0,405,1.0,400
1119,432,68,47.13650793650794,48.87800453514739,11.0,36.0,372,2.0,364
1120,432,62,47.13650793650794,49.08698412698413,11.0,27.0,379,2.0,370
1121,432,247,47.13650793650794,48.34394557823129,11.0,22.0,192,1.0,185
1122,432,235,47.13650793650794,48.99410430839002,11.0,19.0,213,2.0,197
1123,432,455,47.13650793650794,49.08698412698413,11.0,1.0,87,2.0,23
1124,465,62,48.06530612244898,49.08698412698413,19.0,27.0,405,1.0,403
1125,465,69,48.06530612244898,50.85170068027211,19.0,32.0,414,3.0,396
1126,465,219,48.06530612244898,50.549841269841274,19.0,27.0,268,2.0,246
1127,465,455,48.06530612244898,49.08698412698413,19.0,1.0,45,1.0,10
1128,465,610,48.06530612244898,50.665941043083905,19.0,24.0,183,3.0,145
1129,465,622,48.06530612244898,50.665941043083905,19.0,24.0,193,3.0,157
1130,465,848,48.06530612244898,50.665941043083905,19.0,9.0,399,3.0,383
1131,455,69,49.08698412698413,50.85170068027211,1.0,32.0,393,2.0,386
1132,455,81,49.08698412698413,51.45541950113379,1.0,33.0,388,2.0,374
1133,455,219,49.08698412698413,50.549841269841274,1.0,27.0,244,1.0,236
1134,455,234,49.08698412698413,51.57151927437642,1.0,35.0,246,2.0,221
1135,455,610,49.08698412698413,50.665941043083905,1.0,24.0,169,2.0,155
1136,455,411,49.08698412698413,51.757278911564626,1.0,20.0,123,3.0,44
1137,455,622,49.08698412698413,50.665941043083905,1.0,24.0,180,2.0,167
1138,455,643,49.08698412698413,51.478639455782314,1.0,20.0,214,2.0,188
1139,455,848,49.08698412698413,50.665941043083905,1.0,9.0,399,2.0,393
1140,455,822,49.08698412698413,51.78049886621315,1.0,-2.0,385,3.0,367
1141,610,228,50.665941043083905,52.523537414965986,24.0,31.0,390,2.0,382
1142,610,228,50.665941043083905,53.10403628117914,24.0,21.0,396,2.0,382
1143,610,411,50.665941043083905,51.757278911564626,24.0,20.0,204,1.0,199
1144,610,452,50.665941043083905,52.33777777777778,24.0,19.0,174,2.0,158
1145,610,645,50.665941043083905,52.33777777777778,24.0,12.0,80,2.0,35
1146,610,822,50.665941043083905,51.78049886621315,24.0,-2.0,217,1.0,212
1147,411,22,51.757278911564626,53.54521541950113,20.0,32.0,397,2.0,389
1148,411,63,51.757278911564626,54.03283446712018,20.0,30.0,362,2.0,348
1149,411,228,51.757278911564626,53.10403628117914,20.0,21.0,192,1.0,183
1150,411,234,51.757278911564626,54.00961451247166,20.0,16.0,202,2.0,177
1151,411,499,51.757278911564626,53.823854875283445,20.0,29.0,125,2.0,88
1152,411,570,51.757278911564626,53.98639455782313,20.0,14.0,186,2.0,159
1153,411,625,51.757278911564626,53.80063492063492,20.0,25.0,231,2.0,214
1154,411,635,51.757278911564626,53.98639455782313,20.0,10.0,244,2.0,224
1155,411,826,51.757278911564626,53.84707482993198,20.0,4.0,425,2.0,415
1156,452,22,52.33777777777778,53.54521541950113,19.0,32.0,433,1.0,430
1157,452,63,52.33777777777778,54.03283446712018,19.0,30.0,396,2.0,389
1158,452,234,52.33777777777778,54.00961451247166,19.0,16.0,230,2.0,218
1159,452,499,52.33777777777778,53.823854875283445,19.0,29.0,79,1.0,47
1160,452,570,52.33777777777778,53.98639455782313,19.0,14.0,138,2.0,118
1161,452,412,52.33777777777778,55.193832199546485,19.0,1.0,129,3.0,40
1162,452,625,52.33777777777778,53.80063492063492,19.0,25.0,184,1.0,173
1163,452,635,52.33777777777778,53.98639455782313,19.0,10.0,196,2.0,183
1164,452,625,52.33777777777778,55.309931972789116,19.0,-1.0,215,3.0,173
1165,452,826,52.33777777777778,53.84707482993198,19.0,4.0,380,2.0,374
1166,499,30,53.823854875283445,55.33315192743764,29.0,25.0,473,2.0,469
1167,499,36,53.823854875283445,55.98331065759637,29.0,12.0,472,2.0,463
1168,499,239,53.823854875283445,55.33315192743764,29.0,26.0,268,2.0,260
1169,499,412,53.823854875283445,55.193832199546485,29.0,1.0,105,1.0,87
1170,499,625,53.823854875283445,55.309931972789116,29.0,-1.0,141,1.0,126
1171,570,239,53.98639455782313,55.33315192743764,14.0,26.0,336,1.0,331
1172,570,250,53.98639455782313,56.95854875283447,14.0,12.0,345,3.0,320
1173,570,412,53.98639455782313,55.193832199546485,14.0,1.0,166,1.0,158
1174,570,609,53.98639455782313,56.95854875283447,14.0,5.0,134,3.0,39
1175,570,625,53.98639455782313,55.309931972789116,14.0,-1.0,79,1.0,55
1176,570,635,53.98639455782313,56.95854875283447,14.0,8.0,144,3.0,65
1177,412,22,55.193832199546485,57.12108843537415,1.0,33.0,399,2.0,390
1178,412,250,55.193832199546485,56.95854875283447,1.0,12.0,179,2.0,162
1179,412,230,55.193832199546485,57.23718820861678,1.0,26.0,202,2.0,182
1180,412,609,55.193832199546485,56.95854875283447,1.0,5.0,211,2.0,197
1181,412,597,55.193832199546485,57.283628117913835,1.0,7.0,206,2.0,185
1182,412,417,55.193832199546485,58.16598639455783,1.0,18.0,128,3.0,5
1183,412,635,55.193832199546485,56.95854875283447,1.0,8.0,236,2.0,223
1184,412,622,55.193832199546485,56.98176870748299,1.0,8.0,224,2.0,210
1185,412,637,55.193832199546485,58.16598639455783,1.0,10.0,259,3.0,225
1186,609,407,56.95854875283447,58.18920634920635,5.0,15.0,209,1.0,202
1187,609,238,56.95854875283447,59.93070294784581,5.0,28.0,392,3.0,371
1188,609,417,56.95854875283447,58.16598639455783,5.0,18.0,199,1.0,192
1189,609,637,56.95854875283447,58.16598639455783,5.0,10.0,59,1.0,28
1190,609,632,56.95854875283447,59.93070294784581,5.0,-3.0,130,3.0,23
1191,597,238,57.283628117913835,59.93070294784581,7.0,28.0,377,3.0,359
1192,597,412,57.283628117913835,59.953922902494334,7.0,10.0,218,3.0,185
1193,597,632,57.283628117913835,59.93070294784581,7.0,-3.0,119,3.0,35
1194,417,73,58.16598639455783,59.97714285714286,18.0,40.0,353,2.0,344
1195,417,238,58.16598639455783,59.93070294784581,18.0,28.0,194,2.0,179
1196,417,412,58.16598639455783,59.953922902494334,18.0,10.0,77,2.0,5
1197,417,632,58.16598639455783,59.93070294784581,18.0,-3.0,228,2.0,215
1198,618,120,1.9040362811791383,3.575873015873016,-6.0,30.0,503,2.0,498
1199,618,238,1.9040362811791383,3.5526530612244898,-6.0,23.0,387,2.0,380
1200,618,228,1.9040362811791383,4.017052154195011,-6.0,27.0,400,2.0,390
1201,618,450,1.9040362811791383,3.4597732426303858,-6.0,19.0,181,2.0,168
1202,618,589,1.9040362811791383,3.9938321995464854,-6.0,3.0,95,2.0,29
1203,618,620,1.9040362811791383,3.4597732426303858,-6.0,13.0,67,2.0,2
1204,618,632,1.9040362811791383,4.017052154195011,-6.0,3.0,92,2.0,14
1205,618,857,1.9040362811791383,3.4597732426303858,-6.0,0.0,248,2.0,239
1206,633,238,2.2523356009070294,3.5526530612244898,-5.0,23.0,399,1.0,395
1207,633,228,2.2523356009070294,4.017052154195011,-5.0,27.0,412,2.0,405
1208,633,450,2.2523356009070294,3.4597732426303858,-5.0,19.0,190,1.0,183
1209,633,589,2.2523356009070294,3.9938321995464854,-5.0,3.0,87,2.0,44
1210,633,620,2.2523356009070294,3.4597732426303858,-5.0,13.0,54,1.0,13
1211,633,632,2.2523356009070294,4.017052154195011,-5.0,3.0,76,2.0,1
1212,633,857,2.2523356009070294,3.4597732426303858,-5.0,0.0,230,1.0,224
1213,620,144,3.4597732426303858,5.61922902494331,13.0,36.0,485,2.0,476
1214,620,227,3.4597732426303858,5.61922902494331,13.0,26.0,404,2.0,393
1215,620,236,3.4597732426303858,6.362267573696145,13.0,26.0,404,3.0,384
1216,620,523,3.4597732426303858,5.596009070294785,13.0,16.0,134,2.0,97
1217,620,609,3.4597732426303858,6.03718820861678,13.0,22.0,112,3.0,11
1218,620,626,3.4597732426303858,5.61922902494331,13.0,9.0,93,2.0,6
1219,620,621,3.4597732426303858,6.060408163265306,13.0,20.0,112,3.0,1
1220,620,850,3.4597732426303858,6.060408163265306,13.0,3.0,256,3.0,230
1221,632,144,4.017052154195011,5.61922902494331,3.0,36.0,493,2.0,488
1222,632,227,4.017052154195011,5.61922902494331,3.0,26.0,411,2.0,405
1223,632,236,4.017052154195011,6.362267573696145,3.0,26.0,409,2.0,396
1224,632,523,4.017052154195011,5.596009070294785,3.0,16.0,128,2.0,109
1225,632,609,4.017052154195011,6.03718820861678,3.0,22.0,90,2.0,23
1226,632,444,4.017052154195011,6.989206349206349,3.0,6.0,227,3.0,188
1227,632,626,4.017052154195011,5.61922902494331,3.0,9.0,69,2.0,6
1228,632,621,4.017052154195011,6.060408163265306,3.0,20.0,89,2.0,11
1229,632,850,4.017052154195011,6.060408163265306,3.0,3.0,235,2.0,218
1230,626,154,5.61922902494331,8.289523809523809,9.0,28.0,486,3.0,472
1231,626,225,5.61922902494331,7.9412244897959186,9.0,20.0,413,2.0,401
1232,626,239,5.61922902494331,8.266303854875284,9.0,19.0,403,3.0,387
1233,626,444,5.61922902494331,6.989206349206349,9.0,6.0,191,1.0,182
1234,626,624,5.61922902494331,7.9412244897959186,9.0,1.0,100,2.0,2
1235,621,154,6.060408163265306,8.289523809523809,20.0,28.0,477,2.0,467
1236,621,225,6.060408163265306,7.9412244897959186,20.0,20.0,404,2.0,396
1237,621,239,6.060408163265306,8.266303854875284,20.0,19.0,394,2.0,382
1238,621,433,6.060408163265306,8.846802721088435,20.0,26.0,223,3.0,188
1239,621,624,6.060408163265306,7.9412244897959186,20.0,1.0,81,2.0,3
1240,621,821,6.060408163265306,8.846802721088435,20.0,-2.0,233,3.0,200
1241,624,381,7.9412244897959186,9.798820861678005,1.0,20.0,256,2.0,243
1242,624,237,7.9412244897959186,10.100680272108844,1.0,20.0,398,2.0,387
1243,624,432,7.9412244897959186,9.798820861678005,1.0,21.0,208,2.0,192
1244,624,472,7.9412244897959186,10.565079365079365,1.0,22.0,189,3.0,152
1245,624,636,7.9412244897959186,9.798820861678005,1.0,18.0,81,2.0,12
1246,624,646,7.9412244897959186,10.634739229024943,1.0,18.0,118,3.0,22
1247,624,830,7.9412244897959186,9.798820861678005,1.0,2.0,221,2.0,206
1248,624,826,7.9412244897959186,10.634739229024943,1.0,2.0,233,3.0,202
1249,621,237,8.846802721088435,10.100680272108844,15.0,20.0,388,1.0,384
1250,621,218,8.846802721088435,11.331337868480725,15.0,33.0,417,2.0,403
1251,621,472,8.846802721088435,10.565079365079365,15.0,22.0,166,2.0,149
1252,621,464,8.846802721088435,11.331337868480725,15.0,17.0,190,2.0,157
1253,621,646,8.846802721088435,10.634739229024943,15.0,18.0,81,2.0,25
1254,621,619,8.846802721088435,11.331337868480725,15.0,7.0,107,2.0,2
1255,621,826,8.846802721088435,10.634739229024943,15.0,2.0,219,2.0,205
1256,636,218,9.798820861678005,11.331337868480725,18.0,33.0,423,2.0,418
1257,636,246,9.798820861678005,12.561995464852608,18.0,1.0,408,3.0,390
1258,636,464,9.798820861678005,11.331337868480725,18.0,17.0,184,2.0,172
1259,636,619,9.798820861678005,11.331337868480725,18.0,7.0,68,2.0,17
1260,646,246,10.634739229024943,12.561995464852608,18.0,1.0,409,2.0,400
1261,619,246,11.331337868480725,12.561995464852608,7.0,1.0,377,1.0,373
1262,619,237,11.331337868480725,13.955192743764172,7.0,32.0,398,3.0,382
1263,619,466,11.331337868480725,13.955192743764172,7.0,12.0,190,3.0,153
1264,619,632,11.331337868480725,13.955192743764172,7.0,9.0,114,3.0,13
1265,619,645,11.331337868480725,14.071292517006803,7.0,13.0,121,3.0,26
1266,619,848,11.331337868480725,13.931972789115646,7.0,0.0,255,3.0,229
1267,632,195,13.955192743764172,16.27718820861678,9.0,26.0,448,2.0,437
1268,632,242,13.955192743764172,15.371609977324264,9.0,35.0,395,1.0,390
1269,632,248,13.955192743764172,16.253968253968253,9.0,31.0,397,2.0,384
1270,632,429,13.955192743764172,14.97687074829932,9.0,20.0,208,1.0,203
1271,632,456,13.955192743764172,15.000090702947846,9.0,20.0,182,1.0,176
1272,632,600,13.955192743764172,16.137868480725626,9.0,23.0,99,2.0,32
1273,632,643,13.955192743764172,15.000090702947846,9.0,13.0,46,1.0,11
1274,632,623,13.955192743764172,16.114648526077097,9.0,19.0,93,2.0,9
1275,632,832,13.955192743764172,15.371609977324264,9.0,-2.0,209,1.0,200
1276,632,828,13.955192743764172,16.62548752834467,9.0,0.0,227,3.0,196
1277,645,195,14.071292517006803,16.27718820861678,13.0,26.0,460,2.0,450
1278,645,242,14.071292517006803,15.371609977324264,13.0,35.0,407,1.0,403
1279,645,248,14.071292517006803,16.253968253968253,13.0,31.0,408,2.0,397
1280,645,600,14.071292517006803,16.137868480725626,13.0,23.0,100,2.0,45
1281,645,623,14.071292517006803,16.114648526077097,13.0,19.0,91,2.0,22
1282,645,832,14.071292517006803,15.371609977324264,13.0,-2.0,195,1.0,187
1283,645,828,14.071292517006803,16.62548752834467,13.0,0.0,214,3.0,183
1284,643,195,15.000090702947846,16.27718820861678,13.0,26.0,451,1.0,448
1285,643,248,15.000090702947846,16.253968253968253,13.0,31.0,399,1.0,395
1286,643,239,15.000090702947846,17.57750566893424,13.0,34.0,419,3.0,404
1287,643,600,15.000090702947846,16.137868480725626,13.0,23.0,65,1.0,43
1288,643,466,15.000090702947846,17.60072562358277,13.0,15.0,209,3.0,177
1289,643,623,15.000090702947846,16.114648526077097,13.0,19.0,52,1.0,20
1290,643,695,15.000090702947846,17.57750566893424,13.0,8.0,123,3.0,52
1291,643,828,15.000090702947846,16.62548752834467,13.0,0.0,198,2.0,185
1292,643,828,15.000090702947846,17.554285714285715,13.0,-1.0,215,3.0,185
1293,623,194,16.114648526077097,18.18122448979592,19.0,31.0,438,2.0,429
1294,623,239,16.114648526077097,17.57750566893424,19.0,34.0,389,1.0,384
1295,623,241,16.114648526077097,18.204444444444444,19.0,34.0,392,2.0,382
1296,623,466,16.114648526077097,17.60072562358277,19.0,15.0,170,1.0,157
1297,623,607,16.114648526077097,18.808163265306124,19.0,20.0,117,3.0,16
1298,623,695,16.114648526077097,17.57750566893424,19.0,8.0,96,1.0,72
1299,623,828,16.114648526077097,17.554285714285715,19.0,-1.0,214,1.0,205
1300,623,850,16.114648526077097,18.808163265306124,19.0,6.0,255,3.0,227
1301,695,237,17.57750566893424,19.574421768707484,8.0,34.0,466,2.0,458
1302,695,607,17.57750566893424,18.808163265306124,8.0,20.0,103,1.0,88
1303,695,613,17.57750566893424,19.969160997732427,8.0,20.0,132,2.0,82
1304,695,607,17.57750566893424,20.01560090702948,8.0,21.0,137,2.0,88
1305,695,623,17.57750566893424,18.808163265306124,8.0,19.0,89,1.0,72
1306,695,626,17.57750566893424,19.969160997732427,8.0,20.0,124,2.0,69
1307,695,631,17.57750566893424,19.99238095238095,8.0,21.0,122,2.0,64
1308,695,850,17.57750566893424,18.808163265306124,8.0,6.0,164,1.0,155
1309,695,828,17.57750566893424,19.945941043083902,8.0,-1.0,168,2.0,133
1310,695,830,17.57750566893424,20.06204081632653,8.0,7.0,172,2.0,135
1311,623,195,18.808163265306124,20.735419501133787,19.0,34.0,436,2.0,428
1312,623,247,18.808163265306124,20.735419501133787,19.0,34.0,385,2.0,376
1313,623,237,18.808163265306124,21.0140589569161,19.0,35.0,398,2.0,386
1314,623,613,18.808163265306124,19.969160997732427,19.0,20.0,51,1.0,10
1315,623,607,18.808163265306124,20.01560090702948,19.0,21.0,54,1.0,16
1316,623,456,18.808163265306124,21.199818594104308,19.0,14.0,196,2.0,167
1317,623,626,18.808163265306124,19.969160997732427,19.0,20.0,50,1.0,3
1318,623,631,18.808163265306124,19.99238095238095,19.0,21.0,52,1.0,8
1319,623,679,18.808163265306124,21.24625850340136,19.0,3.0,119,2.0,56
1320,623,828,18.808163265306124,19.945941043083902,19.0,-1.0,211,1.0,205
1321,623,830,18.808163265306124,20.06204081632653,19.0,7.0,214,1.0,207
1322,626,237,19.969160997732427,21.0140589569161,20.0,35.0,392,1.0,389
1323,626,244,19.969160997732427,22.38403628117914,20.0,27.0,396,2.0,382
1324,626,456,19.969160997732427,21.199818594104308,20.0,14.0,178,1.0,170
1325,626,467,19.969160997732427,22.175056689342405,20.0,7.0,185,2.0,159
1326,626,679,19.969160997732427,21.24625850340136,20.0,3.0,76,1.0,53
1327,626,654,19.969160997732427,22.84843537414966,20.0,1.0,127,3.0,28
1328,626,828,19.969160997732427,22.894875283446712,20.0,-6.0,238,3.0,202
1329,631,237,19.99238095238095,21.0140589569161,21.0,35.0,396,1.0,394
1330,631,244,19.99238095238095,22.38403628117914,21.0,27.0,400,2.0,387
1331,631,456,19.99238095238095,21.199818594104308,21.0,14.0,183,1.0,175
1332,631,467,19.99238095238095,22.175056689342405,21.0,7.0,189,2.0,164
1333,631,679,19.99238095238095,21.24625850340136,21.0,3.0,72,1.0,48
1334,631,654,19.99238095238095,22.84843537414966,21.0,1.0,125,3.0,23
1335,631,828,19.99238095238095,22.894875283446712,21.0,-6.0,233,3.0,197
1336,679,244,21.24625850340136,22.38403628117914,3.0,27.0,438,1.0,435
1337,679,233,21.24625850340136,23.359274376417233,3.0,24.0,455,2.0,446
1338,679,430,21.24625850340136,23.38249433106576,3.0,10.0,265,2.0,249
1339,679,654,21.24625850340136,22.84843537414966,3.0,1.0,73,2.0,25
1340,679,657,21.24625850340136,23.38249433106576,3.0,-4.0,95,2.0,22
1341,679,828,21.24625850340136,22.894875283446712,3.0,-6.0,165,2.0,149
1342,654,241,22.84843537414966,24.845351473922904,1.0,19.0,422,2.0,413
1343,654,219,22.84843537414966,25.193650793650793,1.0,20.0,447,2.0,435
1344,654,462,22.84843537414966,24.845351473922904,1.0,17.0,210,2.0,192
1345,654,451,22.84843537414966,25.193650793650793,1.0,17.0,227,2.0,203
1346,654,620,22.84843537414966,25.193650793650793,1.0,9.0,107,2.0,34
1347,657,241,23.38249433106576,24.845351473922904,-4.0,19.0,421,1.0,416
1348,657,219,23.38249433106576,25.193650793650793,-4.0,20.0,445,2.0,438
1349,657,462,23.38249433106576,24.845351473922904,-4.0,17.0,205,1.0,195
1350,657,451,23.38249433106576,25.193650793650793,-4.0,17.0,220,2.0,206
1351,657,620,23.38249433106576,25.193650793650793,-4.0,9.0,86,2.0,37
1352,620,145,25.193650793650793,27.353106575963718,9.0,33.0,484,2.0,475
1353,620,241,25.193650793650793,26.470748299319727,9.0,0.0,383,1.0,379
1354,620,233,25.193650793650793,27.724625850340136,9.0,35.0,402,3.0,387
1355,620,462,25.193650793650793,26.470748299319727,9.0,-5.0,167,1.0,158
1356,620,603,25.193650793650793,27.608526077097505,9.0,14.0,105,2.0,17
1357,620,618,25.193650793650793,27.538866213151927,9.0,15.0,101,2.0,2
1358,620,821,25.193650793650793,27.492426303854877,9.0,-1.0,224,2.0,201
1359,618,193,27.538866213151927,28.65342403628118,15.0,37.0,428,1.0,425
1360,618,242,27.538866213151927,28.699863945578233,15.0,36.0,379,1.0,376
1361,618,228,27.538866213151927,29.326802721088438,15.0,34.0,398,2.0,390
1362,618,462,27.538866213151927,28.95528344671202,15.0,15.0,168,1.0,156
1363,618,418,27.538866213151927,29.489342403628118,15.0,27.0,217,2.0,200
1364,618,654,27.538866213151927,28.699863945578233,15.0,13.0,62,1.0,36
1365,618,615,27.538866213151927,29.489342403628118,15.0,21.0,84,2.0,3
1366,618,822,27.538866213151927,28.676643990929705,15.0,-2.0,210,1.0,204
1367,618,820,27.538866213151927,29.489342403628118,15.0,-1.0,219,2.0,202
1368,654,204,28.699863945578233,31.32371882086168,13.0,35.0,464,3.0,450
1369,654,226,28.699863945578233,30.95219954648526,13.0,31.0,439,2.0,428
1370,654,227,28.699863945578233,31.2540589569161,13.0,37.0,441,3.0,427
1371,654,450,28.699863945578233,30.928979591836736,13.0,18.0,225,2.0,204
1372,654,611,28.699863945578233,31.277278911564625,13.0,13.0,119,3.0,43
1373,654,620,28.699863945578233,30.743219954648527,13.0,14.0,94,2.0,34
1374,654,658,28.699863945578233,31.32371882086168,13.0,14.0,113,3.0,4
1375,654,827,28.699863945578233,30.882539682539683,13.0,-4.0,197,2.0,173
1376,615,204,29.489342403628118,31.32371882086168,21.0,35.0,419,2.0,411
1377,615,226,29.489342403628118,30.95219954648526,21.0,31.0,394,1.0,389
1378,615,227,29.489342403628118,31.2540589569161,21.0,37.0,395,2.0,388
1379,615,450,29.489342403628118,30.928979591836736,21.0,18.0,176,1.0,165
1380,615,611,29.489342403628118,31.277278911564625,21.0,13.0,77,2.0,4
1381,615,620,29.489342403628118,30.743219954648527,21.0,14.0,54,1.0,5
1382,615,658,29.489342403628118,31.32371882086168,21.0,14.0,90,2.0,43
1383,615,827,29.489342403628118,30.882539682539683,21.0,-4.0,220,1.0,212
1384,615,830,29.489342403628118,31.764897959183674,21.0,-4.0,236,2.0,215
1385,620,238,30.743219954648527,32.60081632653061,14.0,38.0,390,2.0,382
1386,620,249,30.743219954648527,33.01877551020408,14.0,21.0,384,2.0,371
1387,620,450,30.743219954648527,32.57759637188209,14.0,13.0,187,2.0,170
1388,620,431,30.743219954648527,32.995555555555555,14.0,6.0,212,2.0,189
1389,620,643,30.743219954648527,32.62403628117914,14.0,11.0,84,2.0,23
1390,620,657,30.743219954648527,32.995555555555555,14.0,-4.0,104,2.0,37
1391,620,830,30.743219954648527,31.764897959183674,14.0,-4.0,215,1.0,210
1392,658,238,31.32371882086168,32.60081632653061,14.0,38.0,424,1.0,420
1393,658,249,31.32371882086168,33.01877551020408,14.0,21.0,415,2.0,409
1394,658,450,31.32371882086168,32.57759637188209,14.0,13.0,215,1.0,208
1395,658,431,31.32371882086168,32.995555555555555,14.0,6.0,238,2.0,227
1396,658,643,31.32371882086168,32.62403628117914,14.0,11.0,58,1.0,15
1397,658,657,31.32371882086168,32.995555555555555,14.0,-4.0,72,2.0,1
1398,643,236,32.62403628117914,34.71383219954649,11.0,35.0,417,2.0,407
1399,643,236,32.62403628117914,35.131791383219955,11.0,30.0,421,3.0,407
1400,643,544,32.62403628117914,34.57451247165533,11.0,13.0,130,2.0,99
1401,643,445,32.62403628117914,35.41043083900227,11.0,22.0,232,3.0,198
1402,643,635,32.62403628117914,34.59773242630386,11.0,10.0,85,2.0,8
1403,643,622,32.62403628117914,35.41043083900227,11.0,20.0,122,3.0,21
1404,643,940,32.62403628117914,34.59773242630386,11.0,-4.0,309,2.0,297
1405,643,834,32.62403628117914,35.43365079365079,11.0,1.0,226,3.0,191
1406,657,236,32.995555555555555,34.71383219954649,-4.0,35.0,427,2.0,421
1407,657,236,32.995555555555555,35.131791383219955,-4.0,30.0,431,2.0,421
1408,657,544,32.995555555555555,34.57451247165533,-4.0,13.0,132,2.0,113
1409,657,445,32.995555555555555,35.41043083900227,-4.0,22.0,236,2.0,212
1410,657,635,32.995555555555555,34.59773242630386,-4.0,10.0,72,2.0,22
1411,657,622,32.995555555555555,35.41043083900227,-4.0,20.0,110,2.0,35
1412,657,940,32.995555555555555,34.59773242630386,-4.0,-4.0,291,2.0,283
1413,657,834,32.995555555555555,35.43365079365079,-4.0,1.0,206,2.0,177
1414,635,232,34.59773242630386,36.78040816326531,10.0,28.0,414,2.0,403
1415,635,467,34.59773242630386,36.57142857142857,10.0,25.0,188,2.0,168
1416,635,625,34.59773242630386,36.5946485260771,10.0,19.0,87,2.0,10
1417,635,827,34.59773242630386,36.57142857142857,10.0,2.0,210,2.0,192
1418,622,232,35.41043083900227,36.78040816326531,20.0,28.0,394,1.0,390
1419,622,237,35.41043083900227,37.94140589569161,20.0,31.0,400,3.0,385
1420,622,232,35.41043083900227,38.05750566893424,20.0,31.0,406,3.0,390
1421,622,467,35.41043083900227,36.57142857142857,20.0,25.0,163,1.0,155
1422,622,508,35.41043083900227,37.94140589569161,20.0,12.0,158,3.0,114
1423,622,625,35.41043083900227,36.5946485260771,20.0,19.0,51,1.0,3
1424,622,636,35.41043083900227,37.94140589569161,20.0,-5.0,110,3.0,14
1425,622,827,35.41043083900227,36.57142857142857,20.0,2.0,211,1.0,205
1426,622,882,35.41043083900227,38.034285714285716,20.0,-1.0,283,3.0,260
1427,625,237,36.5946485260771,37.94140589569161,19.0,31.0,392,1.0,388
1428,625,232,36.5946485260771,38.05750566893424,19.0,31.0,398,1.0,393
1429,625,508,36.5946485260771,37.94140589569161,19.0,12.0,131,1.0,117
1430,625,449,36.5946485260771,38.684444444444445,19.0,14.0,198,2.0,176
1431,625,636,36.5946485260771,37.94140589569161,19.0,-5.0,59,1.0,11
1432,625,632,36.5946485260771,38.684444444444445,19.0,11.0,90,2.0,7
1433,625,882,36.5946485260771,38.034285714285716,19.0,-1.0,264,1.0,257
1434,636,242,37.94140589569161,39.7990022675737,-5.0,19.0,402,2.0,394
1435,636,237,37.94140589569161,40.14730158730159,-5.0,24.0,410,2.0,399
1436,636,468,37.94140589569161,39.891882086167804,-5.0,25.0,188,2.0,168
1437,636,461,37.94140589569161,39.9847619047619,-5.0,16.0,196,2.0,175
1438,636,631,37.94140589569161,39.86866213151927,-5.0,25.0,83,2.0,5
1439,636,625,37.94140589569161,39.9847619047619,-5.0,14.0,89,2.0,11
1440,636,830,37.94140589569161,39.891882086167804,-5.0,6.0,211,2.0,194
1441,636,821,37.94140589569161,39.9847619047619,-5.0,-2.0,205,2.0,185
1442,632,242,38.684444444444445,39.7990022675737,11.0,19.0,393,1.0,390
1443,632,237,38.684444444444445,40.14730158730159,11.0,24.0,400,1.0,395
1444,632,468,38.684444444444445,39.891882086167804,11.0,25.0,172,1.0,164
1445,632,461,38.684444444444445,39.9847619047619,11.0,16.0,180,1.0,171
1446,632,631,38.684444444444445,39.86866213151927,11.0,25.0,51,1.0,1
1447,632,625,38.684444444444445,39.9847619047619,11.0,14.0,56,1.0,7
1448,632,830,38.684444444444445,39.891882086167804,11.0,6.0,205,1.0,198
1449,632,821,38.684444444444445,39.9847619047619,11.0,-2.0,197,1.0,189
1450,631,136,39.86866213151927,42.58539682539683,25.0,33.0,509,3.0,495
1451,631,425,39.86866213151927,42.60861678004535,25.0,20.0,237,3.0,206
1452,631,831,39.86866213151927,42.58539682539683,25.0,-1.0,232,3.0,200
1453,625,136,39.9847619047619,42.58539682539683,14.0,33.0,502,3.0,489
1454,625,250,39.9847619047619,42.91047619047619,14.0,33.0,396,3.0,375
1455,625,425,39.9847619047619,42.60861678004535,14.0,20.0,230,3.0,200
1456,625,693,39.9847619047619,42.93369614512472,14.0,11.0,144,3.0,68
1457,625,831,39.9847619047619,42.58539682539683,14.0,-1.0,234,3.0,206
1458,693,233,42.93369614512472,44.0714739229025,11.0,34.0,463,1.0,460
1459,693,236,42.93369614512472,45.2324716553288,11.0,27.0,468,2.0,457
1460,693,432,42.93369614512472,44.419773242630384,11.0,17.0,269,1.0,261
1461,693,432,42.93369614512472,45.00027210884354,11.0,12.0,276,2.0,261
1462,693,642,42.93369614512472,44.88417233560091,11.0,12.0,98,2.0,51
1463,693,641,42.93369614512472,45.069931972789114,11.0,5.0,106,2.0,52
1464,693,824,42.93369614512472,44.02503401360544,11.0,-5.0,139,1.0,131
1465,627,236,43.885714285714286,45.2324716553288,15.0,27.0,395,1.0,391
1466,627,238,43.885714285714286,46.625668934240366,15.0,35.0,407,3.0,389
1467,627,432,43.885714285714286,45.00027210884354,15.0,12.0,201,1.0,195
1468,627,451,43.885714285714286,46.69532879818594,15.0,16.0,214,3.0,176
1469,627,641,43.885714285714286,45.069931972789114,15.0,5.0,53,1.0,14
1470,627,640,43.885714285714286,46.556009070294785,15.0,13.0,116,3.0,13
1471,627,827,43.885714285714286,46.556009070294785,15.0,-5.0,231,3.0,200
1472,642,238,44.88417233560091,46.625668934240366,12.0,35.0,411,2.0,404
1473,642,241,44.88417233560091,47.113287981859415,12.0,35.0,412,2.0,401
1474,642,451,44.88417233560091,46.69532879818594,12.0,16.0,206,2.0,191
1475,642,432,44.88417233560091,47.13650793650794,12.0,11.0,231,2.0,210
1476,642,640,44.88417233560091,46.556009070294785,12.0,13.0,72,2.0,2
1477,642,649,44.88417233560091,47.113287981859415,12.0,-0.0,96,2.0,7
1478,642,827,44.88417233560091,46.556009070294785,12.0,-5.0,199,2.0,185
1479,641,238,45.069931972789114,46.625668934240366,5.0,35.0,409,2.0,403
1480,641,241,45.069931972789114,47.113287981859415,5.0,35.0,410,2.0,400
1481,641,451,45.069931972789114,46.69532879818594,5.0,16.0,202,2.0,190
1482,641,432,45.069931972789114,47.13650793650794,5.0,11.0,227,2.0,209
1483,641,640,45.069931972789114,46.556009070294785,5.0,13.0,64,1.0,1
1484,641,649,45.069931972789114,47.113287981859415,5.0,-0.0,88,2.0,8
1485,641,827,45.069931972789114,46.556009070294785,5.0,-5.0,197,1.0,186
1486,640,247,46.556009070294785,48.34394557823129,13.0,22.0,400,2.0,393
1487,640,235,46.556009070294785,48.99410430839002,13.0,19.0,418,2.0,405
1488,640,465,46.556009070294785,48.06530612244898,13.0,19.0,187,2.0,175
1489,640,455,46.556009070294785,49.08698412698413,13.0,1.0,215,3.0,185
1490,640,644,46.556009070294785,48.11174603174603,13.0,16.0,67,2.0,4
1491,640,851,46.556009070294785,48.11174603174603,13.0,2.0,221,2.0,211
1492,649,247,47.113287981859415,48.34394557823129,-0.0,22.0,405,1.0,402
1493,649,235,47.113287981859415,48.99410430839002,-0.0,19.0,422,2.0,414
1494,649,455,47.113287981859415,49.08698412698413,-0.0,1.0,212,2.0,194
1495,644,219,48.11174603174603,50.549841269841274,16.0,27.0,438,2.0,425
1496,644,610,48.11174603174603,50.665941043083905,16.0,24.0,115,3.0,34
1497,644,622,48.11174603174603,50.665941043083905,16.0,24.0,112,3.0,22
1498,644,848,48.11174603174603,50.665941043083905,16.0,9.0,232,3.0,204
1499,622,228,50.665941043083905,52.523537414965986,24.0,31.0,402,2.0,394
1500,622,228,50.665941043083905,53.10403628117914,24.0,21.0,408,2.0,394
1501,622,411,50.665941043083905,51.757278911564626,24.0,20.0,216,1.0,211
1502,622,452,50.665941043083905,52.33777777777778,24.0,19.0,185,2.0,170
1503,622,645,50.665941043083905,52.33777777777778,24.0,12.0,76,2.0,23
1504,622,822,50.665941043083905,51.78049886621315,24.0,-2.0,206,1.0,200
1505,643,228,51.478639455782314,52.523537414965986,20.0,31.0,417,1.0,415
1506,643,228,51.478639455782314,53.10403628117914,20.0,21.0,421,2.0,415
1507,643,234,51.478639455782314,54.00961451247166,20.0,16.0,423,3.0,409
1508,643,499,51.478639455782314,53.823854875283445,20.0,29.0,176,2.0,144
1509,643,570,51.478639455782314,53.98639455782313,20.0,14.0,130,3.0,73
1510,643,625,51.478639455782314,53.80063492063492,20.0,25.0,102,2.0,18
1511,643,635,51.478639455782314,53.98639455782313,20.0,10.0,108,3.0,8
1512,643,826,51.478639455782314,53.84707482993198,20.0,4.0,210,2.0,183
1513,645,234,52.33777777777778,54.00961451247166,12.0,16.0,417,2.0,411
1514,645,499,52.33777777777778,53.823854875283445,12.0,29.0,159,1.0,146
1515,645,570,52.33777777777778,53.98639455782313,12.0,14.0,103,2.0,75
1516,645,412,52.33777777777778,55.193832199546485,12.0,1.0,263,3.0,233
1517,645,625,52.33777777777778,53.80063492063492,12.0,25.0,66,1.0,20
1518,645,635,52.33777777777778,53.98639455782313,12.0,10.0,72,2.0,10
1519,645,625,52.33777777777778,55.309931972789116,12.0,-1.0,130,3.0,20
1520,645,826,52.33777777777778,53.84707482993198,12.0,4.0,192,2.0,181
1521,625,239,53.80063492063492,55.33315192743764,25.0,26.0,392,2.0,386
1522,625,412,53.80063492063492,55.193832199546485,25.0,1.0,221,1.0,213
1523,635,239,53.98639455782313,55.33315192743764,10.0,26.0,400,1.0,396
1524,635,250,53.98639455782313,56.95854875283447,10.0,12.0,406,3.0,385
1525,635,412,53.98639455782313,55.193832199546485,10.0,1.0,229,1.0,223
1526,635,609,53.98639455782313,56.95854875283447,10.0,5.0,131,3.0,26
1527,635,625,53.98639455782313,55.309931972789116,10.0,-1.0,58,1.0,10
1528,625,250,55.309931972789116,56.95854875283447,-1.0,12.0,382,2.0,375
1529,625,230,55.309931972789116,57.23718820861678,-1.0,26.0,404,2.0,395
1530,625,407,55.309931972789116,58.18920634920635,-1.0,15.0,251,3.0,218
1531,625,609,55.309931972789116,56.95854875283447,-1.0,5.0,73,2.0,16
1532,625,597,55.309931972789116,57.283628117913835,-1.0,7.0,89,2.0,28
1533,625,417,55.309931972789116,58.16598639455783,-1.0,18.0,242,3.0,208
1534,625,635,55.309931972789116,56.95854875283447,-1.0,8.0,72,2.0,10
1535,625,622,55.309931972789116,56.98176870748299,-1.0,8.0,72,2.0,3
1536,625,637,55.309931972789116,58.16598639455783,-1.0,10.0,124,3.0,12
1537,635,407,56.95854875283447,58.18920634920635,8.0,15.0,234,1.0,228
1538,635,238,56.95854875283447,59.93070294784581,8.0,28.0,417,3.0,397
1539,635,417,56.95854875283447,58.16598639455783,8.0,18.0,224,1.0,218
1540,635,637,56.95854875283447,58.16598639455783,8.0,10.0,52,1.0,2
1541,635,632,56.95854875283447,59.93070294784581,8.0,-3.0,128,3.0,3
1542,622,407,56.98176870748299,58.18920634920635,8.0,15.0,221,1.0,215
1543,622,238,56.98176870748299,59.93070294784581,8.0,28.0,404,3.0,384
1544,622,417,56.98176870748299,58.16598639455783,8.0,18.0,211,1.0,205
1545,622,412,56.98176870748299,59.953922902494334,8.0,10.0,246,3.0,210
1546,622,637,56.98176870748299,58.16598639455783,8.0,10.0,53,1.0,15
1547,622,632,56.98176870748299,59.93070294784581,8.0,-3.0,127,3.0,10
1548,637,238,58.16598639455783,59.93070294784581,10.0,28.0,406,2.0,399
1549,637,412,58.16598639455783,59.953922902494334,10.0,10.0,238,2.0,225
1550,637,632,58.16598639455783,59.93070294784581,10.0,-3.0,76,2.0,5
1551,857,523,3.4597732426303858,5.596009070294785,0.0,16.0,346,2.0,334
1552,857,609,3.4597732426303858,6.03718820861678,0.0,22.0,272,3.0,248
1553,857,626,3.4597732426303858,5.61922902494331,0.0,9.0,249,2.0,231
1554,857,621,3.4597732426303858,6.060408163265306,0.0,20.0,261,3.0,236
1555,857,850,3.4597732426303858,6.060408163265306,0.0,3.0,112,3.0,7
1556,850,433,6.060408163265306,8.846802721088435,3.0,26.0,434,3.0,417
1557,850,624,6.060408163265306,7.9412244897959186,3.0,1.0,240,2.0,226
1558,850,621,6.060408163265306,8.846802721088435,3.0,15.0,259,3.0,229
1559,850,821,6.060408163265306,8.846802721088435,3.0,-2.0,123,3.0,29
1560,821,472,8.846802721088435,10.565079365079365,-2.0,22.0,357,2.0,349
1561,821,464,8.846802721088435,11.331337868480725,-2.0,17.0,373,2.0,357
1562,821,646,8.846802721088435,10.634739229024943,-2.0,18.0,191,2.0,175
1563,821,619,8.846802721088435,11.331337868480725,-2.0,7.0,229,2.0,202
1564,821,826,8.846802721088435,10.634739229024943,-2.0,2.0,77,2.0,5
1565,830,464,9.798820861678005,11.331337868480725,2.0,17.0,372,2.0,366
1566,830,619,9.798820861678005,11.331337868480725,2.0,7.0,221,2.0,211
1567,848,429,13.931972789115646,14.97687074829932,0.0,20.0,421,1.0,419
1568,848,456,13.931972789115646,15.000090702947846,0.0,20.0,395,1.0,392
1569,848,600,13.931972789115646,16.137868480725626,0.0,23.0,266,2.0,248
1570,848,643,13.931972789115646,15.000090702947846,0.0,13.0,210,1.0,205
1571,848,623,13.931972789115646,16.114648526077097,0.0,19.0,244,2.0,225
1572,848,832,13.931972789115646,15.371609977324264,0.0,-2.0,64,1.0,16
1573,848,828,13.931972789115646,16.62548752834467,0.0,0.0,118,3.0,20
1574,918,600,14.698231292517008,16.137868480725626,-1.0,23.0,324,1.0,318
1575,918,466,14.698231292517008,17.60072562358277,-1.0,15.0,469,3.0,452
1576,918,623,14.698231292517008,16.114648526077097,-1.0,19.0,301,1.0,295
1577,918,695,14.698231292517008,17.57750566893424,-1.0,8.0,255,3.0,223
1578,918,828,14.698231292517008,16.62548752834467,-1.0,0.0,122,2.0,90
1579,918,828,14.698231292517008,17.554285714285715,-1.0,-1.0,152,3.0,90
1580,832,466,15.371609977324264,17.60072562358277,-2.0,15.0,378,2.0,366
1581,832,695,15.371609977324264,17.57750566893424,-2.0,8.0,167,2.0,137
1582,832,828,15.371609977324264,16.62548752834467,-2.0,0.0,54,1.0,4
1583,832,828,15.371609977324264,17.554285714285715,-2.0,-1.0,94,2.0,4
1584,828,607,16.62548752834467,18.808163265306124,0.0,20.0,240,2.0,221
1585,828,623,16.62548752834467,18.808163265306124,0.0,19.0,226,2.0,205
1586,828,850,16.62548752834467,18.808163265306124,0.0,6.0,97,2.0,22
1587,828,607,17.554285714285715,18.808163265306124,-1.0,20.0,228,1.0,221
1588,828,613,17.554285714285715,19.969160997732427,-1.0,20.0,239,2.0,215
1589,828,607,17.554285714285715,20.01560090702948,-1.0,21.0,245,2.0,221
1590,828,623,17.554285714285715,18.808163265306124,-1.0,19.0,212,1.0,205
1591,828,626,17.554285714285715,19.969160997732427,-1.0,20.0,227,2.0,202
1592,828,631,17.554285714285715,19.99238095238095,-1.0,21.0,223,2.0,197
1593,828,850,17.554285714285715,18.808163265306124,-1.0,6.0,58,1.0,22
1594,828,830,17.554285714285715,20.06204081632653,-1.0,7.0,108,3.0,2
1595,850,613,18.808163265306124,19.969160997732427,6.0,20.0,242,1.0,237
1596,850,607,18.808163265306124,20.01560090702948,6.0,21.0,249,1.0,243
1597,850,456,18.808163265306124,21.199818594104308,6.0,14.0,407,2.0,394
1598,850,626,18.808163265306124,19.969160997732427,6.0,20.0,230,1.0,224
1599,850,631,18.808163265306124,19.99238095238095,6.0,21.0,225,1.0,219
1600,850,679,18.808163265306124,21.24625850340136,6.0,3.0,201,2.0,171
1601,850,828,18.808163265306124,19.945941043083902,6.0,-1.0,54,1.0,22
1602,850,830,18.808163265306124,20.06204081632653,6.0,7.0,58,1.0,20
1603,828,456,19.945941043083902,21.199818594104308,-1.0,14.0,376,1.0,372
1604,828,467,19.945941043083902,22.175056689342405,-1.0,7.0,374,2.0,361
1605,828,679,19.945941043083902,21.24625850340136,-1.0,3.0,159,1.0,149
1606,828,654,19.945941043083902,22.84843537414966,-1.0,1.0,214,3.0,174
1607,830,456,20.06204081632653,21.199818594104308,7.0,14.0,377,1.0,374
1608,830,467,20.06204081632653,22.175056689342405,7.0,7.0,374,2.0,363
1609,830,679,20.06204081632653,21.24625850340136,7.0,3.0,159,1.0,151
1610,830,654,20.06204081632653,22.84843537414966,7.0,1.0,213,3.0,176
1611,830,828,20.06204081632653,22.894875283446712,7.0,-6.0,122,3.0,2
1612,828,462,22.894875283446712,24.845351473922904,-6.0,17.0,376,2.0,366
1613,828,451,22.894875283446712,25.193650793650793,-6.0,17.0,390,2.0,377
1614,828,620,22.894875283446712,25.193650793650793,-6.0,9.0,230,2.0,208
1615,821,462,27.492426303854877,28.95528344671202,-1.0,15.0,364,1.0,359
1616,821,418,27.492426303854877,29.489342403628118,-1.0,27.0,412,2.0,403
1617,821,654,27.492426303854877,28.699863945578233,-1.0,13.0,175,1.0,167
1618,821,615,27.492426303854877,29.489342403628118,-1.0,21.0,223,2.0,206
1619,821,822,27.492426303854877,28.676643990929705,-1.0,-2.0,51,1.0,1
1620,821,820,27.492426303854877,29.489342403628118,-1.0,-1.0,86,2.0,1
1621,822,450,28.676643990929705,30.928979591836736,-2.0,18.0,384,2.0,372
1622,822,611,28.676643990929705,31.277278911564625,-2.0,13.0,239,3.0,211
1623,822,620,28.676643990929705,30.743219954648527,-2.0,14.0,221,2.0,202
1624,822,658,28.676643990929705,31.32371882086168,-2.0,14.0,200,3.0,164
1625,822,827,28.676643990929705,30.882539682539683,-2.0,-4.0,95,2.0,5
1626,820,450,29.489342403628118,30.928979591836736,-1.0,18.0,375,1.0,370
1627,820,611,29.489342403628118,31.277278911564625,-1.0,13.0,223,2.0,209
1628,820,620,29.489342403628118,30.743219954648527,-1.0,14.0,207,1.0,200
1629,820,658,29.489342403628118,31.32371882086168,-1.0,14.0,180,2.0,162
1630,820,827,29.489342403628118,30.882539682539683,-1.0,-4.0,60,1.0,7
1631,820,830,29.489342403628118,31.764897959183674,-1.0,-4.0,99,2.0,10
1632,827,450,30.882539682539683,32.57759637188209,-4.0,13.0,384,2.0,377
1633,827,431,30.882539682539683,32.995555555555555,-4.0,6.0,406,2.0,396
1634,827,643,30.882539682539683,32.62403628117914,-4.0,11.0,199,2.0,184
1635,827,657,30.882539682539683,32.995555555555555,-4.0,-4.0,193,2.0,170
1636,830,431,31.764897959183674,32.995555555555555,-4.0,6.0,403,1.0,399
1637,830,544,31.764897959183674,34.57451247165533,-4.0,13.0,311,3.0,286
1638,830,657,31.764897959183674,32.995555555555555,-4.0,-4.0,181,1.0,173
1639,830,635,31.764897959183674,34.59773242630386,-4.0,10.0,230,3.0,195
1640,830,940,31.764897959183674,34.59773242630386,-4.0,-4.0,164,3.0,110
1641,940,467,34.59773242630386,36.57142857142857,-4.0,25.0,481,2.0,473
1642,940,625,34.59773242630386,36.5946485260771,-4.0,19.0,327,2.0,315
1643,940,827,34.59773242630386,36.57142857142857,-4.0,2.0,141,2.0,113
1644,834,467,35.43365079365079,36.57142857142857,1.0,25.0,370,1.0,367
1645,834,508,35.43365079365079,37.94140589569161,1.0,12.0,343,3.0,326
1646,834,625,35.43365079365079,36.5946485260771,1.0,19.0,215,1.0,209
1647,834,636,35.43365079365079,37.94140589569161,1.0,-5.0,226,3.0,198
1648,834,827,35.43365079365079,36.57142857142857,1.0,2.0,49,1.0,7
1649,834,882,35.43365079365079,38.034285714285716,1.0,-1.0,122,3.0,48
1650,827,508,36.57142857142857,37.94140589569161,2.0,12.0,324,1.0,319
1651,827,449,36.57142857142857,38.684444444444445,2.0,14.0,389,2.0,378
1652,827,636,36.57142857142857,37.94140589569161,2.0,-5.0,200,1.0,191
1653,827,632,36.57142857142857,38.684444444444445,2.0,11.0,215,2.0,195
1654,827,882,36.57142857142857,38.034285714285716,2.0,-1.0,84,1.0,55
1655,882,468,38.034285714285716,39.891882086167804,-1.0,25.0,422,2.0,414
1656,882,461,38.034285714285716,39.9847619047619,-1.0,16.0,429,2.0,421
1657,882,631,38.034285714285716,39.86866213151927,-1.0,25.0,263,2.0,251
1658,882,625,38.034285714285716,39.9847619047619,-1.0,14.0,270,2.0,257
1659,882,830,38.034285714285716,39.891882086167804,-1.0,6.0,95,2.0,52
1660,882,821,38.034285714285716,39.9847619047619,-1.0,-2.0,104,2.0,61
1661,830,425,39.891882086167804,42.60861678004535,6.0,20.0,422,3.0,405
1662,830,831,39.891882086167804,42.58539682539683,6.0,-1.0,116,3.0,1
1663,821,425,39.9847619047619,42.60861678004535,-2.0,20.0,412,3.0,396
1664,821,693,39.9847619047619,42.93369614512472,-2.0,11.0,180,3.0,128
1665,821,831,39.9847619047619,42.58539682539683,-2.0,-1.0,112,3.0,10
1666,831,432,42.58539682539683,44.419773242630384,-1.0,17.0,407,2.0,399
1667,831,432,42.58539682539683,45.00027210884354,-1.0,12.0,412,2.0,399
1668,831,627,42.58539682539683,43.885714285714286,-1.0,15.0,212,1.0,204
1669,831,642,42.58539682539683,44.88417233560091,-1.0,12.0,213,2.0,189
1670,831,641,42.58539682539683,45.069931972789114,-1.0,5.0,218,2.0,190
1671,831,826,42.58539682539683,43.81605442176871,-1.0,1.0,53,1.0,5
1672,831,824,42.58539682539683,44.02503401360544,-1.0,-5.0,62,1.0,7
1673,826,432,43.81605442176871,45.00027210884354,1.0,12.0,397,1.0,394
1674,826,451,43.81605442176871,46.69532879818594,1.0,16.0,395,3.0,375
1675,826,642,43.81605442176871,44.88417233560091,1.0,12.0,190,1.0,184
1676,826,641,43.81605442176871,45.069931972789114,1.0,5.0,193,1.0,185
1677,826,640,43.81605442176871,46.556009070294785,1.0,13.0,220,3.0,186
1678,826,827,43.81605442176871,46.556009070294785,1.0,-5.0,118,3.0,1
1679,824,451,44.02503401360544,46.69532879818594,-5.0,16.0,390,3.0,373
1680,824,641,44.02503401360544,45.069931972789114,-5.0,5.0,188,1.0,183
1681,824,640,44.02503401360544,46.556009070294785,-5.0,13.0,214,3.0,184
1682,824,827,44.02503401360544,46.556009070294785,-5.0,-5.0,109,3.0,3
1683,827,465,46.556009070294785,48.06530612244898,-5.0,19.0,368,2.0,362
1684,827,455,46.556009070294785,49.08698412698413,-5.0,1.0,388,3.0,372
1685,827,644,46.556009070294785,48.11174603174603,-5.0,16.0,195,2.0,183
1686,827,851,46.556009070294785,48.11174603174603,-5.0,2.0,71,2.0,24
1687,851,610,48.11174603174603,50.665941043083905,2.0,24.0,265,3.0,241
1688,851,622,48.11174603174603,50.665941043083905,2.0,24.0,254,3.0,229
1689,851,848,48.11174603174603,50.665941043083905,2.0,9.0,110,3.0,3
1690,848,411,50.665941043083905,51.757278911564626,9.0,20.0,440,1.0,437
1691,848,452,50.665941043083905,52.33777777777778,9.0,19.0,402,2.0,396
1692,848,645,50.665941043083905,52.33777777777778,9.0,12.0,215,2.0,203
1693,848,822,50.665941043083905,51.78049886621315,9.0,-2.0,55,1.0,26
1694,822,499,51.78049886621315,53.823854875283445,-2.0,29.0,335,2.0,323
1695,822,570,51.78049886621315,53.98639455782313,-2.0,14.0,269,2.0,252
1696,822,625,51.78049886621315,53.80063492063492,-2.0,25.0,215,2.0,197
1697,822,635,51.78049886621315,53.98639455782313,-2.0,10.0,210,2.0,187
1698,822,826,51.78049886621315,53.84707482993198,-2.0,4.0,89,2.0,4
1699,826,412,53.84707482993198,55.193832199546485,4.0,1.0,418,1.0,414
1700,826,625,53.84707482993198,55.309931972789116,4.0,-1.0,211,1.0,201
