,f0,f1,t0,t1,dB0,dB1,dist,utime,ufreq
0,7,73,0.2089795918367347,1.9504761904761905,18.0,24.0,100,2.0,66
1,7,73,0.2089795918367347,2.4380952380952383,18.0,25.0,116,2.0,66
2,7,256,0.2089795918367347,2.9257142857142857,18.0,2.0,275,3.0,249
3,73,182,1.9504761904761905,4.365351473922901,24.0,32.0,151,2.0,109
4,73,219,1.9504761904761905,3.599092970521542,24.0,35.0,162,2.0,146
5,73,219,1.9504761904761905,3.993832199546485,24.0,32.0,170,2.0,146
6,73,443,1.9504761904761905,3.8777324263038553,24.0,20.0,379,2.0,370
7,73,504,1.9504761904761905,4.3421315192743775,24.0,22.0,443,2.0,431
8,73,182,2.4380952380952383,4.365351473922901,25.0,32.0,137,2.0,109
9,73,172,2.4380952380952383,5.085170068027211,25.0,29.0,151,3.0,99
10,73,219,2.4380952380952383,3.599092970521542,25.0,35.0,154,1.0,146
11,73,219,2.4380952380952383,3.993832199546485,25.0,32.0,161,2.0,146
12,73,218,2.4380952380952383,5.224489795918368,25.0,27.0,188,3.0,145
13,73,443,2.4380952380952383,3.8777324263038553,25.0,20.0,375,1.0,370
14,73,504,2.4380952380952383,4.3421315192743775,25.0,22.0,439,2.0,431
15,73,506,2.4380952380952383,5.224489795918368,25.0,21.0,449,3.0,433
16,73,172,3.3668934240362813,5.085170068027211,40.0,29.0,124,2.0,99
17,73,87,3.3668934240362813,6.03718820861678,40.0,23.0,116,3.0,14
18,73,218,3.3668934240362813,5.224489795918368,40.0,27.0,166,2.0,145
19,73,249,3.3668934240362813,6.03718820861678,40.0,20.0,210,3.0,176
20,73,506,3.3668934240362813,5.224489795918368,40.0,21.0,440,2.0,433
21,73,419,3.3668934240362813,6.060408163265307,40.0,13.0,365,3.0,346
22,182,87,4.365351473922901,6.03718820861678,32.0,23.0,119,2.0,95
23,182,132,4.365351473922901,7.314285714285713,32.0,21.0,136,3.0,50
24,182,249,4.365351473922901,6.03718820861678,32.0,20.0,98,2.0,67
25,182,224,4.365351473922901,7.198185941043084,32.0,11.0,129,3.0,42
26,182,419,4.365351473922901,6.060408163265307,32.0,13.0,248,2.0,237
27,172,132,5.085170068027211,7.314285714285713,29.0,21.0,104,2.0,40
28,172,224,5.085170068027211,7.198185941043084,29.0,11.0,105,2.0,52
29,172,489,5.085170068027211,7.8947845804988654,29.0,0.0,339,3.0,317
30,87,132,6.03718820861678,7.314285714285713,23.0,21.0,71,1.0,45
31,87,43,6.03718820861678,8.428843537414966,23.0,14.0,112,2.0,44
32,87,224,6.03718820861678,7.198185941043084,23.0,11.0,146,1.0,137
33,87,205,6.03718820861678,8.266303854875284,23.0,11.0,152,2.0,118
34,87,489,6.03718820861678,7.8947845804988654,23.0,0.0,410,2.0,402
35,87,506,6.03718820861678,8.243083900226758,23.0,2.0,430,2.0,419
36,132,43,7.314285714285713,8.428843537414966,21.0,14.0,101,1.0,89
37,132,44,7.314285714285713,9.241541950113382,21.0,14.0,121,2.0,88
38,132,43,7.314285714285713,10.193560090702947,21.0,10.0,153,3.0,89
39,132,231,7.314285714285713,9.566621315192744,21.0,6.0,139,2.0,99
40,132,450,7.314285714285713,9.798820861678005,21.0,7.0,336,2.0,318
41,132,455,7.314285714285713,10.00780045351474,21.0,2.0,343,3.0,323
42,43,89,8.428843537414966,11.122358276643991,14.0,10.0,125,3.0,46
43,43,231,8.428843537414966,9.566621315192744,14.0,6.0,194,1.0,188
44,43,254,8.428843537414966,10.425759637188207,14.0,1.0,228,2.0,211
45,43,232,8.428843537414966,11.122358276643991,14.0,10.0,222,3.0,189
46,43,450,8.428843537414966,9.798820861678005,14.0,7.0,411,1.0,407
47,43,455,8.428843537414966,10.00780045351474,14.0,2.0,418,2.0,412
48,44,89,9.241541950113382,11.122358276643991,14.0,10.0,93,2.0,45
49,44,254,9.241541950113382,10.425759637188207,14.0,1.0,216,1.0,210
50,44,232,9.241541950113382,11.122358276643991,14.0,10.0,205,2.0,188
51,43,232,10.193560090702947,12.329795918367347,10.0,12.0,210,2.0,189
52,43,438,10.193560090702947,12.353015873015876,10.0,8.0,406,2.0,395
53,89,43,11.122358276643991,12.956734693877552,10.0,9.0,91,2.0,46
54,89,109,11.122358276643991,13.653333333333334,10.0,19.0,111,3.0,20
55,89,232,11.122358276643991,12.329795918367347,10.0,12.0,152,1.0,143
56,89,218,11.122358276643991,13.862312925170068,10.0,7.0,175,3.0,129
57,89,438,11.122358276643991,12.353015873015876,10.0,8.0,353,1.0,349
58,89,437,11.122358276643991,13.281814058956915,10.0,5.0,360,2.0,348
59,43,195,12.956734693877552,14.953650793650795,9.0,24.0,175,2.0,152
60,43,195,12.956734693877552,15.557369614512472,9.0,27.0,189,3.0,152
61,43,243,12.956734693877552,14.837551020408164,9.0,24.0,216,2.0,200
62,43,243,12.956734693877552,15.046530612244899,9.0,25.0,219,2.0,200
63,43,497,12.956734693877552,14.25705215419501,9.0,4.0,457,1.0,454
64,43,455,12.956734693877552,15.928888888888887,9.0,13.0,431,3.0,412
65,109,195,13.653333333333334,14.953650793650795,19.0,24.0,103,1.0,86
66,109,195,13.653333333333334,15.557369614512472,19.0,27.0,119,2.0,86
67,109,243,13.653333333333334,14.837551020408164,19.0,24.0,143,1.0,134
68,109,243,13.653333333333334,15.046530612244899,19.0,25.0,147,1.0,134
69,109,455,13.653333333333334,15.928888888888887,19.0,13.0,360,2.0,346
70,195,73,14.953650793650795,16.741587301587302,24.0,27.0,144,2.0,122
71,195,73,14.953650793650795,17.22920634920635,24.0,28.0,156,2.0,122
72,195,218,14.953650793650795,16.857687074829933,24.0,31.0,85,2.0,23
73,195,218,14.953650793650795,17.69360544217687,24.0,31.0,120,3.0,23
74,195,437,14.953650793650795,16.857687074829933,24.0,21.0,256,2.0,242
75,195,437,14.953650793650795,17.809705215419505,24.0,23.0,271,3.0,242
76,195,661,14.953650793650795,16.880907029478458,24.0,2.0,473,2.0,466
77,195,649,14.953650793650795,17.69360544217687,24.0,5.0,469,3.0,454
78,195,73,15.557369614512472,16.741587301587302,27.0,27.0,132,1.0,122
79,195,73,15.557369614512472,17.22920634920635,27.0,28.0,142,2.0,122
80,195,73,15.557369614512472,18.18122448979592,27.0,29.0,166,3.0,122
81,195,218,15.557369614512472,16.857687074829933,27.0,31.0,61,1.0,23
82,195,218,15.557369614512472,17.69360544217687,27.0,31.0,95,2.0,23
83,195,219,15.557369614512472,18.274104308390022,27.0,31.0,119,3.0,24
84,195,437,15.557369614512472,16.857687074829933,27.0,21.0,248,1.0,242
85,195,437,15.557369614512472,17.809705215419505,27.0,23.0,261,2.0,242
86,195,437,15.557369614512472,18.29732426303855,27.0,21.0,269,3.0,242
87,195,661,15.557369614512472,16.880907029478458,27.0,2.0,469,1.0,466
88,195,649,15.557369614512472,17.69360544217687,27.0,5.0,463,2.0,454
89,195,662,15.557369614512472,18.320544217687075,27.0,3.0,482,3.0,467
90,73,88,16.741587301587302,19.295782312925173,27.0,27.0,111,3.0,15
91,73,219,16.741587301587302,18.274104308390022,27.0,31.0,160,2.0,146
92,73,246,16.741587301587302,19.574421768707484,27.0,26.0,212,3.0,173
93,73,437,16.741587301587302,17.809705215419505,27.0,23.0,367,1.0,364
94,73,437,16.741587301587302,18.29732426303855,27.0,21.0,370,2.0,364
95,73,410,16.741587301587302,19.574421768707484,27.0,19.0,358,3.0,337
96,73,88,17.22920634920635,19.295782312925173,28.0,27.0,90,2.0,15
97,73,219,17.22920634920635,18.274104308390022,28.0,31.0,153,1.0,146
98,73,246,17.22920634920635,19.574421768707484,28.0,26.0,200,2.0,173
99,73,437,17.22920634920635,18.29732426303855,28.0,21.0,367,1.0,364
100,73,410,17.22920634920635,19.574421768707484,28.0,19.0,352,2.0,337
101,73,88,18.18122448979592,19.295782312925173,29.0,27.0,50,1.0,15
102,73,182,18.18122448979592,20.54965986394558,29.0,31.0,149,2.0,109
103,73,195,18.18122448979592,21.03727891156463,29.0,29.0,173,3.0,122
104,73,246,18.18122448979592,19.574421768707484,29.0,26.0,183,1.0,173
105,73,255,18.18122448979592,20.572879818594107,29.0,29.0,209,2.0,182
106,73,243,18.18122448979592,21.03727891156463,29.0,31.0,210,3.0,170
107,73,410,18.18122448979592,19.574421768707484,29.0,19.0,342,1.0,337
108,73,468,18.18122448979592,20.52643990929705,29.0,21.0,408,2.0,395
109,73,438,18.18122448979592,21.03727891156463,29.0,23.0,385,3.0,365
110,88,182,19.295782312925173,20.54965986394558,27.0,31.0,108,1.0,94
111,88,195,19.295782312925173,21.03727891156463,27.0,29.0,131,2.0,107
112,88,255,19.295782312925173,20.572879818594107,27.0,29.0,176,1.0,167
113,88,243,19.295782312925173,21.03727891156463,27.0,31.0,172,2.0,155
114,88,468,19.295782312925173,20.52643990929705,27.0,21.0,384,1.0,380
115,88,438,19.295782312925173,21.03727891156463,27.0,23.0,358,2.0,350
116,88,450,19.295782312925173,22.01251700680272,27.0,22.0,380,3.0,362
117,182,194,20.54965986394558,22.964535147392287,31.0,30.0,105,2.0,12
118,182,195,20.54965986394558,22.98775510204082,31.0,30.0,106,2.0,13
119,182,243,20.54965986394558,22.964535147392287,31.0,32.0,121,2.0,61
120,182,243,20.54965986394558,22.98775510204082,31.0,32.0,121,2.0,61
121,182,450,20.54965986394558,22.01251700680272,31.0,22.0,275,1.0,268
122,182,438,20.54965986394558,22.98775510204082,31.0,22.0,277,2.0,256
123,182,638,20.54965986394558,22.964535147392287,31.0,8.0,468,2.0,456
124,182,615,20.54965986394558,23.38249433106576,31.0,7.0,450,3.0,433
125,195,194,21.03727891156463,22.964535147392287,29.0,30.0,83,2.0,1
126,195,243,21.03727891156463,22.964535147392287,29.0,32.0,96,2.0,48
127,195,243,21.03727891156463,22.98775510204082,29.0,32.0,97,2.0,48
128,195,438,21.03727891156463,22.98775510204082,29.0,22.0,257,2.0,243
129,195,638,21.03727891156463,22.964535147392287,29.0,8.0,451,2.0,443
130,195,615,21.03727891156463,23.38249433106576,29.0,7.0,432,2.0,420
131,194,86,22.964535147392287,24.636371882086173,30.0,31.0,130,2.0,108
132,194,86,22.964535147392287,25.007891156462588,30.0,34.0,139,2.0,108
133,194,255,22.964535147392287,24.96145124716553,30.0,30.0,105,2.0,61
134,194,255,22.964535147392287,25.44907029478458,30.0,30.0,123,2.0,61
135,194,417,22.964535147392287,24.79891156462585,30.0,22.0,237,2.0,223
136,194,486,22.964535147392287,25.309750566893424,30.0,23.0,309,2.0,292
137,194,661,22.964535147392287,24.357732426303848,30.0,5.0,471,1.0,467
138,195,86,22.98775510204082,24.636371882086173,30.0,31.0,130,2.0,109
139,195,86,22.98775510204082,25.007891156462588,30.0,34.0,139,2.0,109
140,195,255,22.98775510204082,24.96145124716553,30.0,30.0,104,2.0,60
141,195,255,22.98775510204082,25.44907029478458,30.0,30.0,122,2.0,60
142,195,417,22.98775510204082,24.79891156462585,30.0,22.0,235,2.0,222
143,195,486,22.98775510204082,25.309750566893424,30.0,23.0,308,2.0,291
144,195,661,22.98775510204082,24.357732426303848,30.0,5.0,470,1.0,466
145,86,87,24.636371882086173,27.422766439909296,31.0,31.0,120,3.0,1
146,86,219,24.636371882086173,26.21532879818594,31.0,30.0,149,2.0,133
147,86,260,24.636371882086173,27.445986394557824,31.0,29.0,212,3.0,174
148,86,486,24.636371882086173,26.72616780045352,31.0,24.0,410,2.0,400
149,86,439,24.636371882086173,27.422766439909296,31.0,24.0,373,3.0,353
150,86,87,25.007891156462588,27.422766439909296,34.0,31.0,104,2.0,1
151,86,219,25.007891156462588,26.21532879818594,34.0,30.0,143,1.0,133
152,86,260,25.007891156462588,27.445986394557824,34.0,29.0,203,2.0,174
153,86,486,25.007891156462588,26.72616780045352,34.0,24.0,407,2.0,400
154,86,439,25.007891156462588,27.422766439909296,34.0,24.0,368,2.0,353
155,86,195,26.935147392290247,28.65342403628118,31.0,30.0,132,2.0,109
156,86,204,26.935147392290247,29.628662131519274,31.0,28.0,165,3.0,118
157,86,243,26.935147392290247,28.676643990929705,31.0,30.0,174,2.0,157
158,86,218,26.935147392290247,29.094603174603176,31.0,30.0,161,2.0,132
159,86,439,26.935147392290247,28.630204081632648,31.0,22.0,360,2.0,353
160,86,441,26.935147392290247,29.094603174603176,31.0,22.0,367,2.0,355
161,87,195,27.422766439909296,28.65342403628118,31.0,30.0,120,1.0,108
162,87,204,27.422766439909296,29.628662131519274,31.0,28.0,151,2.0,117
163,87,243,27.422766439909296,28.676643990929705,31.0,30.0,165,1.0,156
164,87,218,27.422766439909296,29.094603174603176,31.0,30.0,149,2.0,131
165,87,439,27.422766439909296,28.630204081632648,31.0,22.0,356,1.0,352
166,87,441,27.422766439909296,29.094603174603176,31.0,22.0,361,2.0,354
167,195,182,28.65342403628118,31.532698412698412,30.0,29.0,125,3.0,13
168,195,242,28.65342403628118,30.557460317460322,30.0,32.0,95,2.0,47
169,195,218,28.65342403628118,30.998639455782317,30.0,30.0,104,2.0,23
170,195,439,28.65342403628118,30.603900226757368,30.0,24.0,258,2.0,244
171,195,441,28.65342403628118,30.998639455782317,30.0,22.0,266,2.0,246
172,195,628,28.65342403628118,30.603900226757368,30.0,9.0,441,2.0,433
173,195,648,28.65342403628118,30.998639455782317,30.0,6.0,464,2.0,453
174,204,182,29.628662131519274,31.532698412698412,28.0,29.0,85,2.0,22
175,204,218,29.628662131519274,30.998639455782317,28.0,30.0,61,1.0,14
176,204,218,29.628662131519274,31.997097505668936,28.0,29.0,103,2.0,14
177,204,441,29.628662131519274,30.998639455782317,28.0,22.0,244,1.0,237
178,204,648,29.628662131519274,30.998639455782317,28.0,6.0,448,1.0,444
179,204,627,29.628662131519274,32.13641723356009,28.0,7.0,437,3.0,423
180,195,86,30.603900226757368,32.624036281179144,31.0,33.0,139,2.0,109
181,195,86,30.603900226757368,33.158095238095235,31.0,31.0,155,3.0,109
182,195,218,30.603900226757368,31.997097505668936,31.0,29.0,64,1.0,23
183,195,485,30.603900226757368,32.92589569160998,31.0,24.0,307,2.0,290
184,195,627,30.603900226757368,32.13641723356009,31.0,7.0,437,2.0,432
185,182,86,31.532698412698412,32.624036281179144,29.0,33.0,107,1.0,96
186,182,86,31.532698412698412,33.158095238095235,29.0,31.0,119,2.0,96
187,182,219,31.532698412698412,33.8314739229025,29.0,29.0,106,2.0,37
188,182,251,31.532698412698412,34.4584126984127,29.0,28.0,144,3.0,69
189,182,485,31.532698412698412,32.92589569160998,29.0,24.0,309,1.0,303
190,182,443,31.532698412698412,33.877913832199546,29.0,23.0,280,2.0,261
191,182,486,31.532698412698412,34.34231292517007,29.0,24.0,327,3.0,304
192,182,615,31.532698412698412,33.94757369614513,29.0,5.0,445,2.0,433
193,182,631,31.532698412698412,33.99401360544218,29.0,8.0,461,2.0,449
194,86,219,32.624036281179144,33.8314739229025,33.0,29.0,143,1.0,133
195,86,251,32.624036281179144,34.4584126984127,33.0,28.0,183,2.0,165
196,86,443,32.624036281179144,33.877913832199546,33.0,23.0,361,1.0,357
197,86,486,32.624036281179144,34.34231292517007,33.0,24.0,407,2.0,400
198,86,432,32.624036281179144,35.03891156462585,33.0,23.0,361,2.0,346
199,86,251,33.158095238095235,34.4584126984127,31.0,28.0,174,1.0,165
200,86,219,33.158095238095235,35.75873015873015,31.0,29.0,174,3.0,133
201,86,486,33.158095238095235,34.34231292517007,31.0,24.0,403,1.0,400
202,86,432,33.158095238095235,35.03891156462585,31.0,23.0,355,2.0,346
203,86,195,34.574512471655325,36.29278911564626,32.0,30.0,132,2.0,109
204,86,219,34.574512471655325,35.75873015873015,32.0,29.0,142,1.0,133
205,86,243,34.574512471655325,36.269569160997726,32.0,31.0,173,2.0,157
206,86,205,34.574512471655325,37.24480725623583,32.0,29.0,165,3.0,119
207,86,438,34.574512471655325,36.269569160997726,32.0,24.0,359,2.0,352
208,86,450,34.574512471655325,37.221587301587306,32.0,23.0,381,3.0,364
209,86,195,35.015691609977324,36.29278911564626,30.0,30.0,122,1.0,109
210,86,204,35.015691609977324,37.9181859410431,30.0,28.0,172,3.0,118
211,86,243,35.015691609977324,36.269569160997726,30.0,31.0,166,1.0,157
212,86,205,35.015691609977324,37.24480725623583,30.0,29.0,153,2.0,119
213,86,438,35.015691609977324,36.269569160997726,30.0,24.0,356,1.0,352
214,86,450,35.015691609977324,37.221587301587306,30.0,23.0,376,2.0,364
215,195,204,36.29278911564626,37.9181859410431,30.0,28.0,71,2.0,9
216,195,194,36.29278911564626,38.196825396825396,30.0,31.0,82,2.0,1
217,195,243,36.29278911564626,38.22004535147392,30.0,32.0,96,2.0,48
218,195,219,36.29278911564626,39.14884353741497,30.0,29.0,125,3.0,24
219,195,437,36.29278911564626,38.196825396825396,30.0,23.0,256,2.0,242
220,195,637,36.29278911564626,38.196825396825396,30.0,9.0,450,2.0,442
221,204,86,37.9181859410431,39.86866213151927,28.0,30.0,145,2.0,118
222,204,86,37.9181859410431,40.26340136054422,28.0,32.0,155,2.0,118
223,204,219,37.9181859410431,39.14884353741497,28.0,29.0,55,1.0,15
224,204,249,37.9181859410431,40.170521541950116,28.0,28.0,107,2.0,45
225,204,437,37.9181859410431,39.59002267573696,28.0,20.0,244,2.0,233
226,204,486,37.9181859410431,40.542040816326534,28.0,24.0,304,3.0,282
227,204,626,37.9181859410431,39.543582766439904,28.0,5.0,428,2.0,422
228,204,661,37.9181859410431,40.05442176870749,28.0,6.0,466,2.0,457
229,194,86,38.196825396825396,39.86866213151927,31.0,30.0,130,2.0,108
230,194,86,38.196825396825396,40.26340136054422,31.0,32.0,140,2.0,108
231,194,249,38.196825396825396,40.170521541950116,31.0,28.0,101,2.0,55
232,194,437,38.196825396825396,39.59002267573696,31.0,20.0,250,1.0,243
233,194,486,38.196825396825396,40.542040816326534,31.0,24.0,309,2.0,292
234,194,626,38.196825396825396,39.543582766439904,31.0,5.0,436,1.0,432
235,194,661,38.196825396825396,40.05442176870749,31.0,6.0,474,2.0,467
236,86,182,39.86866213151927,41.494058956916106,30.0,30.0,119,2.0,96
237,86,219,39.86866213151927,41.540498866213156,30.0,28.0,151,2.0,133
238,86,327,39.86866213151927,41.98167800453515,30.0,27.0,258,2.0,241
239,86,492,39.86866213151927,41.958458049886616,30.0,22.0,416,2.0,406
240,86,497,39.86866213151927,42.44607709750567,30.0,24.0,426,3.0,411
241,86,182,40.26340136054422,41.494058956916106,32.0,30.0,110,1.0,96
242,86,219,40.26340136054422,41.540498866213156,32.0,28.0,144,1.0,133
243,86,327,40.26340136054422,41.98167800453515,32.0,27.0,252,2.0,241
244,86,492,40.26340136054422,41.958458049886616,32.0,22.0,413,2.0,406
245,86,497,40.26340136054422,42.44607709750567,32.0,24.0,422,2.0,411
246,182,173,41.494058956916106,43.560634920634925,30.0,29.0,89,2.0,9
247,182,217,41.494058956916106,43.88571428571429,30.0,28.0,109,2.0,35
248,182,440,41.494058956916106,43.88571428571429,30.0,21.0,278,2.0,258
249,182,626,41.494058956916106,42.91047619047619,30.0,5.0,448,1.0,444
250,86,173,42.16743764172336,43.560634920634925,32.0,29.0,106,1.0,87
251,86,195,42.16743764172336,44.814512471655334,32.0,31.0,158,3.0,109
252,86,195,42.16743764172336,45.02349206349206,32.0,30.0,164,3.0,109
253,86,217,42.16743764172336,43.88571428571429,32.0,28.0,150,2.0,131
254,86,243,42.16743764172336,44.837732426303866,32.0,31.0,195,3.0,157
255,86,243,42.16743764172336,45.093151927437646,32.0,31.0,201,3.0,157
256,86,440,42.16743764172336,43.88571428571429,32.0,21.0,362,2.0,354
257,86,432,42.16743764172336,44.977052154195015,32.0,22.0,367,3.0,346
258,86,438,42.16743764172336,45.00027210884354,32.0,23.0,373,3.0,352
259,173,195,43.560634920634925,44.814512471655334,29.0,31.0,58,1.0,22
260,173,195,43.560634920634925,45.02349206349206,29.0,30.0,67,1.0,22
261,173,195,43.560634920634925,46.04517006802721,29.0,29.0,109,2.0,22
262,173,243,43.560634920634925,44.837732426303866,29.0,31.0,89,1.0,70
263,173,243,43.560634920634925,45.093151927437646,29.0,31.0,96,2.0,70
264,173,432,43.560634920634925,44.977052154195015,29.0,22.0,266,1.0,259
265,173,438,43.560634920634925,45.00027210884354,29.0,23.0,272,1.0,265
266,173,631,43.560634920634925,44.791292517006795,29.0,7.0,461,1.0,458
267,173,626,43.560634920634925,45.30213151927439,29.0,7.0,459,2.0,453
268,173,638,43.560634920634925,46.50956916099774,29.0,-0.0,482,3.0,465
269,195,146,44.814512471655334,47.43836734693878,31.0,28.0,123,3.0,49
270,195,219,44.814512471655334,46.857868480725635,31.0,30.0,91,2.0,24
271,195,219,44.814512471655334,47.670566893424045,31.0,32.0,125,3.0,24
272,195,504,44.814512471655334,46.881088435374146,31.0,20.0,322,2.0,309
273,195,437,44.814512471655334,47.69378684807257,31.0,23.0,272,3.0,242
274,195,638,44.814512471655334,46.50956916099774,31.0,-0.0,449,2.0,443
275,195,146,45.02349206349206,47.43836734693878,30.0,28.0,115,2.0,49
276,195,219,45.02349206349206,46.857868480725635,30.0,30.0,83,2.0,24
277,195,219,45.02349206349206,47.670566893424045,30.0,32.0,116,3.0,24
278,195,504,45.02349206349206,46.881088435374146,30.0,20.0,319,2.0,309
279,195,437,45.02349206349206,47.69378684807257,30.0,23.0,268,3.0,242
280,195,638,45.02349206349206,46.50956916099774,30.0,-0.0,448,1.0,443
281,195,146,46.04517006802721,47.43836734693878,29.0,28.0,77,1.0,49
282,195,73,46.04517006802721,48.181405895691604,29.0,24.0,153,2.0,122
283,195,219,46.04517006802721,47.670566893424045,29.0,32.0,74,2.0,24
284,195,218,46.04517006802721,48.181405895691604,29.0,28.0,95,2.0,23
285,195,437,46.04517006802721,47.69378684807257,29.0,23.0,252,2.0,242
286,195,443,46.04517006802721,48.785124716553284,29.0,20.0,275,3.0,248
287,146,73,47.43836734693878,49.13342403628118,28.0,26.0,103,2.0,73
288,146,218,47.43836734693878,49.24952380952381,28.0,28.0,106,2.0,72
289,146,205,47.43836734693878,50.0390022675737,28.0,27.0,127,3.0,59
290,146,443,47.43836734693878,48.785124716553284,28.0,20.0,303,1.0,297
291,146,437,47.43836734693878,49.24952380952381,28.0,19.0,301,2.0,291
292,146,452,47.43836734693878,50.41052154195012,28.0,17.0,332,3.0,306
293,146,632,47.43836734693878,49.24952380952381,28.0,2.0,492,2.0,486
294,73,181,48.181405895691604,50.526621315192735,24.0,24.0,148,2.0,108
295,73,153,48.181405895691604,51.13034013605442,24.0,17.0,150,3.0,80
296,73,218,48.181405895691604,49.24952380952381,24.0,28.0,152,1.0,145
297,73,205,48.181405895691604,50.0390022675737,24.0,27.0,154,2.0,132
298,73,437,48.181405895691604,49.24952380952381,24.0,19.0,367,1.0,364
299,73,452,48.181405895691604,50.41052154195012,24.0,17.0,391,2.0,379
300,73,499,48.181405895691604,51.13034013605442,24.0,11.0,445,3.0,426
301,73,181,49.13342403628118,50.526621315192735,26.0,24.0,124,1.0,108
302,73,153,49.13342403628118,51.13034013605442,26.0,17.0,117,2.0,80
303,73,243,49.13342403628118,51.54829931972789,26.0,18.0,199,2.0,170
304,73,452,49.13342403628118,50.41052154195012,26.0,17.0,383,1.0,379
305,73,499,49.13342403628118,51.13034013605442,26.0,11.0,435,2.0,426
306,181,82,50.526621315192735,52.50031746031746,24.0,17.0,130,2.0,99
307,181,195,50.526621315192735,53.475555555555566,24.0,17.0,128,3.0,14
308,181,243,50.526621315192735,51.54829931972789,24.0,18.0,76,1.0,62
309,181,245,50.526621315192735,52.87183673469388,24.0,16.0,120,2.0,64
310,181,244,50.526621315192735,53.475555555555566,24.0,16.0,142,3.0,63
311,181,497,50.526621315192735,52.77895691609978,24.0,12.0,331,2.0,316
312,181,438,50.526621315192735,53.475555555555566,24.0,10.0,287,3.0,257
313,181,628,50.526621315192735,51.85015873015873,24.0,1.0,451,1.0,447
314,153,82,51.13034013605442,52.50031746031746,17.0,17.0,92,1.0,71
315,153,195,51.13034013605442,53.475555555555566,17.0,17.0,109,2.0,42
316,153,245,51.13034013605442,52.87183673469388,17.0,16.0,119,2.0,92
317,153,244,51.13034013605442,53.475555555555566,17.0,16.0,136,2.0,91
318,153,497,51.13034013605442,52.77895691609978,17.0,12.0,351,2.0,344
319,153,438,51.13034013605442,53.475555555555566,17.0,10.0,302,2.0,285
320,82,182,52.50031746031746,54.86875283446712,17.0,24.0,143,2.0,100
321,82,218,52.50031746031746,54.89197278911565,17.0,21.0,171,2.0,136
322,82,417,52.50031746031746,54.961632653061216,17.0,15.0,351,2.0,335
323,195,182,53.475555555555566,54.86875283446712,17.0,24.0,61,1.0,13
324,195,87,53.475555555555566,55.542131519274385,17.0,33.0,140,2.0,108
325,195,87,53.475555555555566,55.98331065759637,17.0,28.0,153,3.0,108
326,195,218,53.475555555555566,54.89197278911565,17.0,21.0,65,1.0,23
327,195,259,53.475555555555566,55.49569160997733,17.0,30.0,108,2.0,64
328,195,259,53.475555555555566,56.029750566893426,17.0,28.0,127,3.0,64
329,195,417,53.475555555555566,54.961632653061216,17.0,15.0,231,1.0,222
330,195,432,53.475555555555566,55.49569160997733,17.0,23.0,252,2.0,237
331,195,438,53.475555555555566,56.0065306122449,17.0,23.0,266,3.0,243
332,195,648,53.475555555555566,55.309931972789116,17.0,0.0,460,2.0,453
333,182,87,54.86875283446712,55.98331065759637,24.0,28.0,106,1.0,95
334,182,259,54.86875283446712,56.029750566893426,24.0,28.0,92,1.0,77
335,182,438,54.86875283446712,56.0065306122449,24.0,23.0,261,1.0,256
336,182,628,54.86875283446712,56.58702947845804,24.0,1.0,452,2.0,446
337,87,86,55.542131519274385,57.933786848072565,33.0,34.0,103,2.0,1
338,87,259,55.542131519274385,57.933786848072565,33.0,28.0,200,2.0,172
339,87,438,55.542131519274385,57.933786848072565,33.0,21.0,366,2.0,351
340,87,86,55.98331065759637,57.933786848072565,28.0,34.0,84,2.0,1
341,87,53,55.98331065759637,58.83936507936508,28.0,26.0,128,3.0,34
342,87,259,55.98331065759637,57.933786848072565,28.0,28.0,191,2.0,172
343,87,218,55.98331065759637,58.909024943310655,28.0,29.0,182,3.0,131
344,87,438,55.98331065759637,57.933786848072565,28.0,21.0,361,2.0,351
345,87,441,55.98331065759637,58.909024943310655,28.0,19.0,376,3.0,354
346,86,195,57.933786848072565,59.11800453514739,34.0,31.0,120,1.0,109
347,86,244,57.933786848072565,59.141224489795924,34.0,29.0,166,1.0,158
348,86,439,57.933786848072565,59.11800453514739,34.0,25.0,357,1.0,353
349,256,73,1.1145578231292517,2.4380952380952383,3.0,25.0,192,1.0,183
350,256,73,1.1145578231292517,3.3668934240362813,3.0,40.0,207,2.0,183
351,256,219,1.1145578231292517,3.599092970521542,3.0,35.0,113,2.0,37
352,256,219,1.1145578231292517,3.993832199546485,3.0,32.0,129,3.0,37
353,256,443,1.1145578231292517,3.8777324263038553,3.0,20.0,222,3.0,187
354,256,632,1.1145578231292517,3.599092970521542,3.0,4.0,391,2.0,376
355,256,615,1.1145578231292517,4.08671201814059,3.0,6.0,381,3.0,359
356,256,182,2.9257142857142857,4.365351473922901,2.0,32.0,97,1.0,74
357,256,172,2.9257142857142857,5.085170068027211,2.0,29.0,125,2.0,84
358,256,219,2.9257142857142857,3.993832199546485,2.0,32.0,59,1.0,37
359,256,218,2.9257142857142857,5.224489795918368,2.0,27.0,106,2.0,38
360,256,504,2.9257142857142857,4.3421315192743775,2.0,22.0,255,1.0,248
361,256,506,2.9257142857142857,5.224489795918368,2.0,21.0,269,2.0,250
362,256,615,2.9257142857142857,4.08671201814059,2.0,6.0,362,1.0,359
363,256,636,2.9257142857142857,5.224489795918368,2.0,5.0,393,2.0,380
364,219,172,3.599092970521542,5.085170068027211,35.0,29.0,79,1.0,47
365,219,87,3.599092970521542,6.03718820861678,35.0,23.0,169,2.0,132
366,219,218,3.599092970521542,5.224489795918368,35.0,27.0,70,2.0,1
367,219,249,3.599092970521542,6.03718820861678,35.0,20.0,109,2.0,30
368,219,506,3.599092970521542,5.224489795918368,35.0,21.0,295,2.0,287
369,219,419,3.599092970521542,6.060408163265307,35.0,13.0,226,2.0,200
370,219,636,3.599092970521542,5.224489795918368,35.0,5.0,423,2.0,417
371,219,172,3.993832199546485,5.085170068027211,32.0,29.0,66,1.0,47
372,219,87,3.993832199546485,6.03718820861678,32.0,23.0,159,2.0,132
373,219,218,3.993832199546485,5.224489795918368,32.0,27.0,53,1.0,1
374,219,249,3.993832199546485,6.03718820861678,32.0,20.0,93,2.0,30
375,219,506,3.993832199546485,5.224489795918368,32.0,21.0,292,1.0,287
376,219,419,3.993832199546485,6.060408163265307,32.0,13.0,219,2.0,200
377,219,636,3.993832199546485,5.224489795918368,32.0,5.0,420,1.0,417
378,218,132,5.224489795918368,7.314285714285713,27.0,21.0,124,2.0,86
379,218,224,5.224489795918368,7.198185941043084,27.0,11.0,85,2.0,6
380,218,489,5.224489795918368,7.8947845804988654,27.0,0.0,294,3.0,271
381,249,132,6.03718820861678,7.314285714285713,20.0,21.0,129,1.0,117
382,249,43,6.03718820861678,8.428843537414966,20.0,14.0,230,2.0,206
383,249,224,6.03718820861678,7.198185941043084,20.0,11.0,56,1.0,25
384,249,205,6.03718820861678,8.266303854875284,20.0,11.0,106,2.0,44
385,249,489,6.03718820861678,7.8947845804988654,20.0,0.0,253,2.0,240
386,249,506,6.03718820861678,8.243083900226758,20.0,2.0,274,2.0,257
387,224,43,7.198185941043084,8.428843537414966,11.0,14.0,189,1.0,181
388,224,44,7.198185941043084,9.241541950113382,11.0,14.0,200,2.0,180
389,224,205,7.198185941043084,8.266303854875284,11.0,11.0,50,1.0,19
390,224,231,7.198185941043084,9.566621315192744,11.0,6.0,102,2.0,7
391,224,506,7.198185941043084,8.243083900226758,11.0,2.0,286,1.0,282
392,224,450,7.198185941043084,9.798820861678005,11.0,7.0,252,3.0,226
393,224,455,7.198185941043084,10.00780045351474,11.0,2.0,261,3.0,231
394,205,43,8.266303854875284,10.193560090702947,11.0,10.0,182,2.0,162
395,205,89,8.266303854875284,11.122358276643991,11.0,10.0,169,3.0,116
396,205,231,8.266303854875284,9.566621315192744,11.0,6.0,62,1.0,26
397,205,254,8.266303854875284,10.425759637188207,11.0,1.0,105,2.0,49
398,205,232,8.266303854875284,11.122358276643991,11.0,10.0,126,3.0,27
399,205,450,8.266303854875284,9.798820861678005,11.0,7.0,254,2.0,245
400,205,455,8.266303854875284,10.00780045351474,11.0,2.0,261,2.0,250
401,231,89,9.566621315192744,11.122358276643991,6.0,10.0,157,2.0,142
402,231,232,9.566621315192744,11.122358276643991,6.0,10.0,67,2.0,1
403,231,232,9.566621315192744,12.329795918367347,6.0,12.0,119,3.0,1
404,231,438,9.566621315192744,12.353015873015876,6.0,8.0,239,3.0,207
405,254,43,10.425759637188207,12.956734693877552,1.0,9.0,237,3.0,211
406,254,232,10.425759637188207,12.329795918367347,1.0,12.0,85,2.0,22
407,254,438,10.425759637188207,12.353015873015876,1.0,8.0,202,2.0,184
408,254,437,10.425759637188207,13.281814058956915,1.0,5.0,220,3.0,183
409,232,43,11.122358276643991,12.956734693877552,10.0,9.0,205,2.0,189
410,232,109,11.122358276643991,13.653333333333334,10.0,19.0,164,3.0,123
411,232,218,11.122358276643991,13.862312925170068,10.0,7.0,119,3.0,14
412,232,438,11.122358276643991,12.353015873015876,10.0,8.0,213,1.0,206
413,232,437,11.122358276643991,13.281814058956915,10.0,5.0,225,2.0,205
414,232,109,12.329795918367347,13.653333333333334,12.0,19.0,136,1.0,123
415,232,195,12.329795918367347,14.953650793650795,12.0,24.0,119,3.0,37
416,232,218,12.329795918367347,13.862312925170068,12.0,7.0,67,2.0,14
417,232,243,12.329795918367347,14.837551020408164,12.0,24.0,109,3.0,11
418,232,243,12.329795918367347,15.046530612244899,12.0,25.0,118,3.0,11
419,232,497,12.329795918367347,14.25705215419501,12.0,4.0,278,2.0,265
420,218,195,13.862312925170068,14.953650793650795,7.0,24.0,52,1.0,23
421,218,195,13.862312925170068,15.557369614512472,7.0,27.0,77,2.0,23
422,218,73,13.862312925170068,16.741587301587302,7.0,27.0,191,3.0,145
423,218,243,13.862312925170068,15.046530612244899,7.0,25.0,57,1.0,25
424,218,455,13.862312925170068,15.928888888888887,7.0,13.0,253,2.0,237
425,243,73,14.837551020408164,16.741587301587302,24.0,27.0,189,2.0,170
426,243,73,14.837551020408164,17.22920634920635,24.0,28.0,199,2.0,170
427,243,218,14.837551020408164,16.857687074829933,24.0,31.0,91,2.0,25
428,243,218,14.837551020408164,17.69360544217687,24.0,31.0,126,3.0,25
429,243,455,14.837551020408164,15.928888888888887,24.0,13.0,217,1.0,212
430,243,437,14.837551020408164,16.857687074829933,24.0,21.0,213,2.0,194
431,243,437,14.837551020408164,17.809705215419505,24.0,23.0,232,3.0,194
432,243,661,14.837551020408164,16.880907029478458,24.0,2.0,427,2.0,418
433,243,649,14.837551020408164,17.69360544217687,24.0,5.0,424,3.0,406
434,243,73,15.046530612244899,16.741587301587302,25.0,27.0,185,2.0,170
435,243,73,15.046530612244899,17.22920634920635,25.0,28.0,194,2.0,170
436,243,218,15.046530612244899,16.857687074829933,25.0,31.0,82,2.0,25
437,243,218,15.046530612244899,17.69360544217687,25.0,31.0,117,3.0,25
438,243,437,15.046530612244899,16.857687074829933,25.0,21.0,209,2.0,194
439,243,437,15.046530612244899,17.809705215419505,25.0,23.0,228,3.0,194
440,243,661,15.046530612244899,16.880907029478458,25.0,2.0,425,2.0,418
441,243,649,15.046530612244899,17.69360544217687,25.0,5.0,422,3.0,406
442,218,73,16.857687074829933,18.18122448979592,31.0,29.0,156,1.0,145
443,218,88,16.857687074829933,19.295782312925173,31.0,27.0,167,2.0,130
444,218,219,16.857687074829933,18.274104308390022,31.0,31.0,61,1.0,1
445,218,246,16.857687074829933,19.574421768707484,31.0,26.0,120,3.0,28
446,218,437,16.857687074829933,18.29732426303855,31.0,21.0,228,1.0,219
447,218,410,16.857687074829933,19.574421768707484,31.0,19.0,225,3.0,192
448,218,662,16.857687074829933,18.320544217687075,31.0,3.0,448,1.0,444
449,218,713,16.857687074829933,19.272562358276645,31.0,1.0,506,2.0,495
450,218,88,17.69360544217687,19.295782312925173,31.0,27.0,147,2.0,130
451,218,182,17.69360544217687,20.54965986394558,31.0,31.0,128,3.0,36
452,218,246,17.69360544217687,19.574421768707484,31.0,26.0,86,2.0,28
453,218,255,17.69360544217687,20.572879818594107,31.0,29.0,129,3.0,37
454,218,410,17.69360544217687,19.574421768707484,31.0,19.0,208,2.0,192
455,218,468,17.69360544217687,20.52643990929705,31.0,21.0,278,3.0,250
456,218,713,17.69360544217687,19.272562358276645,31.0,1.0,500,2.0,495
457,218,661,17.69360544217687,20.54965986394558,31.0,6.0,460,3.0,443
458,219,88,18.274104308390022,19.295782312925173,31.0,27.0,138,1.0,131
459,219,182,18.274104308390022,20.54965986394558,31.0,31.0,105,2.0,37
460,219,195,18.274104308390022,21.03727891156463,31.0,29.0,121,3.0,24
461,219,246,18.274104308390022,19.574421768707484,31.0,26.0,62,1.0,27
462,219,255,18.274104308390022,20.572879818594107,31.0,29.0,105,2.0,36
463,219,243,18.274104308390022,21.03727891156463,31.0,31.0,121,3.0,24
464,219,410,18.274104308390022,19.574421768707484,31.0,19.0,199,1.0,191
465,219,468,18.274104308390022,20.52643990929705,31.0,21.0,267,2.0,249
466,219,438,18.274104308390022,21.03727891156463,31.0,23.0,249,3.0,219
467,219,661,18.274104308390022,20.54965986394558,31.0,6.0,453,2.0,442
468,219,638,18.274104308390022,21.03727891156463,31.0,8.0,436,3.0,419
469,246,195,19.574421768707484,21.03727891156463,26.0,29.0,81,1.0,51
470,246,243,19.574421768707484,21.03727891156463,26.0,31.0,63,1.0,3
471,246,438,19.574421768707484,21.03727891156463,26.0,23.0,202,1.0,192
472,246,450,19.574421768707484,22.01251700680272,26.0,22.0,229,2.0,204
473,246,638,19.574421768707484,21.03727891156463,26.0,8.0,397,1.0,392
474,255,194,20.572879818594107,22.964535147392287,29.0,30.0,120,2.0,61
475,255,195,20.572879818594107,22.98775510204082,29.0,30.0,120,2.0,60
476,255,243,20.572879818594107,22.964535147392287,29.0,32.0,104,2.0,12
477,255,243,20.572879818594107,22.98775510204082,29.0,32.0,105,2.0,12
478,255,450,20.572879818594107,22.01251700680272,29.0,22.0,205,1.0,195
479,255,438,20.572879818594107,22.98775510204082,29.0,22.0,210,2.0,183
480,255,638,20.572879818594107,22.964535147392287,29.0,8.0,397,2.0,383
481,255,615,20.572879818594107,23.38249433106576,29.0,7.0,380,3.0,360
482,243,194,21.03727891156463,22.964535147392287,31.0,30.0,96,2.0,49
483,243,195,21.03727891156463,22.98775510204082,31.0,30.0,97,2.0,48
484,243,438,21.03727891156463,22.98775510204082,31.0,22.0,212,2.0,195
485,243,638,21.03727891156463,22.964535147392287,31.0,8.0,404,2.0,395
486,243,615,21.03727891156463,23.38249433106576,31.0,7.0,385,2.0,372
487,243,86,22.964535147392287,24.636371882086173,32.0,31.0,173,2.0,157
488,243,86,22.964535147392287,25.007891156462588,32.0,34.0,180,2.0,157
489,243,255,22.964535147392287,24.96145124716553,32.0,30.0,87,2.0,12
490,243,255,22.964535147392287,25.44907029478458,32.0,30.0,108,2.0,12
491,243,417,22.964535147392287,24.79891156462585,32.0,22.0,191,2.0,174
492,243,486,22.964535147392287,25.309750566893424,32.0,23.0,263,2.0,243
493,243,661,22.964535147392287,24.357732426303848,32.0,5.0,422,1.0,418
494,243,86,22.98775510204082,24.636371882086173,32.0,31.0,172,2.0,157
495,243,86,22.98775510204082,25.007891156462588,32.0,34.0,179,2.0,157
496,243,255,22.98775510204082,24.96145124716553,32.0,30.0,86,2.0,12
497,243,255,22.98775510204082,25.44907029478458,32.0,30.0,107,2.0,12
498,243,417,22.98775510204082,24.79891156462585,32.0,22.0,191,2.0,174
499,243,486,22.98775510204082,25.309750566893424,32.0,23.0,263,2.0,243
500,243,661,22.98775510204082,24.357732426303848,32.0,5.0,422,1.0,418
501,255,86,24.96145124716553,26.935147392290247,30.0,31.0,189,2.0,169
502,255,87,24.96145124716553,27.422766439909296,30.0,31.0,199,2.0,168
503,255,219,24.96145124716553,26.21532879818594,30.0,30.0,65,1.0,36
504,255,260,24.96145124716553,27.445986394557824,30.0,29.0,107,2.0,5
505,255,486,24.96145124716553,26.72616780045352,30.0,24.0,243,2.0,231
506,255,439,24.96145124716553,27.422766439909296,30.0,24.0,212,2.0,184
507,255,627,24.96145124716553,26.424308390022677,30.0,6.0,377,1.0,372
508,255,648,24.96145124716553,27.21378684807256,30.0,8.0,405,2.0,393
509,255,86,25.44907029478458,26.935147392290247,30.0,31.0,181,1.0,169
510,255,87,25.44907029478458,27.422766439909296,30.0,31.0,188,2.0,168
511,255,260,25.44907029478458,27.445986394557824,30.0,29.0,86,2.0,5
512,255,486,25.44907029478458,26.72616780045352,30.0,24.0,237,1.0,231
513,255,439,25.44907029478458,27.422766439909296,30.0,24.0,203,2.0,184
514,255,648,25.44907029478458,27.21378684807256,30.0,8.0,400,2.0,393
515,219,87,26.21532879818594,27.422766439909296,30.0,31.0,142,1.0,132
516,219,195,26.21532879818594,28.65342403628118,30.0,30.0,108,2.0,24
517,219,260,26.21532879818594,27.445986394557824,30.0,29.0,67,1.0,41
518,219,243,26.21532879818594,28.676643990929705,30.0,30.0,109,2.0,24
519,219,218,26.21532879818594,29.094603174603176,30.0,30.0,124,3.0,1
520,219,439,26.21532879818594,27.422766439909296,30.0,24.0,226,1.0,220
521,219,439,26.21532879818594,28.630204081632648,30.0,22.0,243,2.0,220
522,219,441,26.21532879818594,29.094603174603176,30.0,22.0,254,3.0,222
523,219,628,26.21532879818594,28.630204081632648,30.0,9.0,422,2.0,409
524,219,615,26.21532879818594,29.094603174603176,30.0,4.0,415,3.0,396
525,260,195,27.445986394557824,28.65342403628118,29.0,30.0,83,1.0,65
526,260,204,27.445986394557824,29.628662131519274,29.0,28.0,109,2.0,56
527,260,243,27.445986394557824,28.676643990929705,29.0,30.0,56,1.0,17
528,260,218,27.445986394557824,29.094603174603176,29.0,30.0,82,2.0,42
529,260,439,27.445986394557824,28.630204081632648,29.0,22.0,186,1.0,179
530,260,441,27.445986394557824,29.094603174603176,29.0,22.0,194,2.0,181
531,260,628,27.445986394557824,28.630204081632648,29.0,9.0,372,1.0,368
532,260,615,27.445986394557824,29.094603174603176,29.0,4.0,362,2.0,355
533,243,195,28.676643990929705,30.603900226757368,30.0,31.0,96,2.0,48
534,243,182,28.676643990929705,31.532698412698412,30.0,29.0,137,3.0,61
535,243,242,28.676643990929705,30.557460317460322,30.0,32.0,81,2.0,1
536,243,218,28.676643990929705,30.998639455782317,30.0,30.0,103,2.0,25
537,243,439,28.676643990929705,30.603900226757368,30.0,24.0,213,2.0,196
538,243,441,28.676643990929705,30.998639455782317,30.0,22.0,222,2.0,198
539,243,628,28.676643990929705,30.603900226757368,30.0,9.0,394,2.0,385
540,243,648,28.676643990929705,30.998639455782317,30.0,6.0,417,2.0,405
541,218,195,29.094603174603176,30.603900226757368,30.0,31.0,69,2.0,23
542,218,182,29.094603174603176,31.532698412698412,30.0,29.0,111,2.0,36
543,218,242,29.094603174603176,30.557460317460322,30.0,32.0,67,1.0,24
544,218,439,29.094603174603176,30.603900226757368,30.0,24.0,230,2.0,221
545,218,441,29.094603174603176,30.998639455782317,30.0,22.0,238,2.0,223
546,218,628,29.094603174603176,30.603900226757368,30.0,9.0,415,2.0,410
547,218,648,29.094603174603176,30.998639455782317,30.0,6.0,438,2.0,430
548,242,86,30.557460317460322,32.624036281179144,32.0,33.0,180,2.0,156
549,242,86,30.557460317460322,33.158095238095235,32.0,31.0,192,3.0,156
550,242,218,30.557460317460322,31.997097505668936,32.0,29.0,66,1.0,24
551,242,485,30.557460317460322,32.92589569160998,32.0,24.0,264,2.0,243
552,242,627,30.557460317460322,32.13641723356009,32.0,7.0,391,2.0,385
553,218,86,30.998639455782317,32.624036281179144,30.0,33.0,149,2.0,132
554,218,86,30.998639455782317,33.158095238095235,30.0,31.0,161,2.0,132
555,218,219,30.998639455782317,33.8314739229025,30.0,29.0,122,3.0,1
556,218,485,30.998639455782317,32.92589569160998,30.0,24.0,280,2.0,267
557,218,443,30.998639455782317,33.877913832199546,30.0,23.0,257,3.0,225
558,218,627,30.998639455782317,32.13641723356009,30.0,7.0,412,1.0,409
559,218,615,30.998639455782317,33.94757369614513,30.0,5.0,417,3.0,397
560,218,86,31.997097505668936,33.158095238095235,29.0,31.0,141,1.0,132
561,218,86,31.997097505668936,34.574512471655325,29.0,32.0,172,3.0,132
562,218,219,31.997097505668936,33.8314739229025,29.0,29.0,79,2.0,1
563,218,251,31.997097505668936,34.4584126984127,29.0,28.0,111,2.0,33
564,218,443,31.997097505668936,33.877913832199546,29.0,23.0,239,2.0,225
565,218,486,31.997097505668936,34.34231292517007,29.0,24.0,286,2.0,268
566,218,615,31.997097505668936,33.94757369614513,29.0,5.0,406,2.0,397
567,218,631,31.997097505668936,33.99401360544218,29.0,8.0,422,2.0,413
568,219,86,33.8314739229025,35.015691609977324,29.0,30.0,142,1.0,133
569,219,195,33.8314739229025,36.29278911564626,29.0,30.0,109,2.0,24
570,219,243,33.8314739229025,36.269569160997726,29.0,31.0,108,2.0,24
571,219,432,33.8314739229025,35.03891156462585,29.0,23.0,219,1.0,213
572,219,438,33.8314739229025,36.269569160997726,29.0,24.0,243,2.0,219
573,219,630,33.8314739229025,35.92126984126985,29.0,7.0,421,2.0,411
574,219,638,33.8314739229025,36.269569160997726,29.0,7.0,432,2.0,419
575,251,195,34.4584126984127,36.29278911564626,28.0,30.0,97,2.0,56
576,251,219,34.4584126984127,35.75873015873015,28.0,29.0,64,1.0,32
577,251,243,34.4584126984127,36.269569160997726,28.0,31.0,78,2.0,8
578,251,205,34.4584126984127,37.24480725623583,28.0,29.0,129,3.0,46
579,251,438,34.4584126984127,36.269569160997726,28.0,24.0,203,2.0,187
580,251,450,34.4584126984127,37.221587301587306,28.0,23.0,232,3.0,199
581,251,630,34.4584126984127,35.92126984126985,28.0,7.0,384,1.0,379
582,251,638,34.4584126984127,36.269569160997726,28.0,7.0,395,2.0,387
583,251,629,34.4584126984127,37.151927437641724,28.0,3.0,395,3.0,378
584,219,204,35.75873015873015,37.9181859410431,29.0,28.0,94,2.0,15
585,219,194,35.75873015873015,38.196825396825396,29.0,31.0,108,2.0,25
586,219,205,35.75873015873015,37.24480725623583,29.0,29.0,66,1.0,14
587,219,243,35.75873015873015,38.22004535147392,29.0,32.0,109,2.0,24
588,219,450,35.75873015873015,37.221587301587306,29.0,23.0,239,1.0,231
589,219,437,35.75873015873015,38.196825396825396,29.0,23.0,242,2.0,218
590,219,629,35.75873015873015,37.151927437641724,29.0,3.0,414,1.0,410
591,219,637,35.75873015873015,38.196825396825396,29.0,9.0,431,2.0,418
592,243,204,36.269569160997726,37.9181859410431,31.0,28.0,81,2.0,39
593,243,194,36.269569160997726,38.196825396825396,31.0,31.0,96,2.0,49
594,243,219,36.269569160997726,39.14884353741497,31.0,29.0,126,3.0,24
595,243,437,36.269569160997726,38.196825396825396,31.0,23.0,211,2.0,194
596,243,637,36.269569160997726,38.196825396825396,31.0,9.0,403,2.0,394
597,205,86,37.24480725623583,39.86866213151927,29.0,30.0,164,3.0,119
598,205,219,37.24480725623583,39.14884353741497,29.0,29.0,83,2.0,14
599,205,249,37.24480725623583,40.170521541950116,29.0,28.0,133,3.0,44
600,205,437,37.24480725623583,39.59002267573696,29.0,20.0,253,2.0,232
601,205,626,37.24480725623583,39.543582766439904,29.0,5.0,432,2.0,421
602,205,661,37.24480725623583,40.05442176870749,29.0,6.0,472,3.0,456
603,243,86,38.22004535147392,39.86866213151927,32.0,30.0,172,2.0,157
604,243,86,38.22004535147392,40.26340136054422,32.0,32.0,180,2.0,157
605,243,249,38.22004535147392,40.170521541950116,32.0,28.0,84,2.0,6
606,243,437,38.22004535147392,39.59002267573696,32.0,20.0,203,1.0,194
607,243,486,38.22004535147392,40.542040816326534,32.0,24.0,263,2.0,243
608,243,626,38.22004535147392,39.543582766439904,32.0,5.0,387,1.0,383
609,243,661,38.22004535147392,40.05442176870749,32.0,6.0,425,2.0,418
610,219,86,39.14884353741497,40.26340136054422,29.0,32.0,141,1.0,133
611,219,182,39.14884353741497,41.494058956916106,29.0,30.0,108,2.0,37
612,219,249,39.14884353741497,40.170521541950116,29.0,28.0,53,1.0,30
613,219,327,39.14884353741497,41.98167800453515,29.0,27.0,163,3.0,108
614,219,486,39.14884353741497,40.542040816326534,29.0,24.0,274,1.0,267
615,219,492,39.14884353741497,41.958458049886616,29.0,22.0,299,3.0,273
616,219,627,39.14884353741497,41.65659863945578,29.0,6.0,422,3.0,408
617,249,182,40.170521541950116,41.494058956916106,28.0,30.0,88,1.0,67
618,249,86,40.170521541950116,42.16743764172336,28.0,32.0,184,2.0,163
619,249,219,40.170521541950116,41.540498866213156,28.0,28.0,66,1.0,30
620,249,327,40.170521541950116,41.98167800453515,28.0,27.0,110,2.0,78
621,249,492,40.170521541950116,41.958458049886616,28.0,22.0,255,2.0,243
622,249,497,40.170521541950116,42.44607709750567,28.0,24.0,267,2.0,248
623,249,627,40.170521541950116,41.65659863945578,28.0,6.0,383,1.0,378
624,249,626,40.170521541950116,42.91047619047619,28.0,5.0,395,3.0,377
625,219,173,41.540498866213156,43.560634920634925,28.0,29.0,98,2.0,46
626,219,217,41.540498866213156,43.88571428571429,28.0,28.0,101,2.0,2
627,219,440,41.540498866213156,43.88571428571429,28.0,21.0,243,2.0,221
628,219,626,41.540498866213156,42.91047619047619,28.0,5.0,411,1.0,407
629,327,173,41.98167800453515,43.560634920634925,27.0,29.0,168,2.0,154
630,327,195,41.98167800453515,44.814512471655334,27.0,31.0,180,3.0,132
631,327,217,41.98167800453515,43.88571428571429,27.0,28.0,137,2.0,110
632,327,243,41.98167800453515,44.837732426303866,27.0,31.0,149,3.0,84
633,327,440,41.98167800453515,43.88571428571429,27.0,21.0,140,2.0,113
634,327,731,41.98167800453515,43.653514739229024,27.0,5.0,410,2.0,404
635,327,631,41.98167800453515,44.791292517006795,27.0,7.0,327,3.0,304
636,327,826,41.98167800453515,43.97859410430839,27.0,3.0,506,2.0,499
637,217,195,43.88571428571429,45.02349206349206,28.0,30.0,54,1.0,22
638,217,195,43.88571428571429,46.04517006802721,28.0,29.0,96,2.0,22
639,217,243,43.88571428571429,45.093151927437646,28.0,31.0,58,1.0,26
640,217,219,43.88571428571429,46.857868480725635,28.0,30.0,128,3.0,2
641,217,432,43.88571428571429,44.977052154195015,28.0,22.0,220,1.0,215
642,217,438,43.88571428571429,45.00027210884354,28.0,23.0,226,1.0,221
643,217,626,43.88571428571429,45.30213151927439,28.0,7.0,414,1.0,409
644,217,638,43.88571428571429,46.50956916099774,28.0,-0.0,436,3.0,421
645,243,195,44.837732426303866,46.04517006802721,31.0,29.0,71,1.0,48
646,243,146,44.837732426303866,47.43836734693878,31.0,28.0,148,3.0,97
647,243,219,44.837732426303866,46.857868480725635,31.0,30.0,90,2.0,24
648,243,219,44.837732426303866,47.670566893424045,31.0,32.0,124,3.0,24
649,243,504,44.837732426303866,46.881088435374146,31.0,20.0,275,2.0,261
650,243,437,44.837732426303866,47.69378684807257,31.0,23.0,230,3.0,194
651,243,638,44.837732426303866,46.50956916099774,31.0,-0.0,402,2.0,395
652,243,146,45.093151927437646,47.43836734693878,31.0,28.0,140,2.0,97
653,243,219,45.093151927437646,46.857868480725635,31.0,30.0,80,2.0,24
654,243,219,45.093151927437646,47.670566893424045,31.0,32.0,114,3.0,24
655,243,504,45.093151927437646,46.881088435374146,31.0,20.0,272,2.0,261
656,243,437,45.093151927437646,47.69378684807257,31.0,23.0,224,3.0,194
657,243,638,45.093151927437646,46.50956916099774,31.0,-0.0,400,1.0,395
658,219,73,46.857868480725635,48.181405895691604,30.0,24.0,157,1.0,146
659,219,73,46.857868480725635,49.13342403628118,30.0,26.0,176,2.0,146
660,219,218,46.857868480725635,48.181405895691604,30.0,28.0,57,1.0,1
661,219,218,46.857868480725635,49.24952380952381,30.0,28.0,103,2.0,1
662,219,443,46.857868480725635,48.785124716553284,30.0,20.0,239,2.0,224
663,219,437,46.857868480725635,49.24952380952381,30.0,19.0,241,2.0,218
664,219,714,46.857868480725635,48.76190476190477,30.0,2.0,502,2.0,495
665,219,632,46.857868480725635,49.24952380952381,30.0,2.0,426,2.0,413
666,219,73,47.670566893424045,49.13342403628118,32.0,26.0,159,1.0,146
667,219,181,47.670566893424045,50.526621315192735,32.0,24.0,129,3.0,38
668,219,218,47.670566893424045,49.24952380952381,32.0,28.0,68,2.0,1
669,219,205,47.670566893424045,50.0390022675737,32.0,27.0,103,2.0,14
670,219,443,47.670566893424045,48.785124716553284,32.0,20.0,229,1.0,224
671,219,437,47.670566893424045,49.24952380952381,32.0,19.0,228,2.0,218
672,219,452,47.670566893424045,50.41052154195012,32.0,17.0,261,3.0,233
673,219,714,47.670566893424045,48.76190476190477,32.0,2.0,497,1.0,495
674,219,632,47.670566893424045,49.24952380952381,32.0,2.0,419,2.0,413
675,218,181,48.181405895691604,50.526621315192735,28.0,24.0,108,2.0,37
676,218,153,48.181405895691604,51.13034013605442,28.0,17.0,143,3.0,65
677,218,205,48.181405895691604,50.0390022675737,28.0,27.0,81,2.0,13
678,218,437,48.181405895691604,49.24952380952381,28.0,19.0,224,1.0,219
679,218,452,48.181405895691604,50.41052154195012,28.0,17.0,253,2.0,234
680,218,499,48.181405895691604,51.13034013605442,28.0,11.0,308,3.0,281
681,218,632,48.181405895691604,49.24952380952381,28.0,2.0,417,1.0,414
682,218,625,48.181405895691604,50.87492063492064,28.0,6.0,423,3.0,407
683,218,181,49.24952380952381,50.526621315192735,28.0,24.0,66,1.0,37
684,218,153,49.24952380952381,51.13034013605442,28.0,17.0,104,2.0,65
685,218,243,49.24952380952381,51.54829931972789,28.0,18.0,102,2.0,25
686,218,452,49.24952380952381,50.41052154195012,28.0,17.0,239,1.0,234
687,218,499,49.24952380952381,51.13034013605442,28.0,11.0,292,2.0,281
688,218,625,49.24952380952381,50.87492063492064,28.0,6.0,413,2.0,407
689,218,628,49.24952380952381,51.85015873015873,28.0,1.0,425,3.0,410
690,205,153,50.0390022675737,51.13034013605442,27.0,17.0,70,1.0,52
691,205,82,50.0390022675737,52.50031746031746,27.0,17.0,162,2.0,123
692,205,243,50.0390022675737,51.54829931972789,27.0,18.0,75,2.0,38
693,205,245,50.0390022675737,52.87183673469388,27.0,16.0,128,3.0,40
694,205,499,50.0390022675737,51.13034013605442,27.0,11.0,298,1.0,294
695,205,497,50.0390022675737,52.77895691609978,27.0,12.0,315,3.0,292
696,205,628,50.0390022675737,51.85015873015873,27.0,1.0,430,2.0,423
697,243,195,51.54829931972789,53.475555555555566,18.0,17.0,96,2.0,48
698,243,245,51.54829931972789,52.87183673469388,18.0,16.0,57,1.0,2
699,243,244,51.54829931972789,53.475555555555566,18.0,16.0,83,2.0,1
700,243,497,51.54829931972789,52.77895691609978,18.0,12.0,259,1.0,254
701,243,438,51.54829931972789,53.475555555555566,18.0,10.0,212,2.0,195
702,245,182,52.87183673469388,54.86875283446712,16.0,24.0,107,2.0,63
703,245,87,52.87183673469388,55.542131519274385,16.0,33.0,195,3.0,158
704,245,218,52.87183673469388,54.89197278911565,16.0,21.0,91,2.0,27
705,245,259,52.87183673469388,55.49569160997733,16.0,30.0,114,3.0,14
706,245,417,52.87183673469388,54.961632653061216,16.0,15.0,194,2.0,172
707,245,432,52.87183673469388,55.49569160997733,16.0,23.0,218,3.0,187
708,245,648,52.87183673469388,55.309931972789116,16.0,0.0,416,2.0,403
709,244,182,53.475555555555566,54.86875283446712,16.0,24.0,86,1.0,62
710,244,87,53.475555555555566,55.542131519274385,16.0,33.0,180,2.0,157
711,244,87,53.475555555555566,55.98331065759637,16.0,28.0,191,3.0,157
712,244,218,53.475555555555566,54.89197278911565,16.0,21.0,66,1.0,26
713,244,259,53.475555555555566,55.49569160997733,16.0,30.0,88,2.0,15
714,244,259,53.475555555555566,56.029750566893426,16.0,28.0,111,3.0,15
715,244,417,53.475555555555566,54.961632653061216,16.0,15.0,184,1.0,173
716,244,432,53.475555555555566,55.49569160997733,16.0,23.0,207,2.0,188
717,244,438,53.475555555555566,56.0065306122449,16.0,23.0,223,3.0,194
718,244,648,53.475555555555566,55.309931972789116,16.0,0.0,412,2.0,404
719,218,87,54.89197278911565,55.98331065759637,21.0,28.0,139,1.0,131
720,218,259,54.89197278911565,56.029750566893426,21.0,28.0,64,1.0,41
721,218,438,54.89197278911565,56.0065306122449,21.0,23.0,225,1.0,220
722,218,628,54.89197278911565,56.58702947845804,21.0,1.0,416,2.0,410
723,259,86,55.49569160997733,57.933786848072565,30.0,34.0,202,2.0,173
724,259,438,55.49569160997733,57.933786848072565,30.0,21.0,208,2.0,179
725,259,628,55.49569160997733,56.58702947845804,30.0,1.0,372,1.0,369
726,259,86,56.029750566893426,57.933786848072565,28.0,34.0,191,2.0,173
727,259,53,56.029750566893426,58.83936507936508,28.0,26.0,239,3.0,206
728,259,218,56.029750566893426,58.909024943310655,28.0,29.0,131,3.0,41
729,259,438,56.029750566893426,57.933786848072565,28.0,21.0,197,2.0,179
730,259,441,56.029750566893426,58.909024943310655,28.0,19.0,220,3.0,182
731,259,627,56.029750566893426,58.49106575963719,28.0,2.0,383,2.0,368
732,259,195,57.933786848072565,59.11800453514739,28.0,31.0,82,1.0,64
733,259,244,57.933786848072565,59.141224489795924,28.0,29.0,54,1.0,15
734,259,439,57.933786848072565,59.11800453514739,28.0,25.0,187,1.0,180
735,259,617,57.933786848072565,59.466303854875285,28.0,7.0,364,2.0,358
736,443,172,3.8777324263038553,5.085170068027211,20.0,29.0,276,1.0,271
737,443,87,3.8777324263038553,6.03718820861678,20.0,23.0,368,2.0,356
738,443,218,3.8777324263038553,5.224489795918368,20.0,27.0,232,1.0,225
739,443,249,3.8777324263038553,6.03718820861678,20.0,20.0,215,2.0,194
740,443,506,3.8777324263038553,5.224489795918368,20.0,21.0,86,1.0,63
741,443,419,3.8777324263038553,6.060408163265307,20.0,13.0,97,2.0,24
742,443,636,3.8777324263038553,5.224489795918368,20.0,5.0,202,1.0,193
743,443,850,3.8777324263038553,5.061950113378685,20.0,4.0,410,1.0,407
744,504,87,4.3421315192743775,6.03718820861678,22.0,23.0,423,2.0,417
745,504,132,4.3421315192743775,7.314285714285713,22.0,21.0,393,3.0,372
746,504,249,4.3421315192743775,6.03718820861678,22.0,20.0,265,2.0,255
747,504,224,4.3421315192743775,7.198185941043084,22.0,11.0,306,3.0,280
748,504,419,4.3421315192743775,6.060408163265307,22.0,13.0,113,2.0,85
749,506,132,5.224489795918368,7.314285714285713,21.0,21.0,385,2.0,374
750,506,224,5.224489795918368,7.198185941043084,21.0,11.0,295,2.0,282
751,506,489,5.224489795918368,7.8947845804988654,21.0,0.0,116,3.0,17
752,419,132,6.060408163265307,7.314285714285713,13.0,21.0,292,1.0,287
753,419,43,6.060408163265307,8.428843537414966,13.0,14.0,390,2.0,376
754,419,224,6.060408163265307,7.198185941043084,13.0,11.0,201,1.0,195
755,419,205,6.060408163265307,8.266303854875284,13.0,11.0,234,2.0,214
756,419,489,6.060408163265307,7.8947845804988654,13.0,0.0,106,2.0,70
757,419,506,6.060408163265307,8.243083900226758,13.0,2.0,128,2.0,87
758,489,44,7.8947845804988654,9.241541950113382,0.0,14.0,449,1.0,445
759,489,43,7.8947845804988654,10.193560090702947,0.0,10.0,457,2.0,446
760,489,231,7.8947845804988654,9.566621315192744,0.0,6.0,268,2.0,258
761,489,254,7.8947845804988654,10.425759637188207,0.0,1.0,259,3.0,235
762,489,450,7.8947845804988654,9.798820861678005,0.0,7.0,91,2.0,39
763,489,455,7.8947845804988654,10.00780045351474,0.0,2.0,97,2.0,34
764,506,43,8.243083900226758,10.193560090702947,2.0,10.0,471,2.0,463
765,506,89,8.243083900226758,11.122358276643991,2.0,10.0,435,3.0,417
766,506,231,8.243083900226758,9.566621315192744,2.0,6.0,281,1.0,275
767,506,254,8.243083900226758,10.425759637188207,2.0,1.0,269,2.0,252
768,506,232,8.243083900226758,11.122358276643991,2.0,10.0,301,3.0,274
769,506,450,8.243083900226758,9.798820861678005,2.0,7.0,87,2.0,56
770,506,455,8.243083900226758,10.00780045351474,2.0,2.0,92,2.0,51
771,450,89,9.798820861678005,11.122358276643991,7.0,10.0,365,1.0,361
772,450,232,9.798820861678005,11.122358276643991,7.0,10.0,225,1.0,218
773,450,232,9.798820861678005,12.329795918367347,7.0,12.0,244,3.0,218
774,450,438,9.798820861678005,12.353015873015876,7.0,8.0,111,3.0,12
775,455,89,10.00780045351474,11.122358276643991,2.0,10.0,369,1.0,366
776,455,43,10.00780045351474,12.956734693877552,2.0,9.0,431,3.0,412
777,455,232,10.00780045351474,11.122358276643991,2.0,10.0,228,1.0,223
778,455,232,10.00780045351474,12.329795918367347,2.0,12.0,244,2.0,223
779,455,438,10.00780045351474,12.353015873015876,2.0,8.0,102,2.0,17
780,438,109,12.353015873015876,13.653333333333334,8.0,19.0,334,1.0,329
781,438,195,12.353015873015876,14.953650793650795,8.0,24.0,268,3.0,243
782,438,218,12.353015873015876,13.862312925170068,8.0,7.0,229,2.0,220
783,438,243,12.353015873015876,14.837551020408164,8.0,24.0,222,2.0,195
784,438,243,12.353015873015876,15.046530612244899,8.0,25.0,227,3.0,195
785,438,497,12.353015873015876,14.25705215419501,8.0,4.0,101,2.0,59
786,437,195,13.281814058956915,14.953650793650795,5.0,24.0,252,2.0,242
787,437,195,13.281814058956915,15.557369614512472,5.0,27.0,261,2.0,242
788,437,243,13.281814058956915,14.837551020408164,5.0,24.0,205,2.0,194
789,437,243,13.281814058956915,15.046530612244899,5.0,25.0,208,2.0,194
790,437,455,13.281814058956915,15.928888888888887,5.0,13.0,115,3.0,18
791,497,195,14.25705215419501,15.557369614512472,4.0,27.0,307,1.0,302
792,497,73,14.25705215419501,16.741587301587302,4.0,27.0,437,2.0,424
793,497,73,14.25705215419501,17.22920634920635,4.0,28.0,443,3.0,424
794,497,218,14.25705215419501,16.857687074829933,4.0,31.0,301,3.0,279
795,497,455,14.25705215419501,15.928888888888887,4.0,13.0,83,2.0,42
796,497,437,14.25705215419501,16.857687074829933,4.0,21.0,127,3.0,60
797,497,661,14.25705215419501,16.880907029478458,4.0,2.0,199,3.0,164
798,455,73,15.928888888888887,17.22920634920635,13.0,28.0,386,1.0,382
799,455,73,15.928888888888887,18.18122448979592,13.0,29.0,394,2.0,382
800,455,218,15.928888888888887,17.69360544217687,13.0,31.0,249,2.0,237
801,455,219,15.928888888888887,18.274104308390022,13.0,31.0,257,2.0,236
802,455,437,15.928888888888887,17.809705215419505,13.0,23.0,83,2.0,18
803,455,437,15.928888888888887,18.29732426303855,13.0,21.0,104,2.0,18
804,455,649,15.928888888888887,17.69360544217687,13.0,5.0,208,2.0,194
805,455,662,15.928888888888887,18.320544217687075,13.0,3.0,231,2.0,207
806,455,861,15.928888888888887,17.69360544217687,13.0,2.0,413,2.0,406
807,437,73,16.857687074829933,18.18122448979592,21.0,29.0,368,1.0,364
808,437,88,16.857687074829933,19.295782312925173,21.0,27.0,364,2.0,349
809,437,219,16.857687074829933,18.274104308390022,21.0,31.0,226,1.0,218
810,437,246,16.857687074829933,19.574421768707484,21.0,26.0,224,3.0,191
811,437,410,16.857687074829933,19.574421768707484,21.0,19.0,120,3.0,27
812,437,662,16.857687074829933,18.320544217687075,21.0,3.0,234,1.0,225
813,437,713,16.857687074829933,19.272562358276645,21.0,1.0,295,2.0,276
814,437,88,17.809705215419505,19.295782312925173,23.0,27.0,355,1.0,349
815,437,182,17.809705215419505,20.54965986394558,23.0,31.0,281,3.0,255
816,437,246,17.809705215419505,19.574421768707484,23.0,26.0,206,2.0,191
817,437,255,17.809705215419505,20.572879818594107,23.0,29.0,217,3.0,182
818,437,410,17.809705215419505,19.574421768707484,23.0,19.0,81,2.0,27
819,437,468,17.809705215419505,20.52643990929705,23.0,21.0,121,3.0,31
820,437,713,17.809705215419505,19.272562358276645,23.0,1.0,283,1.0,276
821,437,661,17.809705215419505,20.54965986394558,23.0,6.0,253,3.0,224
822,437,827,17.809705215419505,20.50321995464852,23.0,3.0,407,3.0,390
823,437,182,18.29732426303855,20.54965986394558,21.0,31.0,273,2.0,255
824,437,195,18.29732426303855,21.03727891156463,21.0,29.0,269,3.0,242
825,437,246,18.29732426303855,19.574421768707484,21.0,26.0,199,1.0,191
826,437,255,18.29732426303855,20.572879818594107,21.0,29.0,207,2.0,182
827,437,243,18.29732426303855,21.03727891156463,21.0,31.0,227,3.0,194
828,437,410,18.29732426303855,19.574421768707484,21.0,19.0,61,1.0,27
829,437,468,18.29732426303855,20.52643990929705,21.0,21.0,101,2.0,31
830,437,438,18.29732426303855,21.03727891156463,21.0,23.0,118,3.0,1
831,437,661,18.29732426303855,20.54965986394558,21.0,6.0,244,2.0,224
832,437,638,18.29732426303855,21.03727891156463,21.0,8.0,233,3.0,201
833,437,827,18.29732426303855,20.50321995464852,21.0,3.0,401,2.0,390
834,410,195,19.574421768707484,21.03727891156463,19.0,29.0,224,1.0,215
835,410,243,19.574421768707484,21.03727891156463,19.0,31.0,178,1.0,167
836,410,438,19.574421768707484,21.03727891156463,19.0,23.0,69,1.0,28
837,410,450,19.574421768707484,22.01251700680272,19.0,22.0,112,2.0,40
838,410,638,19.574421768707484,21.03727891156463,19.0,8.0,237,1.0,228
839,410,850,19.574421768707484,21.339138321995467,19.0,1.0,447,2.0,440
840,468,194,20.52643990929705,22.964535147392287,21.0,30.0,293,2.0,274
841,468,195,20.52643990929705,22.98775510204082,21.0,30.0,293,2.0,273
842,468,243,20.52643990929705,22.964535147392287,21.0,32.0,248,2.0,225
843,468,243,20.52643990929705,22.98775510204082,21.0,32.0,249,2.0,225
844,468,450,20.52643990929705,22.01251700680272,21.0,22.0,66,1.0,18
845,468,438,20.52643990929705,22.98775510204082,21.0,22.0,110,2.0,30
846,468,638,20.52643990929705,22.964535147392287,21.0,8.0,200,2.0,170
847,468,615,20.52643990929705,23.38249433106576,21.0,7.0,192,3.0,147
848,468,865,20.52643990929705,22.91809523809524,21.0,-0.0,410,2.0,397
849,438,194,21.03727891156463,22.964535147392287,23.0,30.0,258,2.0,244
850,438,195,21.03727891156463,22.98775510204082,23.0,30.0,257,2.0,243
851,438,243,21.03727891156463,22.964535147392287,23.0,32.0,212,2.0,195
852,438,243,21.03727891156463,22.98775510204082,23.0,32.0,212,2.0,195
853,438,638,21.03727891156463,22.964535147392287,23.0,8.0,217,2.0,200
854,438,615,21.03727891156463,23.38249433106576,23.0,7.0,204,2.0,177
855,438,865,21.03727891156463,22.91809523809524,23.0,-0.0,435,2.0,427
856,438,827,21.03727891156463,23.91655328798186,23.0,1.0,408,3.0,389
857,450,86,22.01251700680272,24.636371882086173,22.0,31.0,381,3.0,364
858,450,255,22.01251700680272,24.96145124716553,22.0,30.0,233,3.0,195
859,450,417,22.01251700680272,24.79891156462585,22.0,22.0,124,3.0,33
860,450,615,22.01251700680272,23.38249433106576,22.0,7.0,175,1.0,165
861,450,661,22.01251700680272,24.357732426303848,22.0,5.0,234,2.0,211
862,450,827,22.01251700680272,23.91655328798186,22.0,1.0,386,2.0,377
863,450,825,22.01251700680272,24.845351473922907,22.0,4.0,394,3.0,375
864,438,86,22.98775510204082,24.636371882086173,22.0,31.0,359,2.0,352
865,438,86,22.98775510204082,25.007891156462588,22.0,34.0,363,2.0,352
866,438,255,22.98775510204082,24.96145124716553,22.0,30.0,202,2.0,183
867,438,255,22.98775510204082,25.44907029478458,22.0,30.0,211,2.0,183
868,438,417,22.98775510204082,24.79891156462585,22.0,22.0,81,2.0,21
869,438,486,22.98775510204082,25.309750566893424,22.0,23.0,111,2.0,48
870,438,661,22.98775510204082,24.357732426303848,22.0,5.0,231,1.0,223
871,438,815,22.98775510204082,25.286530612244896,22.0,6.0,390,2.0,377
872,438,825,22.98775510204082,24.845351473922907,22.0,4.0,395,2.0,387
873,438,826,22.98775510204082,25.286530612244896,22.0,5.0,400,2.0,388
874,417,86,24.79891156462585,26.935147392290247,22.0,31.0,344,2.0,331
875,417,87,24.79891156462585,27.422766439909296,22.0,31.0,349,3.0,330
876,417,219,24.79891156462585,26.21532879818594,22.0,30.0,207,1.0,198
877,417,260,24.79891156462585,27.445986394557824,22.0,29.0,194,3.0,157
878,417,486,24.79891156462585,26.72616780045352,22.0,24.0,108,2.0,69
879,417,439,24.79891156462585,27.422766439909296,22.0,24.0,115,3.0,22
880,417,627,24.79891156462585,26.424308390022677,22.0,6.0,221,2.0,210
881,417,648,24.79891156462585,27.21378684807256,22.0,8.0,253,2.0,231
882,417,825,24.79891156462585,26.72616780045352,22.0,5.0,416,2.0,408
883,417,842,24.79891156462585,27.30666666666667,22.0,2.0,439,3.0,425
884,486,86,25.309750566893424,26.935147392290247,23.0,31.0,406,2.0,400
885,486,87,25.309750566893424,27.422766439909296,23.0,31.0,409,2.0,399
886,486,260,25.309750566893424,27.445986394557824,23.0,29.0,244,2.0,226
887,486,439,25.309750566893424,27.422766439909296,23.0,24.0,102,2.0,47
888,486,627,25.309750566893424,26.424308390022677,23.0,6.0,149,1.0,141
889,486,648,25.309750566893424,27.21378684807256,23.0,8.0,182,2.0,162
890,486,825,25.309750566893424,26.72616780045352,23.0,5.0,344,1.0,339
891,486,842,25.309750566893424,27.30666666666667,23.0,2.0,366,2.0,356
892,486,195,26.72616780045352,28.65342403628118,24.0,30.0,303,2.0,291
893,486,204,26.72616780045352,29.628662131519274,24.0,28.0,308,3.0,282
894,486,243,26.72616780045352,28.676643990929705,24.0,30.0,257,2.0,243
895,486,218,26.72616780045352,29.094603174603176,24.0,30.0,287,2.0,268
896,486,439,26.72616780045352,28.630204081632648,24.0,22.0,95,2.0,47
897,486,441,26.72616780045352,29.094603174603176,24.0,22.0,111,2.0,45
898,486,628,26.72616780045352,28.630204081632648,24.0,9.0,164,2.0,142
899,486,615,26.72616780045352,29.094603174603176,24.0,4.0,164,2.0,129
900,486,860,26.72616780045352,28.42122448979592,24.0,2.0,381,2.0,374
901,439,195,27.422766439909296,28.65342403628118,24.0,30.0,250,1.0,244
902,439,204,27.422766439909296,29.628662131519274,24.0,28.0,253,2.0,235
903,439,243,27.422766439909296,28.676643990929705,24.0,30.0,203,1.0,196
904,439,218,27.422766439909296,29.094603174603176,24.0,30.0,232,2.0,221
905,439,441,27.422766439909296,29.094603174603176,24.0,22.0,72,2.0,2
906,439,628,27.422766439909296,28.630204081632648,24.0,9.0,196,1.0,189
907,439,615,27.422766439909296,29.094603174603176,24.0,4.0,190,2.0,176
908,439,195,28.630204081632648,30.603900226757368,22.0,31.0,258,2.0,244
909,439,182,28.630204081632648,31.532698412698412,22.0,29.0,286,3.0,257
910,439,242,28.630204081632648,30.557460317460322,22.0,32.0,214,2.0,197
911,439,218,28.630204081632648,30.998639455782317,22.0,30.0,243,2.0,221
912,439,441,28.630204081632648,30.998639455782317,22.0,22.0,102,2.0,2
913,439,628,28.630204081632648,30.603900226757368,22.0,9.0,207,2.0,189
914,439,648,28.630204081632648,30.998639455782317,22.0,6.0,233,2.0,209
915,439,850,28.630204081632648,30.859319727891158,22.0,1.0,422,2.0,411
916,439,826,28.630204081632648,31.532698412698412,22.0,-0.0,407,3.0,387
917,441,195,29.094603174603176,30.603900226757368,22.0,31.0,254,2.0,246
918,441,182,29.094603174603176,31.532698412698412,22.0,29.0,279,2.0,259
919,441,242,29.094603174603176,30.557460317460322,22.0,32.0,209,1.0,199
920,441,218,29.094603174603176,30.998639455782317,22.0,30.0,238,2.0,223
921,441,218,29.094603174603176,31.997097505668936,22.0,29.0,256,3.0,223
922,441,439,29.094603174603176,30.603900226757368,22.0,24.0,65,2.0,2
923,441,628,29.094603174603176,30.603900226757368,22.0,9.0,198,2.0,187
924,441,648,29.094603174603176,30.998639455782317,22.0,6.0,223,2.0,207
925,441,850,29.094603174603176,30.859319727891158,22.0,1.0,416,2.0,409
926,441,826,29.094603174603176,31.532698412698412,22.0,-0.0,399,2.0,385
927,439,86,30.603900226757368,32.624036281179144,24.0,33.0,364,2.0,353
928,439,86,30.603900226757368,33.158095238095235,24.0,31.0,370,3.0,353
929,439,218,30.603900226757368,31.997097505668936,24.0,29.0,229,1.0,221
930,439,485,30.603900226757368,32.92589569160998,24.0,24.0,110,2.0,46
931,439,627,30.603900226757368,32.13641723356009,24.0,7.0,199,2.0,188
932,439,824,30.603900226757368,32.92589569160998,24.0,4.0,398,2.0,385
933,439,842,30.603900226757368,33.01877551020408,24.0,2.0,416,2.0,403
934,441,86,30.998639455782317,32.624036281179144,22.0,33.0,362,2.0,355
935,441,86,30.998639455782317,33.158095238095235,22.0,31.0,367,2.0,355
936,441,219,30.998639455782317,33.8314739229025,22.0,29.0,253,3.0,222
937,441,485,30.998639455782317,32.92589569160998,22.0,24.0,94,2.0,44
938,441,443,30.998639455782317,33.877913832199546,22.0,23.0,124,3.0,2
939,441,627,30.998639455782317,32.13641723356009,22.0,7.0,192,1.0,186
940,441,615,30.998639455782317,33.94757369614513,22.0,5.0,215,3.0,174
941,441,824,30.998639455782317,32.92589569160998,22.0,4.0,392,2.0,383
942,441,842,30.998639455782317,33.01877551020408,22.0,2.0,410,2.0,401
943,485,86,32.92589569160998,34.574512471655325,24.0,32.0,405,2.0,399
944,485,86,32.92589569160998,35.015691609977324,24.0,30.0,409,2.0,399
945,485,251,32.92589569160998,34.4584126984127,24.0,28.0,243,2.0,234
946,485,219,32.92589569160998,35.75873015873015,24.0,29.0,293,3.0,266
947,485,486,32.92589569160998,34.34231292517007,24.0,24.0,61,1.0,1
948,485,432,32.92589569160998,35.03891156462585,24.0,23.0,105,2.0,53
949,485,615,32.92589569160998,33.94757369614513,24.0,5.0,137,1.0,130
950,485,631,32.92589569160998,33.99401360544218,24.0,8.0,153,1.0,146
951,485,827,32.92589569160998,34.80671201814059,24.0,5.0,351,2.0,342
952,485,827,32.92589569160998,35.75873015873015,24.0,1.0,363,3.0,342
953,443,86,33.877913832199546,35.015691609977324,23.0,30.0,360,1.0,357
954,443,195,33.877913832199546,36.29278911564626,23.0,30.0,269,2.0,248
955,443,219,33.877913832199546,35.75873015873015,23.0,29.0,238,2.0,224
956,443,243,33.877913832199546,36.269569160997726,23.0,31.0,225,2.0,200
957,443,432,33.877913832199546,35.03891156462585,23.0,23.0,51,1.0,11
958,443,438,33.877913832199546,36.269569160997726,23.0,24.0,103,2.0,5
959,443,630,33.877913832199546,35.92126984126985,23.0,7.0,207,2.0,187
960,443,638,33.877913832199546,36.269569160997726,23.0,7.0,221,2.0,195
961,443,827,33.877913832199546,35.75873015873015,23.0,1.0,392,2.0,384
962,443,861,33.877913832199546,36.037369614512464,23.0,1.0,428,2.0,418
963,486,195,34.34231292517007,36.29278911564626,24.0,30.0,303,2.0,291
964,486,219,34.34231292517007,35.75873015873015,24.0,29.0,274,1.0,267
965,486,243,34.34231292517007,36.269569160997726,24.0,31.0,257,2.0,243
966,486,205,34.34231292517007,37.24480725623583,24.0,29.0,308,3.0,281
967,486,438,34.34231292517007,36.269569160997726,24.0,24.0,96,2.0,48
968,486,450,34.34231292517007,37.221587301587306,24.0,23.0,129,3.0,36
969,486,630,34.34231292517007,35.92126984126985,24.0,7.0,159,2.0,144
970,486,638,34.34231292517007,36.269569160997726,24.0,7.0,173,2.0,152
971,486,629,34.34231292517007,37.151927437641724,24.0,3.0,187,3.0,143
972,486,827,34.34231292517007,35.75873015873015,24.0,1.0,346,1.0,341
973,486,861,34.34231292517007,36.037369614512464,24.0,1.0,382,2.0,375
974,432,195,35.03891156462585,36.29278911564626,23.0,30.0,243,1.0,237
975,432,204,35.03891156462585,37.9181859410431,23.0,28.0,260,3.0,228
976,432,243,35.03891156462585,36.269569160997726,23.0,31.0,196,1.0,189
977,432,205,35.03891156462585,37.24480725623583,23.0,29.0,246,2.0,227
978,432,438,35.03891156462585,36.269569160997726,23.0,24.0,53,1.0,6
979,432,450,35.03891156462585,37.221587301587306,23.0,23.0,96,2.0,18
980,432,638,35.03891156462585,36.269569160997726,23.0,7.0,213,1.0,206
981,432,629,35.03891156462585,37.151927437641724,23.0,3.0,217,2.0,197
982,438,204,36.269569160997726,37.9181859410431,24.0,28.0,245,2.0,234
983,438,194,36.269569160997726,38.196825396825396,24.0,31.0,258,2.0,244
984,438,243,36.269569160997726,38.22004535147392,24.0,32.0,212,2.0,195
985,438,219,36.269569160997726,39.14884353741497,24.0,29.0,252,3.0,219
986,438,437,36.269569160997726,38.196825396825396,24.0,23.0,83,2.0,1
987,438,637,36.269569160997726,38.196825396825396,24.0,9.0,216,2.0,199
988,438,852,36.269569160997726,38.49868480725624,24.0,-0.0,425,2.0,414
989,450,86,37.221587301587306,39.86866213151927,23.0,30.0,381,3.0,364
990,450,219,37.221587301587306,39.14884353741497,23.0,29.0,245,2.0,231
991,450,249,37.221587301587306,40.170521541950116,23.0,28.0,238,3.0,201
992,450,437,37.221587301587306,39.59002267573696,23.0,20.0,103,2.0,13
993,450,626,37.221587301587306,39.543582766439904,23.0,5.0,202,2.0,176
994,450,661,37.221587301587306,40.05442176870749,23.0,6.0,244,3.0,211
995,450,852,37.221587301587306,38.49868480725624,23.0,-0.0,406,1.0,402
996,450,828,37.221587301587306,39.543582766439904,23.0,2.0,391,2.0,378
997,437,86,38.196825396825396,39.86866213151927,23.0,30.0,358,2.0,351
998,437,86,38.196825396825396,40.26340136054422,23.0,32.0,362,2.0,351
999,437,249,38.196825396825396,40.170521541950116,23.0,28.0,206,2.0,188
1000,437,486,38.196825396825396,40.542040816326534,23.0,24.0,112,2.0,49
1001,437,626,38.196825396825396,39.543582766439904,23.0,5.0,198,1.0,189
1002,437,661,38.196825396825396,40.05442176870749,23.0,6.0,238,2.0,224
1003,437,828,38.196825396825396,39.543582766439904,23.0,2.0,395,1.0,391
1004,437,826,38.196825396825396,40.51882086167801,23.0,6.0,402,2.0,389
1005,437,182,39.59002267573696,41.494058956916106,20.0,30.0,268,2.0,255
1006,437,86,39.59002267573696,42.16743764172336,20.0,32.0,368,3.0,351
1007,437,219,39.59002267573696,41.540498866213156,20.0,28.0,234,2.0,218
1008,437,327,39.59002267573696,41.98167800453515,20.0,27.0,151,2.0,110
1009,437,492,39.59002267573696,41.958458049886616,20.0,22.0,116,2.0,55
1010,437,497,39.59002267573696,42.44607709750567,20.0,24.0,137,3.0,60
1011,437,627,39.59002267573696,41.65659863945578,20.0,6.0,210,2.0,190
1012,437,827,39.59002267573696,41.935238095238105,20.0,3.0,403,2.0,390
1013,437,824,39.59002267573696,41.98167800453515,20.0,3.0,400,2.0,387
1014,486,86,40.542040816326534,42.16743764172336,24.0,32.0,406,2.0,400
1015,486,327,40.542040816326534,41.98167800453515,24.0,27.0,171,1.0,159
1016,486,492,40.542040816326534,41.958458049886616,24.0,22.0,61,1.0,6
1017,486,497,40.542040816326534,42.44607709750567,24.0,24.0,83,2.0,11
1018,486,627,40.542040816326534,41.65659863945578,24.0,6.0,149,1.0,141
1019,486,626,40.542040816326534,42.91047619047619,24.0,5.0,173,2.0,140
1020,486,827,40.542040816326534,41.935238095238105,24.0,3.0,346,1.0,341
1021,486,824,40.542040816326534,41.98167800453515,24.0,3.0,344,1.0,338
1022,486,847,40.542040816326534,43.49097505668935,24.0,-0.0,383,3.0,361
1023,492,173,41.958458049886616,43.560634920634925,22.0,29.0,326,2.0,319
1024,492,195,41.958458049886616,44.814512471655334,22.0,31.0,321,3.0,297
1025,492,217,41.958458049886616,43.88571428571429,22.0,28.0,287,2.0,275
1026,492,243,41.958458049886616,44.837732426303866,22.0,31.0,278,3.0,249
1027,492,440,41.958458049886616,43.88571428571429,22.0,21.0,98,2.0,52
1028,492,731,41.958458049886616,43.653514739229024,22.0,5.0,250,2.0,239
1029,492,631,41.958458049886616,44.791292517006795,22.0,7.0,185,3.0,139
1030,492,847,41.958458049886616,43.49097505668935,22.0,-0.0,361,2.0,355
1031,492,826,41.958458049886616,43.97859410430839,22.0,3.0,345,2.0,334
1032,497,173,42.44607709750567,43.560634920634925,24.0,29.0,328,1.0,324
1033,497,195,42.44607709750567,44.814512471655334,24.0,31.0,319,2.0,302
1034,497,195,42.44607709750567,45.02349206349206,24.0,30.0,322,3.0,302
1035,497,217,42.44607709750567,43.88571428571429,24.0,28.0,287,1.0,280
1036,497,243,42.44607709750567,44.837732426303866,24.0,31.0,274,2.0,254
1037,497,243,42.44607709750567,45.093151927437646,24.0,31.0,278,3.0,254
1038,497,440,42.44607709750567,43.88571428571429,24.0,21.0,84,1.0,57
1039,497,432,42.44607709750567,44.977052154195015,24.0,22.0,127,3.0,65
1040,497,438,42.44607709750567,45.00027210884354,24.0,23.0,125,3.0,59
1041,497,731,42.44607709750567,43.653514739229024,24.0,5.0,240,1.0,234
1042,497,631,42.44607709750567,44.791292517006795,24.0,7.0,168,2.0,134
1043,497,626,42.44607709750567,45.30213151927439,24.0,7.0,178,3.0,129
1044,497,847,42.44607709750567,43.49097505668935,24.0,-0.0,353,1.0,350
1045,497,826,42.44607709750567,43.97859410430839,24.0,3.0,336,2.0,329
1046,440,195,43.88571428571429,45.02349206349206,21.0,30.0,250,1.0,245
1047,440,195,43.88571428571429,46.04517006802721,21.0,29.0,262,2.0,245
1048,440,243,43.88571428571429,45.093151927437646,21.0,31.0,204,1.0,197
1049,440,219,43.88571428571429,46.857868480725635,21.0,30.0,255,3.0,221
1050,440,432,43.88571428571429,44.977052154195015,21.0,22.0,48,1.0,8
1051,440,438,43.88571428571429,45.00027210884354,21.0,23.0,48,1.0,2
1052,440,626,43.88571428571429,45.30213151927439,21.0,7.0,196,1.0,186
1053,440,638,43.88571428571429,46.50956916099774,21.0,-0.0,228,3.0,198
1054,432,195,44.977052154195015,46.04517006802721,22.0,29.0,241,1.0,237
1055,432,146,44.977052154195015,47.43836734693878,22.0,28.0,305,2.0,286
1056,432,219,44.977052154195015,46.857868480725635,22.0,30.0,228,2.0,213
1057,432,219,44.977052154195015,47.670566893424045,22.0,32.0,243,3.0,213
1058,432,504,44.977052154195015,46.881088435374146,22.0,20.0,109,2.0,72
1059,432,437,44.977052154195015,47.69378684807257,22.0,23.0,117,3.0,5
1060,432,638,44.977052154195015,46.50956916099774,22.0,-0.0,216,2.0,206
1061,432,813,44.977052154195015,47.8098866213152,22.0,4.0,400,3.0,381
1062,438,195,45.00027210884354,46.04517006802721,23.0,29.0,247,1.0,243
1063,438,146,45.00027210884354,47.43836734693878,23.0,28.0,310,2.0,292
1064,438,219,45.00027210884354,46.857868480725635,23.0,30.0,233,2.0,219
1065,438,219,45.00027210884354,47.670566893424045,23.0,32.0,247,3.0,219
1066,438,504,45.00027210884354,46.881088435374146,23.0,20.0,104,2.0,66
1067,438,437,45.00027210884354,47.69378684807257,23.0,23.0,116,3.0,1
1068,438,638,45.00027210884354,46.50956916099774,23.0,-0.0,210,2.0,200
1069,438,813,45.00027210884354,47.8098866213152,23.0,4.0,394,3.0,375
1070,504,73,46.881088435374146,48.181405895691604,20.0,24.0,435,1.0,431
1071,504,73,46.881088435374146,49.13342403628118,20.0,26.0,442,2.0,431
1072,504,218,46.881088435374146,48.181405895691604,20.0,28.0,291,1.0,286
1073,504,218,46.881088435374146,49.24952380952381,20.0,28.0,304,2.0,286
1074,504,443,46.881088435374146,48.785124716553284,20.0,20.0,102,2.0,61
1075,504,437,46.881088435374146,49.24952380952381,20.0,19.0,122,2.0,67
1076,504,714,46.881088435374146,48.76190476190477,20.0,2.0,225,2.0,210
1077,504,632,46.881088435374146,49.24952380952381,20.0,2.0,164,2.0,128
1078,504,850,46.881088435374146,49.15664399092971,20.0,-0.0,360,2.0,346
1079,437,73,47.69378684807257,49.13342403628118,23.0,26.0,369,1.0,364
1080,437,181,47.69378684807257,50.526621315192735,23.0,24.0,284,3.0,256
1081,437,218,47.69378684807257,49.24952380952381,23.0,28.0,229,2.0,219
1082,437,205,47.69378684807257,50.0390022675737,23.0,27.0,253,2.0,232
1083,437,443,47.69378684807257,48.785124716553284,23.0,20.0,47,1.0,6
1084,437,452,47.69378684807257,50.41052154195012,23.0,17.0,118,3.0,15
1085,437,714,47.69378684807257,48.76190476190477,23.0,2.0,281,1.0,277
1086,437,632,47.69378684807257,49.24952380952381,23.0,2.0,206,2.0,195
1087,437,850,47.69378684807257,49.15664399092971,23.0,-0.0,418,1.0,413
1088,437,832,47.69378684807257,50.41052154195012,23.0,2.0,412,3.0,395
1089,443,181,48.785124716553284,50.526621315192735,20.0,24.0,273,2.0,262
1090,443,153,48.785124716553284,51.13034013605442,20.0,17.0,307,2.0,290
1091,443,205,48.785124716553284,50.0390022675737,20.0,27.0,244,1.0,238
1092,443,243,48.785124716553284,51.54829931972789,20.0,18.0,233,3.0,200
1093,443,452,48.785124716553284,50.41052154195012,20.0,17.0,71,2.0,9
1094,443,499,48.785124716553284,51.13034013605442,20.0,11.0,115,2.0,56
1095,443,625,48.785124716553284,50.87492063492064,20.0,6.0,203,2.0,182
1096,443,832,48.785124716553284,50.41052154195012,20.0,2.0,395,2.0,389
1097,437,181,49.24952380952381,50.526621315192735,19.0,24.0,262,1.0,256
1098,437,153,49.24952380952381,51.13034013605442,19.0,17.0,295,2.0,284
1099,437,243,49.24952380952381,51.54829931972789,19.0,18.0,218,2.0,194
1100,437,452,49.24952380952381,50.41052154195012,19.0,17.0,52,1.0,15
1101,437,499,49.24952380952381,51.13034013605442,19.0,11.0,102,2.0,62
1102,437,625,49.24952380952381,50.87492063492064,19.0,6.0,201,2.0,188
1103,437,628,49.24952380952381,51.85015873015873,19.0,1.0,221,3.0,191
1104,437,832,49.24952380952381,50.41052154195012,19.0,2.0,398,1.0,395
1105,452,82,50.41052154195012,52.50031746031746,17.0,17.0,381,2.0,370
1106,452,243,50.41052154195012,51.54829931972789,17.0,18.0,215,1.0,209
1107,452,245,50.41052154195012,52.87183673469388,17.0,16.0,233,2.0,207
1108,452,497,50.41052154195012,52.77895691609978,17.0,12.0,111,2.0,45
1109,452,628,50.41052154195012,51.85015873015873,17.0,1.0,187,1.0,176
1110,499,82,51.13034013605442,52.50031746031746,11.0,17.0,421,1.0,417
1111,499,195,51.13034013605442,53.475555555555566,11.0,17.0,320,2.0,304
1112,499,245,51.13034013605442,52.87183673469388,11.0,16.0,265,2.0,254
1113,499,244,51.13034013605442,53.475555555555566,11.0,16.0,274,2.0,255
1114,499,497,51.13034013605442,52.77895691609978,11.0,12.0,71,2.0,2
1115,499,438,51.13034013605442,53.475555555555566,11.0,10.0,118,2.0,61
1116,497,182,52.77895691609978,54.86875283446712,12.0,24.0,328,2.0,315
1117,497,87,52.77895691609978,55.542131519274385,12.0,33.0,427,3.0,410
1118,497,218,52.77895691609978,54.89197278911565,12.0,21.0,293,2.0,279
1119,497,259,52.77895691609978,55.49569160997733,12.0,30.0,265,3.0,238
1120,497,417,52.77895691609978,54.961632653061216,12.0,15.0,123,2.0,80
1121,497,432,52.77895691609978,55.49569160997733,12.0,23.0,134,3.0,65
1122,497,648,52.77895691609978,55.309931972789116,12.0,0.0,186,3.0,151
1123,497,831,52.77895691609978,55.17061224489796,12.0,1.0,350,2.0,334
1124,438,182,53.475555555555566,54.86875283446712,10.0,24.0,263,1.0,256
1125,438,87,53.475555555555566,55.542131519274385,10.0,33.0,362,2.0,351
1126,438,87,53.475555555555566,55.98331065759637,10.0,28.0,367,3.0,351
1127,438,218,53.475555555555566,54.89197278911565,10.0,21.0,228,1.0,220
1128,438,259,53.475555555555566,55.49569160997733,10.0,30.0,199,2.0,179
1129,438,259,53.475555555555566,56.029750566893426,10.0,28.0,210,3.0,179
1130,438,417,53.475555555555566,54.961632653061216,10.0,15.0,67,1.0,21
1131,438,432,53.475555555555566,55.49569160997733,10.0,23.0,87,2.0,6
1132,438,648,53.475555555555566,55.309931972789116,10.0,0.0,224,2.0,210
1133,438,831,53.475555555555566,55.17061224489796,10.0,1.0,400,2.0,393
1134,438,832,53.475555555555566,56.122630385487525,10.0,-1.0,410,3.0,394
1135,417,87,54.961632653061216,55.98331065759637,15.0,28.0,333,1.0,330
1136,417,86,54.961632653061216,57.933786848072565,15.0,34.0,355,3.0,331
1137,417,259,54.961632653061216,56.029750566893426,15.0,28.0,165,1.0,158
1138,417,259,54.961632653061216,57.933786848072565,15.0,28.0,203,3.0,158
1139,417,438,54.961632653061216,56.0065306122449,15.0,23.0,50,1.0,21
1140,417,438,54.961632653061216,57.933786848072565,15.0,21.0,130,3.0,21
1141,417,628,54.961632653061216,56.58702947845804,15.0,1.0,222,2.0,211
1142,417,832,54.961632653061216,56.122630385487525,15.0,-1.0,418,1.0,415
1143,432,86,55.49569160997733,57.933786848072565,23.0,34.0,362,2.0,346
1144,432,259,55.49569160997733,57.933786848072565,23.0,28.0,202,2.0,173
1145,432,438,55.49569160997733,57.933786848072565,23.0,21.0,105,2.0,6
1146,432,628,55.49569160997733,56.58702947845804,23.0,1.0,202,1.0,196
1147,438,86,56.0065306122449,57.933786848072565,23.0,34.0,362,2.0,352
1148,438,53,56.0065306122449,58.83936507936508,23.0,26.0,404,3.0,385
1149,438,259,56.0065306122449,57.933786848072565,23.0,28.0,197,2.0,179
1150,438,218,56.0065306122449,58.909024943310655,23.0,29.0,253,3.0,220
1151,438,441,56.0065306122449,58.909024943310655,23.0,19.0,125,3.0,3
1152,438,627,56.0065306122449,58.49106575963719,23.0,2.0,217,2.0,189
1153,438,842,56.0065306122449,58.514285714285705,23.0,-1.0,418,3.0,404
1154,438,195,57.933786848072565,59.11800453514739,21.0,31.0,248,1.0,243
1155,438,244,57.933786848072565,59.141224489795924,21.0,29.0,201,1.0,194
1156,438,439,57.933786848072565,59.11800453514739,21.0,25.0,51,1.0,1
1157,438,617,57.933786848072565,59.466303854875285,21.0,7.0,191,2.0,179
1158,438,842,57.933786848072565,59.466303854875285,21.0,6.0,409,2.0,404
1159,632,172,3.599092970521542,5.085170068027211,4.0,29.0,464,1.0,460
1160,632,218,3.599092970521542,5.224489795918368,4.0,27.0,420,2.0,414
1161,632,249,3.599092970521542,6.03718820861678,4.0,20.0,397,2.0,383
1162,632,506,3.599092970521542,5.224489795918368,4.0,21.0,144,2.0,126
1163,632,419,3.599092970521542,6.060408163265307,4.0,13.0,238,2.0,213
1164,632,636,3.599092970521542,5.224489795918368,4.0,5.0,70,2.0,4
1165,632,850,3.599092970521542,5.061950113378685,4.0,4.0,227,1.0,218
1166,615,218,4.08671201814059,5.224489795918368,6.0,27.0,400,1.0,397
1167,615,249,4.08671201814059,6.03718820861678,6.0,20.0,376,2.0,366
1168,615,506,4.08671201814059,5.224489795918368,6.0,21.0,120,1.0,109
1169,615,419,4.08671201814059,6.060408163265307,6.0,13.0,214,2.0,196
1170,615,636,4.08671201814059,5.224489795918368,6.0,5.0,53,1.0,21
1171,636,224,5.224489795918368,7.198185941043084,5.0,11.0,421,2.0,412
1172,636,489,5.224489795918368,7.8947845804988654,5.0,0.0,187,3.0,147
1173,661,219,16.880907029478458,18.274104308390022,2.0,31.0,446,1.0,442
1174,661,246,16.880907029478458,19.574421768707484,2.0,26.0,431,3.0,415
1175,661,437,16.880907029478458,18.29732426303855,2.0,21.0,232,1.0,224
1176,661,410,16.880907029478458,19.574421768707484,2.0,19.0,277,3.0,251
1177,661,662,16.880907029478458,18.320544217687075,2.0,3.0,62,1.0,1
1178,661,713,16.880907029478458,19.272562358276645,2.0,1.0,115,2.0,52
1179,649,182,17.69360544217687,20.54965986394558,5.0,31.0,483,3.0,467
1180,649,246,17.69360544217687,19.574421768707484,5.0,26.0,411,2.0,403
1181,649,255,17.69360544217687,20.572879818594107,5.0,29.0,413,3.0,394
1182,649,410,17.69360544217687,19.574421768707484,5.0,19.0,252,2.0,239
1183,649,468,17.69360544217687,20.52643990929705,5.0,21.0,218,3.0,181
1184,649,713,17.69360544217687,19.272562358276645,5.0,1.0,93,2.0,64
1185,649,661,17.69360544217687,20.54965986394558,5.0,6.0,124,3.0,12
1186,649,827,17.69360544217687,20.50321995464852,5.0,3.0,215,3.0,178
1187,662,182,18.320544217687075,20.54965986394558,3.0,31.0,490,2.0,480
1188,662,195,18.320544217687075,21.03727891156463,3.0,29.0,481,3.0,467
1189,662,246,18.320544217687075,19.574421768707484,3.0,26.0,419,1.0,416
1190,662,255,18.320544217687075,20.572879818594107,3.0,29.0,418,2.0,407
1191,662,243,18.320544217687075,21.03727891156463,3.0,31.0,435,3.0,419
1192,662,410,18.320544217687075,19.574421768707484,3.0,19.0,258,1.0,252
1193,662,468,18.320544217687075,20.52643990929705,3.0,21.0,216,2.0,194
1194,662,438,18.320544217687075,21.03727891156463,3.0,23.0,253,3.0,224
1195,662,661,18.320544217687075,20.54965986394558,3.0,6.0,96,2.0,1
1196,662,638,18.320544217687075,21.03727891156463,3.0,8.0,119,3.0,24
1197,662,827,18.320544217687075,20.50321995464852,3.0,3.0,190,2.0,165
1198,713,255,19.272562358276645,20.572879818594107,1.0,29.0,461,1.0,458
1199,713,243,19.272562358276645,21.03727891156463,1.0,31.0,476,2.0,470
1200,713,468,19.272562358276645,20.52643990929705,1.0,21.0,251,1.0,245
1201,713,438,19.272562358276645,21.03727891156463,1.0,23.0,285,2.0,275
1202,713,450,19.272562358276645,22.01251700680272,1.0,22.0,288,3.0,263
1203,713,661,19.272562358276645,20.54965986394558,1.0,6.0,76,1.0,52
1204,713,638,19.272562358276645,21.03727891156463,1.0,8.0,107,2.0,75
1205,713,827,19.272562358276645,20.50321995464852,1.0,3.0,126,1.0,114
1206,713,850,19.272562358276645,21.339138321995467,1.0,1.0,163,2.0,137
1207,661,194,20.54965986394558,22.964535147392287,6.0,30.0,478,2.0,467
1208,661,195,20.54965986394558,22.98775510204082,6.0,30.0,478,2.0,466
1209,661,243,20.54965986394558,22.964535147392287,6.0,32.0,431,2.0,418
1210,661,243,20.54965986394558,22.98775510204082,6.0,32.0,431,2.0,418
1211,661,450,20.54965986394558,22.01251700680272,6.0,22.0,220,1.0,211
1212,661,438,20.54965986394558,22.98775510204082,6.0,22.0,246,2.0,223
1213,661,638,20.54965986394558,22.964535147392287,6.0,8.0,107,2.0,23
1214,661,615,20.54965986394558,23.38249433106576,6.0,7.0,130,3.0,46
1215,661,865,20.54965986394558,22.91809523809524,6.0,-0.0,228,2.0,204
1216,638,194,21.03727891156463,22.964535147392287,8.0,30.0,452,2.0,444
1217,638,195,21.03727891156463,22.98775510204082,8.0,30.0,451,2.0,443
1218,638,243,21.03727891156463,22.964535147392287,8.0,32.0,404,2.0,395
1219,638,243,21.03727891156463,22.98775510204082,8.0,32.0,404,2.0,395
1220,638,438,21.03727891156463,22.98775510204082,8.0,22.0,217,2.0,200
1221,638,615,21.03727891156463,23.38249433106576,8.0,7.0,104,2.0,23
1222,638,865,21.03727891156463,22.91809523809524,8.0,-0.0,241,2.0,227
1223,638,827,21.03727891156463,23.91655328798186,8.0,1.0,226,3.0,189
1224,638,255,22.964535147392287,24.96145124716553,8.0,30.0,393,2.0,383
1225,638,255,22.964535147392287,25.44907029478458,8.0,30.0,398,2.0,383
1226,638,417,22.964535147392287,24.79891156462585,8.0,22.0,235,2.0,221
1227,638,486,22.964535147392287,25.309750566893424,8.0,23.0,182,2.0,152
1228,638,661,22.964535147392287,24.357732426303848,8.0,5.0,64,1.0,23
1229,638,815,22.964535147392287,25.286530612244896,8.0,6.0,203,2.0,177
1230,638,825,22.964535147392287,24.845351473922907,8.0,4.0,204,2.0,187
1231,638,826,22.964535147392287,25.286530612244896,8.0,5.0,213,2.0,188
1232,615,255,23.38249433106576,24.96145124716553,7.0,30.0,366,2.0,360
1233,615,255,23.38249433106576,25.44907029478458,7.0,30.0,371,2.0,360
1234,615,219,23.38249433106576,26.21532879818594,7.0,30.0,414,3.0,396
1235,615,417,23.38249433106576,24.79891156462585,7.0,22.0,207,1.0,198
1236,615,486,23.38249433106576,25.309750566893424,7.0,23.0,153,2.0,129
1237,615,815,23.38249433106576,25.286530612244896,7.0,6.0,216,2.0,200
1238,615,825,23.38249433106576,24.845351473922907,7.0,4.0,219,1.0,210
1239,615,826,23.38249433106576,25.286530612244896,7.0,5.0,226,2.0,211
1240,661,255,24.357732426303848,25.44907029478458,5.0,30.0,409,1.0,406
1241,661,219,24.357732426303848,26.21532879818594,5.0,30.0,449,2.0,442
1242,661,486,24.357732426303848,26.72616780045352,5.0,24.0,203,2.0,175
1243,661,627,24.357732426303848,26.424308390022677,5.0,6.0,95,2.0,34
1244,661,648,24.357732426303848,27.21378684807256,5.0,8.0,124,3.0,13
1245,661,825,24.357732426303848,26.72616780045352,5.0,5.0,193,2.0,164
1246,661,842,24.357732426303848,27.30666666666667,5.0,2.0,221,3.0,181
1247,815,486,25.286530612244896,26.72616780045352,6.0,24.0,335,1.0,329
1248,815,439,25.286530612244896,27.422766439909296,6.0,24.0,387,2.0,376
1249,815,627,25.286530612244896,26.424308390022677,6.0,6.0,194,1.0,188
1250,815,648,25.286530612244896,27.21378684807256,6.0,8.0,186,2.0,167
1251,815,825,25.286530612244896,26.72616780045352,6.0,5.0,63,1.0,10
1252,815,842,25.286530612244896,27.30666666666667,6.0,2.0,91,2.0,27
1253,627,195,26.424308390022677,28.65342403628118,6.0,30.0,443,2.0,432
1254,627,260,26.424308390022677,27.445986394557824,6.0,29.0,370,1.0,367
1255,627,243,26.424308390022677,28.676643990929705,6.0,30.0,396,2.0,384
1256,627,218,26.424308390022677,29.094603174603176,6.0,30.0,425,3.0,409
1257,627,439,26.424308390022677,28.630204081632648,6.0,22.0,211,2.0,188
1258,627,441,26.424308390022677,29.094603174603176,6.0,22.0,219,3.0,186
1259,627,628,26.424308390022677,28.630204081632648,6.0,9.0,95,2.0,1
1260,627,615,26.424308390022677,29.094603174603176,6.0,4.0,116,3.0,12
1261,627,860,26.424308390022677,28.42122448979592,6.0,2.0,248,2.0,233
1262,648,195,27.21378684807256,28.65342403628118,8.0,30.0,457,1.0,453
1263,648,204,27.21378684807256,29.628662131519274,8.0,28.0,456,2.0,444
1264,648,243,27.21378684807256,28.676643990929705,8.0,30.0,410,1.0,405
1265,648,218,27.21378684807256,29.094603174603176,8.0,30.0,438,2.0,430
1266,648,439,27.21378684807256,28.630204081632648,8.0,22.0,218,1.0,209
1267,648,441,27.21378684807256,29.094603174603176,8.0,22.0,222,2.0,207
1268,648,628,27.21378684807256,28.630204081632648,8.0,9.0,64,1.0,20
1269,648,615,27.21378684807256,29.094603174603176,8.0,4.0,87,2.0,33
1270,648,860,27.21378684807256,28.42122448979592,8.0,2.0,218,1.0,212
1271,628,195,28.630204081632648,30.603900226757368,9.0,31.0,441,2.0,433
1272,628,182,28.630204081632648,31.532698412698412,9.0,29.0,463,3.0,446
1273,628,242,28.630204081632648,30.557460317460322,9.0,32.0,395,2.0,386
1274,628,218,28.630204081632648,30.998639455782317,9.0,30.0,422,2.0,410
1275,628,439,28.630204081632648,30.603900226757368,9.0,24.0,207,2.0,189
1276,628,441,28.630204081632648,30.998639455782317,9.0,22.0,213,2.0,187
1277,628,648,28.630204081632648,30.998639455782317,9.0,6.0,104,2.0,20
1278,628,850,28.630204081632648,30.859319727891158,9.0,1.0,242,2.0,222
1279,628,826,28.630204081632648,31.532698412698412,9.0,-0.0,234,3.0,198
1280,615,195,29.094603174603176,30.603900226757368,4.0,31.0,425,2.0,420
1281,615,182,29.094603174603176,31.532698412698412,4.0,29.0,446,2.0,433
1282,615,242,29.094603174603176,30.557460317460322,4.0,32.0,378,1.0,373
1283,615,218,29.094603174603176,30.998639455782317,4.0,30.0,405,2.0,397
1284,615,218,29.094603174603176,31.997097505668936,4.0,29.0,416,3.0,397
1285,615,439,29.094603174603176,30.603900226757368,4.0,24.0,188,2.0,176
1286,615,441,29.094603174603176,30.998639455782317,4.0,22.0,192,2.0,174
1287,615,628,29.094603174603176,30.603900226757368,4.0,9.0,66,2.0,13
1288,615,648,29.094603174603176,30.998639455782317,4.0,6.0,88,2.0,33
1289,615,850,29.094603174603176,30.859319727891158,4.0,1.0,247,2.0,235
1290,615,826,29.094603174603176,31.532698412698412,4.0,-0.0,236,2.0,211
1291,628,218,30.603900226757368,31.997097505668936,9.0,29.0,414,1.0,410
1292,628,485,30.603900226757368,32.92589569160998,9.0,24.0,174,2.0,143
1293,628,627,30.603900226757368,32.13641723356009,9.0,7.0,66,2.0,1
1294,628,824,30.603900226757368,32.92589569160998,9.0,4.0,220,2.0,196
1295,628,842,30.603900226757368,33.01877551020408,9.0,2.0,238,2.0,214
1296,648,219,30.998639455782317,33.8314739229025,6.0,29.0,446,3.0,429
1297,648,485,30.998639455782317,32.92589569160998,6.0,24.0,183,2.0,163
1298,648,443,30.998639455782317,33.877913832199546,6.0,23.0,240,3.0,205
1299,648,627,30.998639455782317,32.13641723356009,6.0,7.0,53,1.0,21
1300,648,615,30.998639455782317,33.94757369614513,6.0,5.0,131,3.0,33
1301,648,824,30.998639455782317,32.92589569160998,6.0,4.0,195,2.0,176
1302,648,842,30.998639455782317,33.01877551020408,6.0,2.0,213,2.0,194
1303,627,219,32.13641723356009,33.8314739229025,7.0,29.0,414,2.0,408
1304,627,251,32.13641723356009,34.4584126984127,7.0,28.0,389,2.0,376
1305,627,443,32.13641723356009,33.877913832199546,7.0,23.0,199,2.0,184
1306,627,486,32.13641723356009,34.34231292517007,7.0,24.0,170,2.0,141
1307,627,432,32.13641723356009,35.03891156462585,7.0,23.0,232,3.0,195
1308,627,615,32.13641723356009,33.94757369614513,7.0,5.0,79,2.0,12
1309,627,631,32.13641723356009,33.99401360544218,7.0,8.0,80,2.0,4
1310,627,827,32.13641723356009,34.80671201814059,7.0,5.0,231,3.0,200
1311,615,195,33.94757369614513,36.29278911564626,5.0,30.0,432,2.0,420
1312,615,219,33.94757369614513,35.75873015873015,5.0,29.0,404,2.0,396
1313,615,243,33.94757369614513,36.269569160997726,5.0,31.0,385,2.0,372
1314,615,432,33.94757369614513,35.03891156462585,5.0,23.0,189,1.0,183
1315,615,438,33.94757369614513,36.269569160997726,5.0,24.0,203,2.0,177
1316,615,630,33.94757369614513,35.92126984126985,5.0,7.0,86,2.0,15
1317,615,638,33.94757369614513,36.269569160997726,5.0,7.0,103,2.0,23
1318,615,827,33.94757369614513,35.75873015873015,5.0,1.0,226,2.0,212
1319,615,861,33.94757369614513,36.037369614512464,5.0,1.0,262,2.0,246
1320,631,195,33.99401360544218,36.29278911564626,8.0,30.0,447,2.0,436
1321,631,219,33.99401360544218,35.75873015873015,8.0,29.0,419,2.0,412
1322,631,243,33.99401360544218,36.269569160997726,8.0,31.0,400,2.0,388
1323,631,432,33.99401360544218,35.03891156462585,8.0,23.0,204,1.0,199
1324,631,438,33.99401360544218,36.269569160997726,8.0,24.0,216,2.0,193
1325,631,630,33.99401360544218,35.92126984126985,8.0,7.0,83,2.0,1
1326,631,638,33.99401360544218,36.269569160997726,8.0,7.0,98,2.0,7
1327,631,827,33.99401360544218,35.75873015873015,8.0,1.0,210,2.0,196
1328,631,861,33.99401360544218,36.037369614512464,8.0,1.0,246,2.0,230
1329,630,204,35.92126984126985,37.9181859410431,7.0,28.0,435,2.0,426
1330,630,194,35.92126984126985,38.196825396825396,7.0,31.0,447,2.0,436
1331,630,205,35.92126984126985,37.24480725623583,7.0,29.0,429,1.0,425
1332,630,243,35.92126984126985,38.22004535147392,7.0,32.0,399,2.0,387
1333,630,450,35.92126984126985,37.221587301587306,7.0,23.0,189,1.0,180
1334,630,437,35.92126984126985,38.196825396825396,7.0,23.0,216,2.0,193
1335,630,629,35.92126984126985,37.151927437641724,7.0,3.0,53,1.0,1
1336,630,637,35.92126984126985,38.196825396825396,7.0,9.0,98,2.0,7
1337,630,852,35.92126984126985,38.49868480725624,7.0,-0.0,248,3.0,222
1338,638,204,36.269569160997726,37.9181859410431,7.0,28.0,440,2.0,434
1339,638,194,36.269569160997726,38.196825396825396,7.0,31.0,452,2.0,444
1340,638,243,36.269569160997726,38.22004535147392,7.0,32.0,404,2.0,395
1341,638,219,36.269569160997726,39.14884353741497,7.0,29.0,437,3.0,419
1342,638,437,36.269569160997726,38.196825396825396,7.0,23.0,217,2.0,201
1343,638,637,36.269569160997726,38.196825396825396,7.0,9.0,83,2.0,1
1344,638,852,36.269569160997726,38.49868480725624,7.0,-0.0,235,2.0,214
1345,629,194,37.151927437641724,38.196825396825396,3.0,31.0,437,1.0,435
1346,629,243,37.151927437641724,38.22004535147392,3.0,32.0,389,1.0,386
1347,629,219,37.151927437641724,39.14884353741497,3.0,29.0,419,2.0,410
1348,629,437,37.151927437641724,38.196825396825396,3.0,23.0,197,1.0,192
1349,629,437,37.151927437641724,39.59002267573696,3.0,20.0,219,2.0,192
1350,629,637,37.151927437641724,38.196825396825396,3.0,9.0,46,1.0,8
1351,629,626,37.151927437641724,39.543582766439904,3.0,5.0,103,2.0,3
1352,629,661,37.151927437641724,40.05442176870749,3.0,6.0,129,3.0,32
1353,629,852,37.151927437641724,38.49868480725624,3.0,-0.0,230,1.0,223
1354,629,828,37.151927437641724,39.543582766439904,3.0,2.0,224,2.0,199
1355,637,249,38.196825396825396,40.170521541950116,9.0,28.0,397,2.0,388
1356,637,437,38.196825396825396,39.59002267573696,9.0,20.0,209,1.0,200
1357,637,486,38.196825396825396,40.542040816326534,9.0,24.0,182,2.0,151
1358,637,626,38.196825396825396,39.543582766439904,9.0,5.0,59,1.0,11
1359,637,661,38.196825396825396,40.05442176870749,9.0,6.0,84,2.0,24
1360,637,828,38.196825396825396,39.543582766439904,9.0,2.0,200,1.0,191
1361,637,826,38.196825396825396,40.51882086167801,9.0,6.0,214,2.0,189
1362,626,182,39.543582766439904,41.494058956916106,5.0,30.0,452,2.0,444
1363,626,219,39.543582766439904,41.540498866213156,5.0,28.0,416,2.0,407
1364,626,327,39.543582766439904,41.98167800453515,5.0,27.0,317,2.0,299
1365,626,492,39.543582766439904,41.958458049886616,5.0,22.0,170,2.0,134
1366,626,497,39.543582766439904,42.44607709750567,5.0,24.0,180,3.0,129
1367,626,627,39.543582766439904,41.65659863945578,5.0,6.0,91,2.0,1
1368,626,827,39.543582766439904,41.935238095238105,5.0,3.0,226,2.0,201
1369,626,824,39.543582766439904,41.98167800453515,5.0,3.0,224,2.0,198
1370,661,182,40.05442176870749,41.494058956916106,6.0,30.0,483,1.0,479
1371,661,219,40.05442176870749,41.540498866213156,6.0,28.0,447,1.0,442
1372,661,327,40.05442176870749,41.98167800453515,6.0,27.0,344,2.0,334
1373,661,492,40.05442176870749,41.958458049886616,6.0,22.0,188,2.0,169
1374,661,497,40.05442176870749,42.44607709750567,6.0,24.0,194,2.0,164
1375,661,627,40.05442176870749,41.65659863945578,6.0,6.0,77,2.0,34
1376,661,626,40.05442176870749,42.91047619047619,6.0,5.0,128,3.0,35
1377,661,827,40.05442176870749,41.935238095238105,6.0,3.0,185,2.0,166
1378,661,824,40.05442176870749,41.98167800453515,6.0,3.0,183,2.0,163
1379,627,173,41.65659863945578,43.560634920634925,6.0,29.0,461,2.0,454
1380,627,217,41.65659863945578,43.88571428571429,6.0,28.0,421,2.0,410
1381,627,440,41.65659863945578,43.88571428571429,6.0,21.0,210,2.0,187
1382,627,626,41.65659863945578,42.91047619047619,6.0,5.0,54,1.0,1
1383,627,731,41.65659863945578,43.653514739229024,6.0,5.0,135,2.0,104
1384,627,847,41.65659863945578,43.49097505668935,6.0,-0.0,234,2.0,220
1385,627,826,41.65659863945578,43.97859410430839,6.0,3.0,223,2.0,199
1386,626,195,42.91047619047619,44.814512471655334,5.0,31.0,439,2.0,431
1387,626,195,42.91047619047619,45.02349206349206,5.0,30.0,441,2.0,431
1388,626,243,42.91047619047619,44.837732426303866,5.0,31.0,392,2.0,383
1389,626,243,42.91047619047619,45.093151927437646,5.0,31.0,394,2.0,383
1390,626,432,42.91047619047619,44.977052154195015,5.0,22.0,213,2.0,194
1391,626,438,42.91047619047619,45.00027210884354,5.0,23.0,208,2.0,188
1392,626,631,42.91047619047619,44.791292517006795,5.0,7.0,81,2.0,5
1393,626,826,42.91047619047619,43.97859410430839,5.0,3.0,205,1.0,200
1394,731,243,43.653514739229024,44.837732426303866,5.0,31.0,491,1.0,488
1395,731,243,43.653514739229024,45.093151927437646,5.0,31.0,492,1.0,488
1396,731,432,43.653514739229024,44.977052154195015,5.0,22.0,304,1.0,299
1397,731,438,43.653514739229024,45.00027210884354,5.0,23.0,299,1.0,293
1398,731,631,43.653514739229024,44.791292517006795,5.0,7.0,111,1.0,100
1399,731,626,43.653514739229024,45.30213151927439,5.0,7.0,127,2.0,105
1400,731,638,43.653514739229024,46.50956916099774,5.0,-0.0,154,3.0,93
1401,631,195,44.791292517006795,46.04517006802721,7.0,29.0,439,1.0,436
1402,631,146,44.791292517006795,47.43836734693878,7.0,28.0,498,3.0,485
1403,631,219,44.791292517006795,46.857868480725635,7.0,30.0,422,2.0,412
1404,631,219,44.791292517006795,47.670566893424045,7.0,32.0,430,3.0,412
1405,631,504,44.791292517006795,46.881088435374146,7.0,20.0,156,2.0,127
1406,631,437,44.791292517006795,47.69378684807257,7.0,23.0,231,3.0,194
1407,631,638,44.791292517006795,46.50956916099774,7.0,-0.0,74,2.0,7
1408,626,146,45.30213151927439,47.43836734693878,7.0,28.0,489,2.0,480
1409,626,219,45.30213151927439,46.857868480725635,7.0,30.0,412,2.0,407
1410,626,219,45.30213151927439,47.670566893424045,7.0,32.0,420,2.0,407
1411,626,218,45.30213151927439,48.181405895691604,7.0,28.0,426,3.0,408
1412,626,504,45.30213151927439,46.881088435374146,7.0,20.0,140,2.0,122
1413,626,437,45.30213151927439,47.69378684807257,7.0,23.0,215,2.0,189
1414,626,638,45.30213151927439,46.50956916099774,7.0,-0.0,53,1.0,12
1415,626,813,45.30213151927439,47.8098866213152,7.0,4.0,216,3.0,187
1416,638,219,46.50956916099774,47.670566893424045,-0.0,32.0,422,1.0,419
1417,638,218,46.50956916099774,48.181405895691604,-0.0,28.0,426,2.0,420
1418,638,218,46.50956916099774,49.24952380952381,-0.0,28.0,436,3.0,420
1419,638,437,46.50956916099774,47.69378684807257,-0.0,23.0,207,1.0,201
1420,638,443,46.50956916099774,48.785124716553284,-0.0,20.0,218,2.0,195
1421,638,437,46.50956916099774,49.24952380952381,-0.0,19.0,233,3.0,201
1422,638,813,46.50956916099774,47.8098866213152,-0.0,4.0,184,1.0,175
1423,638,714,46.50956916099774,48.76190476190477,-0.0,2.0,123,2.0,76
1424,638,632,46.50956916099774,49.24952380952381,-0.0,2.0,118,3.0,6
1425,638,850,46.50956916099774,49.15664399092971,-0.0,-0.0,241,3.0,212
1426,813,437,47.8098866213152,49.24952380952381,4.0,19.0,381,1.0,376
1427,813,452,47.8098866213152,50.41052154195012,4.0,17.0,378,3.0,361
1428,813,632,47.8098866213152,49.24952380952381,4.0,2.0,191,1.0,181
1429,813,850,47.8098866213152,49.15664399092971,4.0,-0.0,69,1.0,37
1430,813,832,47.8098866213152,50.41052154195012,4.0,2.0,114,3.0,19
1431,714,243,48.76190476190477,51.54829931972789,2.0,18.0,486,3.0,471
1432,714,452,48.76190476190477,50.41052154195012,2.0,17.0,271,2.0,262
1433,714,499,48.76190476190477,51.13034013605442,2.0,11.0,238,2.0,215
1434,714,625,48.76190476190477,50.87492063492064,2.0,6.0,127,2.0,89
1435,714,832,48.76190476190477,50.41052154195012,2.0,2.0,138,2.0,118
1436,632,181,49.24952380952381,50.526621315192735,2.0,24.0,454,1.0,451
1437,632,153,49.24952380952381,51.13034013605442,2.0,17.0,486,2.0,479
1438,632,243,49.24952380952381,51.54829931972789,2.0,18.0,401,2.0,389
1439,632,452,49.24952380952381,50.41052154195012,2.0,17.0,187,1.0,180
1440,632,499,49.24952380952381,51.13034013605442,2.0,11.0,156,2.0,133
1441,632,625,49.24952380952381,50.87492063492064,2.0,6.0,70,2.0,7
1442,632,628,49.24952380952381,51.85015873015873,2.0,1.0,112,3.0,4
1443,632,832,49.24952380952381,50.41052154195012,2.0,2.0,206,1.0,200
1444,625,195,50.87492063492064,53.475555555555566,6.0,17.0,444,3.0,430
1445,625,245,50.87492063492064,52.87183673469388,6.0,16.0,390,2.0,380
1446,625,244,50.87492063492064,53.475555555555566,6.0,16.0,397,3.0,381
1447,625,497,50.87492063492064,52.77895691609978,6.0,12.0,152,2.0,128
1448,625,438,50.87492063492064,53.475555555555566,6.0,10.0,218,3.0,187
1449,628,195,51.85015873015873,53.475555555555566,1.0,17.0,439,2.0,433
1450,628,245,51.85015873015873,52.87183673469388,1.0,16.0,386,1.0,383
1451,628,244,51.85015873015873,53.475555555555566,1.0,16.0,390,2.0,384
1452,628,438,51.85015873015873,53.475555555555566,1.0,10.0,202,2.0,190
1453,648,259,55.309931972789116,57.933786848072565,0.0,28.0,405,3.0,389
1454,648,438,55.309931972789116,57.933786848072565,0.0,21.0,238,3.0,210
1455,648,628,55.309931972789116,56.58702947845804,0.0,1.0,59,1.0,20
1456,628,195,56.58702947845804,59.11800453514739,1.0,31.0,447,3.0,433
1457,628,259,56.58702947845804,57.933786848072565,1.0,28.0,374,1.0,369
1458,628,218,56.58702947845804,58.909024943310655,1.0,29.0,422,2.0,410
1459,628,244,56.58702947845804,59.141224489795924,1.0,29.0,399,3.0,384
1460,628,438,56.58702947845804,57.933786848072565,1.0,21.0,199,1.0,190
1461,628,441,56.58702947845804,58.909024943310655,1.0,19.0,212,2.0,187
1462,628,439,56.58702947845804,59.11800453514739,1.0,25.0,218,3.0,189
1463,628,627,56.58702947845804,58.49106575963719,1.0,2.0,82,2.0,1
1464,628,617,56.58702947845804,59.466303854875285,1.0,7.0,124,3.0,11
1465,628,842,56.58702947845804,58.514285714285705,1.0,-1.0,230,2.0,214
1466,628,842,56.58702947845804,59.466303854875285,1.0,6.0,247,3.0,214
1467,844,506,3.8545124716553287,5.224489795918368,4.0,21.0,343,1.0,338
1468,844,419,3.8545124716553287,6.060408163265307,4.0,13.0,435,2.0,425
1469,844,636,3.8545124716553287,5.224489795918368,4.0,5.0,216,1.0,208
1470,844,850,3.8545124716553287,5.061950113378685,4.0,4.0,52,1.0,6
1471,843,506,4.133151927437642,5.224489795918368,4.0,21.0,340,1.0,337
1472,843,419,4.133151927437642,6.060408163265307,4.0,13.0,432,2.0,424
1473,843,636,4.133151927437642,5.224489795918368,4.0,5.0,212,1.0,207
1474,850,489,5.061950113378685,7.8947845804988654,4.0,0.0,381,3.0,361
1475,861,410,17.69360544217687,19.574421768707484,2.0,19.0,458,2.0,451
1476,861,468,17.69360544217687,20.52643990929705,2.0,21.0,412,3.0,393
1477,861,713,17.69360544217687,19.272562358276645,2.0,1.0,163,2.0,148
1478,861,661,17.69360544217687,20.54965986394558,2.0,6.0,235,3.0,200
1479,861,827,17.69360544217687,20.50321995464852,2.0,3.0,126,3.0,34
1480,827,450,20.50321995464852,22.01251700680272,3.0,22.0,383,2.0,377
1481,827,438,20.50321995464852,22.98775510204082,3.0,22.0,403,2.0,389
1482,827,638,20.50321995464852,22.964535147392287,3.0,8.0,217,2.0,189
1483,827,615,20.50321995464852,23.38249433106576,3.0,7.0,246,3.0,212
1484,827,865,20.50321995464852,22.91809523809524,3.0,-0.0,111,2.0,38
1485,850,438,21.339138321995467,22.98775510204082,1.0,22.0,418,2.0,412
1486,850,638,21.339138321995467,22.964535147392287,1.0,8.0,223,2.0,212
1487,850,615,21.339138321995467,23.38249433106576,1.0,7.0,251,2.0,235
1488,850,865,21.339138321995467,22.91809523809524,1.0,-0.0,70,2.0,15
1489,850,827,21.339138321995467,23.91655328798186,1.0,1.0,113,3.0,23
1490,865,417,22.91809523809524,24.79891156462585,-0.0,22.0,455,2.0,448
1491,865,486,22.91809523809524,25.309750566893424,-0.0,23.0,393,2.0,379
1492,865,661,22.91809523809524,24.357732426303848,-0.0,5.0,213,1.0,204
1493,865,815,22.91809523809524,25.286530612244896,-0.0,6.0,114,2.0,50
1494,865,825,22.91809523809524,24.845351473922907,-0.0,4.0,92,2.0,40
1495,865,826,22.91809523809524,25.286530612244896,-0.0,5.0,109,2.0,39
1496,827,486,23.91655328798186,25.309750566893424,1.0,23.0,346,1.0,341
1497,827,486,23.91655328798186,26.72616780045352,1.0,24.0,362,3.0,341
1498,827,815,23.91655328798186,25.286530612244896,1.0,6.0,60,1.0,12
1499,827,627,23.91655328798186,26.424308390022677,1.0,6.0,227,3.0,200
1500,827,826,23.91655328798186,25.286530612244896,1.0,5.0,59,1.0,1
1501,827,825,23.91655328798186,26.72616780045352,1.0,5.0,121,3.0,2
1502,825,486,24.845351473922907,26.72616780045352,4.0,24.0,349,2.0,339
1503,825,439,24.845351473922907,27.422766439909296,4.0,24.0,402,3.0,386
1504,825,627,24.845351473922907,26.424308390022677,4.0,6.0,209,2.0,198
1505,825,648,24.845351473922907,27.21378684807256,4.0,8.0,204,2.0,177
1506,825,842,24.845351473922907,27.30666666666667,4.0,2.0,107,2.0,17
1507,826,486,25.286530612244896,26.72616780045352,5.0,24.0,346,1.0,340
1508,826,439,25.286530612244896,27.422766439909296,5.0,24.0,398,2.0,387
1509,826,627,25.286530612244896,26.424308390022677,5.0,6.0,205,1.0,199
1510,826,648,25.286530612244896,27.21378684807256,5.0,8.0,196,2.0,178
1511,826,825,25.286530612244896,26.72616780045352,5.0,5.0,62,1.0,1
1512,826,842,25.286530612244896,27.30666666666667,5.0,2.0,88,2.0,16
1513,825,439,26.72616780045352,28.630204081632648,5.0,22.0,395,2.0,386
1514,825,441,26.72616780045352,29.094603174603176,5.0,22.0,397,2.0,384
1515,825,628,26.72616780045352,28.630204081632648,5.0,9.0,213,2.0,197
1516,825,615,26.72616780045352,29.094603174603176,5.0,4.0,233,2.0,210
1517,825,860,26.72616780045352,28.42122448979592,5.0,2.0,81,2.0,35
1518,842,439,27.30666666666667,28.630204081632648,2.0,22.0,407,1.0,403
1519,842,441,27.30666666666667,29.094603174603176,2.0,22.0,408,2.0,401
1520,842,628,27.30666666666667,28.630204081632648,2.0,9.0,221,1.0,214
1521,842,615,27.30666666666667,29.094603174603176,2.0,4.0,240,2.0,227
1522,842,860,27.30666666666667,28.42122448979592,2.0,2.0,51,1.0,18
1523,860,439,28.42122448979592,30.603900226757368,2.0,24.0,431,2.0,421
1524,860,441,28.42122448979592,30.998639455782317,2.0,22.0,433,3.0,419
1525,860,628,28.42122448979592,30.603900226757368,2.0,9.0,250,2.0,232
1526,860,648,28.42122448979592,30.998639455782317,2.0,6.0,239,3.0,212
1527,860,850,28.42122448979592,30.859319727891158,2.0,1.0,105,2.0,10
1528,850,485,30.859319727891158,32.92589569160998,1.0,24.0,376,2.0,365
1529,850,627,30.859319727891158,32.13641723356009,1.0,7.0,230,1.0,223
1530,850,824,30.859319727891158,32.92589569160998,1.0,4.0,93,2.0,26
1531,850,842,30.859319727891158,33.01877551020408,1.0,2.0,93,2.0,8
1532,826,485,31.532698412698412,32.92589569160998,-0.0,24.0,346,1.0,341
1533,826,443,31.532698412698412,33.877913832199546,-0.0,23.0,396,2.0,383
1534,826,486,31.532698412698412,34.34231292517007,-0.0,24.0,361,3.0,340
1535,826,615,31.532698412698412,33.94757369614513,-0.0,5.0,235,2.0,211
1536,826,631,31.532698412698412,33.99401360544218,-0.0,8.0,222,2.0,195
1537,826,824,31.532698412698412,32.92589569160998,-0.0,4.0,60,1.0,2
1538,826,842,31.532698412698412,33.01877551020408,-0.0,2.0,66,1.0,16
1539,824,486,32.92589569160998,34.34231292517007,4.0,24.0,343,1.0,338
1540,824,432,32.92589569160998,35.03891156462585,4.0,23.0,402,2.0,392
1541,824,615,32.92589569160998,33.94757369614513,4.0,5.0,214,1.0,209
1542,824,631,32.92589569160998,33.99401360544218,4.0,8.0,198,1.0,193
1543,824,827,32.92589569160998,34.80671201814059,4.0,5.0,81,2.0,3
1544,824,827,32.92589569160998,35.75873015873015,4.0,1.0,122,3.0,3
1545,842,486,33.01877551020408,34.34231292517007,2.0,24.0,361,1.0,356
1546,842,432,33.01877551020408,35.03891156462585,2.0,23.0,419,2.0,410
1547,842,630,33.01877551020408,35.92126984126985,2.0,7.0,246,3.0,212
1548,842,827,33.01877551020408,34.80671201814059,2.0,5.0,78,2.0,15
1549,842,827,33.01877551020408,35.75873015873015,2.0,1.0,119,3.0,15
1550,827,438,34.80671201814059,36.269569160997726,5.0,24.0,394,1.0,389
1551,827,450,34.80671201814059,37.221587301587306,5.0,23.0,391,2.0,377
1552,827,630,34.80671201814059,35.92126984126985,5.0,7.0,203,1.0,197
1553,827,638,34.80671201814059,36.269569160997726,5.0,7.0,199,1.0,189
1554,827,629,34.80671201814059,37.151927437641724,5.0,3.0,222,2.0,198
1555,827,861,34.80671201814059,36.037369614512464,5.0,1.0,63,1.0,34
1556,827,450,35.75873015873015,37.221587301587306,1.0,23.0,382,1.0,377
1557,827,437,35.75873015873015,38.196825396825396,1.0,23.0,404,2.0,390
1558,827,629,35.75873015873015,37.151927437641724,1.0,3.0,207,1.0,198
1559,827,637,35.75873015873015,38.196825396825396,1.0,9.0,217,2.0,190
1560,827,852,35.75873015873015,38.49868480725624,1.0,-0.0,121,3.0,25
1561,861,450,36.037369614512464,37.221587301587306,1.0,23.0,414,1.0,411
1562,861,437,36.037369614512464,38.196825396825396,1.0,23.0,434,2.0,424
1563,861,629,36.037369614512464,37.151927437641724,1.0,3.0,237,1.0,232
1564,861,637,36.037369614512464,38.196825396825396,1.0,9.0,243,2.0,224
1565,861,852,36.037369614512464,38.49868480725624,1.0,-0.0,106,2.0,9
1566,852,437,38.49868480725624,39.59002267573696,-0.0,20.0,418,1.0,415
1567,852,486,38.49868480725624,40.542040816326534,-0.0,24.0,376,2.0,366
1568,852,626,38.49868480725624,39.543582766439904,-0.0,5.0,230,1.0,226
1569,852,661,38.49868480725624,40.05442176870749,-0.0,6.0,202,2.0,191
1570,852,828,38.49868480725624,39.543582766439904,-0.0,2.0,51,1.0,24
1571,852,826,38.49868480725624,40.51882086167801,-0.0,6.0,91,2.0,26
1572,828,492,39.543582766439904,41.958458049886616,2.0,22.0,352,2.0,336
1573,828,497,39.543582766439904,42.44607709750567,2.0,24.0,354,3.0,331
1574,828,627,39.543582766439904,41.65659863945578,2.0,6.0,221,2.0,201
1575,828,827,39.543582766439904,41.935238095238105,2.0,3.0,103,2.0,1
1576,828,824,39.543582766439904,41.98167800453515,2.0,3.0,105,2.0,4
1577,826,327,40.51882086167801,41.98167800453515,6.0,27.0,503,1.0,499
1578,826,492,40.51882086167801,41.958458049886616,6.0,22.0,340,1.0,334
1579,826,497,40.51882086167801,42.44607709750567,6.0,24.0,339,2.0,329
1580,826,627,40.51882086167801,41.65659863945578,6.0,6.0,205,1.0,199
1581,826,626,40.51882086167801,42.91047619047619,6.0,5.0,225,2.0,200
1582,826,827,40.51882086167801,41.935238095238105,6.0,3.0,61,1.0,1
1583,826,824,40.51882086167801,41.98167800453515,6.0,3.0,63,1.0,2
1584,826,847,40.51882086167801,43.49097505668935,6.0,-0.0,130,3.0,21
1585,827,440,41.935238095238105,43.88571428571429,3.0,21.0,396,2.0,387
1586,827,731,41.935238095238105,43.653514739229024,3.0,5.0,121,2.0,96
1587,827,631,41.935238095238105,44.791292517006795,3.0,7.0,231,3.0,196
1588,827,847,41.935238095238105,43.49097505668935,3.0,-0.0,70,2.0,20
1589,827,826,41.935238095238105,43.97859410430839,3.0,3.0,88,2.0,1
1590,824,440,41.98167800453515,43.88571428571429,3.0,21.0,393,2.0,384
1591,824,731,41.98167800453515,43.653514739229024,3.0,5.0,118,2.0,93
1592,824,631,41.98167800453515,44.791292517006795,3.0,7.0,228,3.0,193
1593,824,847,41.98167800453515,43.49097505668935,3.0,-0.0,69,2.0,23
1594,824,826,41.98167800453515,43.97859410430839,3.0,3.0,86,2.0,2
1595,847,432,43.49097505668935,44.977052154195015,-0.0,22.0,420,1.0,415
1596,847,438,43.49097505668935,45.00027210884354,-0.0,23.0,414,2.0,409
1597,847,631,43.49097505668935,44.791292517006795,-0.0,7.0,223,1.0,216
1598,847,626,43.49097505668935,45.30213151927439,-0.0,7.0,234,2.0,221
1599,826,438,43.97859410430839,45.00027210884354,3.0,23.0,390,1.0,388
1600,826,504,43.97859410430839,46.881088435374146,3.0,20.0,345,3.0,322
1601,826,626,43.97859410430839,45.30213151927439,3.0,7.0,208,1.0,200
1602,826,638,43.97859410430839,46.50956916099774,3.0,-0.0,217,3.0,188
1603,850,452,49.15664399092971,50.41052154195012,-0.0,17.0,402,1.0,398
1604,850,499,49.15664399092971,51.13034013605442,-0.0,11.0,361,2.0,351
1605,850,625,49.15664399092971,50.87492063492064,-0.0,6.0,237,2.0,225
1606,850,628,49.15664399092971,51.85015873015873,-0.0,1.0,250,3.0,222
1607,850,832,49.15664399092971,50.41052154195012,-0.0,2.0,57,1.0,18
1608,832,497,50.41052154195012,52.77895691609978,2.0,12.0,350,2.0,335
1609,832,628,50.41052154195012,51.85015873015873,2.0,1.0,213,1.0,204
1610,831,438,55.17061224489796,57.933786848072565,1.0,21.0,411,3.0,393
1611,831,628,55.17061224489796,56.58702947845804,1.0,1.0,212,1.0,203
1612,832,438,56.122630385487525,57.933786848072565,-1.0,21.0,402,2.0,394
1613,832,441,56.122630385487525,58.909024943310655,-1.0,19.0,409,3.0,391
1614,832,627,56.122630385487525,58.49106575963719,-1.0,2.0,229,2.0,205
1615,832,842,56.122630385487525,58.514285714285705,-1.0,-1.0,103,2.0,10
