,f0,f1,t0,t1,dB0,dB1,dist,utime,ufreq
0,77,65,1.5557369614512473,2.972154195011338,13.0,34.0,62,1.0,12
1,77,65,1.5557369614512473,2.995374149659864,13.0,34.0,63,1.0,12
2,77,65,1.5557369614512473,4.179591836734694,13.0,30.0,114,3.0,12
3,77,251,1.5557369614512473,2.972154195011338,13.0,19.0,184,1.0,174
4,77,235,1.5557369614512473,3.2043537414965986,13.0,23.0,173,2.0,158
5,77,251,1.5557369614512473,4.040272108843538,13.0,19.0,204,2.0,174
6,77,465,1.5557369614512473,3.1579138321995464,13.0,6.0,394,2.0,388
7,65,19,2.972154195011338,4.992290249433107,34.0,12.0,98,2.0,46
8,65,251,2.972154195011338,4.040272108843538,34.0,19.0,192,1.0,186
9,65,19,2.995374149659864,4.992290249433107,34.0,12.0,98,2.0,46
10,65,251,2.995374149659864,4.040272108843538,34.0,19.0,191,1.0,186
11,65,197,4.179591836734694,6.664126984126984,30.0,34.0,170,2.0,132
12,65,259,4.179591836734694,6.780226757369615,30.0,35.0,224,3.0,194
13,65,454,4.179591836734694,6.710566893424036,30.0,25.0,404,3.0,389
14,65,420,4.179591836734694,6.989206349206349,30.0,15.0,375,3.0,355
15,19,197,4.992290249433107,6.664126984126984,12.0,34.0,192,2.0,178
16,19,195,4.992290249433107,7.662585034013605,12.0,31.0,210,3.0,176
17,19,259,4.992290249433107,6.780226757369615,12.0,35.0,252,2.0,240
18,19,232,4.992290249433107,7.8251247165532885,12.0,31.0,245,3.0,213
19,19,454,4.992290249433107,6.710566893424036,12.0,25.0,441,2.0,435
20,19,420,4.992290249433107,6.989206349206349,12.0,15.0,410,2.0,401
21,197,194,6.664126984126984,8.17342403628118,34.0,31.0,65,2.0,3
22,197,201,6.664126984126984,8.986122448979591,34.0,22.0,100,2.0,4
23,197,232,6.664126984126984,7.8251247165532885,34.0,31.0,61,1.0,35
24,197,260,6.664126984126984,8.080544217687075,34.0,32.0,88,1.0,63
25,197,231,6.664126984126984,9.009342403628118,34.0,16.0,107,2.0,34
26,197,454,6.664126984126984,8.034104308390022,34.0,9.0,264,1.0,257
27,195,201,7.662585034013605,8.986122448979591,31.0,22.0,57,1.0,6
28,195,77,7.662585034013605,10.565079365079365,31.0,17.0,172,3.0,118
29,195,231,7.662585034013605,9.009342403628118,31.0,16.0,68,1.0,36
30,194,77,8.17342403628118,10.565079365079365,31.0,17.0,156,2.0,117
31,201,77,8.986122448979591,10.565079365079365,22.0,17.0,141,2.0,124
32,201,154,8.986122448979591,11.261678004535147,22.0,13.0,109,2.0,47
33,201,231,8.986122448979591,11.215238095238096,22.0,11.0,101,2.0,30
34,77,190,10.565079365079365,12.120816326530612,17.0,18.0,131,2.0,113
35,77,195,10.565079365079365,13.049614512471656,17.0,22.0,159,2.0,118
36,77,393,10.565079365079365,12.469115646258503,17.0,26.0,326,2.0,316
37,77,428,10.565079365079365,12.469115646258503,17.0,27.0,360,2.0,351
38,154,195,11.261678004535147,13.049614512471656,13.0,22.0,87,2.0,41
39,154,393,11.261678004535147,12.469115646258503,13.0,26.0,245,1.0,239
40,154,389,11.261678004535147,13.862312925170068,13.0,27.0,260,3.0,235
41,154,428,11.261678004535147,12.469115646258503,13.0,27.0,279,1.0,274
42,154,415,11.261678004535147,13.885532879818594,13.0,27.0,284,3.0,261
43,154,626,11.261678004535147,12.469115646258503,13.0,15.0,475,1.0,472
44,154,617,11.261678004535147,13.212154195011339,13.0,15.0,471,2.0,463
45,190,185,12.120816326530612,14.605351473922903,18.0,24.0,107,2.0,5
46,190,389,12.120816326530612,13.862312925170068,18.0,27.0,213,2.0,199
47,190,242,12.120816326530612,14.628571428571428,18.0,27.0,120,3.0,52
48,190,415,12.120816326530612,13.885532879818594,18.0,27.0,237,2.0,225
49,190,457,12.120816326530612,14.582131519274377,18.0,26.0,287,2.0,267
50,190,617,12.120816326530612,13.212154195011339,18.0,15.0,430,1.0,427
51,190,617,12.120816326530612,14.605351473922903,18.0,15.0,440,2.0,427
52,195,185,13.049614512471656,14.605351473922903,22.0,24.0,68,2.0,10
53,195,77,13.049614512471656,15.928888888888888,22.0,20.0,171,3.0,118
54,195,242,13.049614512471656,14.628571428571428,22.0,27.0,83,2.0,47
55,195,389,13.049614512471656,15.975328798185942,22.0,26.0,231,3.0,194
56,195,457,13.049614512471656,14.582131519274377,22.0,26.0,270,2.0,262
57,195,457,13.049614512471656,15.975328798185942,22.0,27.0,291,3.0,262
58,195,617,13.049614512471656,14.605351473922903,22.0,15.0,427,2.0,422
59,195,630,13.049614512471656,15.27873015873016,22.0,15.0,445,2.0,435
60,185,77,14.605351473922903,15.928888888888888,24.0,20.0,122,1.0,108
61,185,152,14.605351473922903,16.973786848072564,24.0,24.0,107,2.0,33
62,185,389,14.605351473922903,15.975328798185942,24.0,26.0,212,1.0,204
63,185,225,14.605351473922903,16.857687074829933,24.0,26.0,105,2.0,40
64,185,457,14.605351473922903,15.975328798185942,24.0,27.0,278,1.0,272
65,185,415,14.605351473922903,16.69514739229025,24.0,26.0,247,2.0,230
66,185,484,14.605351473922903,17.39174603174603,24.0,24.0,322,3.0,299
67,185,630,14.605351473922903,16.69514739229025,24.0,15.0,454,2.0,445
68,185,630,14.605351473922903,17.39174603174603,24.0,12.0,461,3.0,445
69,77,152,15.928888888888888,16.973786848072564,20.0,24.0,87,1.0,75
70,77,195,15.928888888888888,17.972244897959182,20.0,29.0,147,2.0,118
71,77,194,15.928888888888888,18.552743764172337,20.0,30.0,163,3.0,117
72,77,260,15.928888888888888,17.87936507936508,20.0,25.0,201,2.0,183
73,77,259,15.928888888888888,18.018684807256236,20.0,28.0,203,2.0,182
74,77,484,15.928888888888888,17.39174603174603,20.0,24.0,412,1.0,407
75,77,461,15.928888888888888,18.088344671201813,20.0,25.0,395,2.0,384
76,152,194,16.973786848072564,18.552743764172337,24.0,30.0,80,2.0,42
77,152,146,16.973786848072564,19.43510204081633,24.0,24.0,106,2.0,6
78,152,259,16.973786848072564,18.018684807256236,24.0,28.0,116,1.0,107
79,152,291,16.973786848072564,19.319002267573698,24.0,28.0,172,2.0,139
80,152,461,16.973786848072564,18.088344671201813,24.0,25.0,313,1.0,309
81,152,462,16.973786848072564,19.504761904761907,24.0,25.0,329,3.0,310
82,152,617,16.973786848072564,18.808163265306124,24.0,14.0,472,2.0,465
83,152,617,16.973786848072564,19.504761904761907,24.0,12.0,478,3.0,465
84,195,146,17.972244897959182,19.43510204081633,29.0,24.0,80,1.0,49
85,195,291,17.972244897959182,19.319002267573698,29.0,28.0,112,1.0,96
86,195,232,17.972244897959182,20.06204081632653,29.0,27.0,97,2.0,37
87,195,462,17.972244897959182,19.504761904761907,29.0,25.0,275,2.0,267
88,195,461,17.972244897959182,20.89795918367347,29.0,26.0,294,3.0,266
89,195,617,17.972244897959182,19.504761904761907,29.0,12.0,427,2.0,422
90,195,617,17.972244897959182,20.224580498866214,29.0,14.0,433,2.0,422
91,194,195,18.552743764172337,20.712199546485262,30.0,24.0,93,2.0,1
92,194,65,18.552743764172337,21.43201814058957,30.0,21.0,179,3.0,129
93,194,232,18.552743764172337,20.06204081632653,30.0,27.0,75,2.0,38
94,194,461,18.552743764172337,20.89795918367347,30.0,26.0,285,2.0,267
95,194,617,18.552743764172337,20.224580498866214,30.0,14.0,429,2.0,423
96,146,195,19.43510204081633,20.712199546485262,24.0,24.0,74,1.0,49
97,146,65,19.43510204081633,21.43201814058957,24.0,21.0,118,2.0,81
98,146,73,19.43510204081633,22.151836734693877,24.0,22.0,138,3.0,73
99,146,232,19.43510204081633,21.873197278911565,24.0,24.0,136,2.0,86
100,146,292,19.43510204081633,22.151836734693877,24.0,26.0,187,3.0,146
101,146,461,19.43510204081633,20.89795918367347,24.0,26.0,321,1.0,315
102,146,462,19.43510204081633,21.594557823129254,24.0,26.0,329,2.0,316
103,146,415,19.43510204081633,22.31437641723356,24.0,24.0,296,3.0,269
104,146,637,19.43510204081633,21.61777777777778,24.0,13.0,500,2.0,491
105,146,617,19.43510204081633,22.31437641723356,24.0,12.0,487,3.0,471
106,195,73,20.712199546485262,22.151836734693877,24.0,22.0,137,1.0,122
107,195,86,20.712199546485262,23.54503401360544,24.0,27.0,164,3.0,109
108,195,232,20.712199546485262,21.873197278911565,24.0,24.0,62,1.0,37
109,195,292,20.712199546485262,22.151836734693877,24.0,26.0,115,1.0,97
110,195,409,20.712199546485262,23.034195011337868,24.0,24.0,236,2.0,214
111,195,415,20.712199546485262,22.31437641723356,24.0,24.0,231,2.0,220
112,195,462,20.712199546485262,23.010975056689343,24.0,25.0,285,2.0,267
113,195,617,20.712199546485262,22.31437641723356,24.0,12.0,428,2.0,422
114,195,617,20.712199546485262,23.034195011337868,24.0,13.0,434,2.0,422
115,65,86,21.43201814058957,23.54503401360544,21.0,27.0,93,2.0,21
116,65,409,21.43201814058957,23.034195011337868,21.0,24.0,351,2.0,344
117,65,232,21.43201814058957,24.380952380952383,21.0,27.0,210,3.0,167
118,65,462,21.43201814058957,23.010975056689343,21.0,25.0,403,2.0,397
119,65,462,21.43201814058957,24.404172335600908,21.0,25.0,417,3.0,397
120,73,86,22.151836734693877,23.54503401360544,22.0,27.0,61,1.0,13
121,73,86,22.151836734693877,24.938231292517006,22.0,24.0,121,3.0,13
122,73,232,22.151836734693877,24.380952380952383,22.0,27.0,186,2.0,159
123,73,292,22.151836734693877,25.007891156462584,22.0,24.0,251,3.0,219
124,73,462,22.151836734693877,24.404172335600908,22.0,25.0,401,2.0,389
125,73,461,22.151836734693877,25.10077097505669,22.0,25.0,408,3.0,388
126,86,65,23.54503401360544,25.40263038548753,27.0,21.0,83,2.0,21
127,86,204,23.54503401360544,26.51718820861678,27.0,20.0,174,3.0,118
128,86,292,23.54503401360544,25.007891156462584,27.0,24.0,215,1.0,206
129,86,260,23.54503401360544,26.05278911564626,27.0,25.0,205,3.0,174
130,86,461,23.54503401360544,25.10077097505669,27.0,25.0,381,2.0,375
131,86,415,23.54503401360544,26.51718820861678,27.0,26.0,353,3.0,329
132,86,204,24.938231292517006,26.51718820861678,24.0,20.0,136,2.0,118
133,86,152,24.938231292517006,27.654965986394558,24.0,20.0,134,3.0,66
134,86,260,24.938231292517006,26.05278911564626,24.0,25.0,180,1.0,174
135,86,415,24.938231292517006,26.51718820861678,24.0,26.0,336,2.0,329
136,86,461,24.938231292517006,27.213786848072562,24.0,28.0,388,2.0,375
137,65,204,25.40263038548753,26.51718820861678,21.0,20.0,147,1.0,139
138,65,152,25.40263038548753,27.654965986394558,21.0,20.0,130,2.0,87
139,65,72,25.40263038548753,28.305124716553287,21.0,27.0,125,3.0,7
140,65,396,25.40263038548753,27.933605442176873,21.0,25.0,348,3.0,331
141,65,265,25.40263038548753,28.328344671201815,21.0,29.0,236,3.0,200
142,65,415,25.40263038548753,26.51718820861678,21.0,26.0,353,1.0,350
143,65,461,25.40263038548753,27.213786848072562,21.0,28.0,404,2.0,396
144,204,152,26.51718820861678,27.654965986394558,20.0,20.0,71,1.0,52
145,204,72,26.51718820861678,28.305124716553287,20.0,27.0,153,2.0,132
146,204,72,26.51718820861678,29.048163265306123,20.0,23.0,171,3.0,132
147,204,396,26.51718820861678,27.933605442176873,20.0,25.0,201,1.0,192
148,204,265,26.51718820861678,28.328344671201815,20.0,29.0,99,2.0,61
149,204,275,26.51718820861678,29.1178231292517,20.0,27.0,133,3.0,71
150,204,497,26.51718820861678,28.583764172335602,20.0,25.0,306,2.0,293
151,204,415,26.51718820861678,29.326802721088438,20.0,25.0,243,3.0,211
152,204,615,26.51718820861678,28.560544217687074,20.0,12.0,420,2.0,411
153,204,617,26.51718820861678,29.350022675736962,20.0,14.0,431,3.0,413
154,152,72,27.654965986394558,29.048163265306123,20.0,23.0,100,1.0,80
155,152,275,27.654965986394558,29.1178231292517,20.0,27.0,138,1.0,123
156,152,389,27.654965986394558,30.00018140589569,20.0,27.0,258,2.0,237
157,152,415,27.654965986394558,29.326802721088438,20.0,25.0,273,2.0,263
158,152,415,27.654965986394558,30.02340136054422,20.0,27.0,282,2.0,263
159,152,617,27.654965986394558,29.350022675736962,20.0,14.0,471,2.0,465
160,152,617,27.654965986394558,30.046621315192745,20.0,15.0,476,2.0,465
161,72,161,28.305124716553287,30.696780045351474,27.0,20.0,136,2.0,89
162,72,389,28.305124716553287,30.00018140589569,27.0,27.0,325,2.0,317
163,72,415,28.305124716553287,29.326802721088438,27.0,25.0,346,1.0,343
164,72,415,28.305124716553287,30.02340136054422,27.0,27.0,351,2.0,343
165,72,161,29.048163265306123,30.696780045351474,23.0,20.0,114,2.0,89
166,72,174,29.048163265306123,31.74167800453515,23.0,31.0,154,3.0,102
167,72,282,29.048163265306123,31.67201814058957,23.0,32.0,238,3.0,210
168,72,457,29.048163265306123,31.41659863945578,23.0,26.0,398,2.0,385
169,161,174,30.696780045351474,31.74167800453515,20.0,31.0,47,1.0,13
170,161,65,30.696780045351474,32.41505668934241,20.0,26.0,121,2.0,96
171,161,265,30.696780045351474,32.71691609977324,20.0,32.0,136,2.0,104
172,161,415,30.696780045351474,32.13641723356009,20.0,26.0,261,1.0,254
173,161,415,30.696780045351474,33.52961451247165,20.0,25.0,282,3.0,254
174,161,617,30.696780045351474,32.8562358276644,20.0,14.0,465,2.0,456
175,161,630,30.696780045351474,33.52961451247165,20.0,14.0,485,3.0,469
176,174,195,31.74167800453515,33.9243537414966,31.0,35.0,96,2.0,21
177,174,193,31.74167800453515,34.06367346938776,31.0,26.0,102,2.0,19
178,174,244,31.74167800453515,33.94757369614513,31.0,29.0,118,2.0,70
179,174,260,31.74167800453515,34.11011337868481,31.0,33.0,133,2.0,86
180,174,415,31.74167800453515,33.52961451247165,31.0,25.0,253,2.0,241
181,174,460,31.74167800453515,34.50485260770975,31.0,27.0,310,3.0,286
182,174,617,31.74167800453515,32.8562358276644,31.0,14.0,446,1.0,443
183,174,630,31.74167800453515,33.52961451247165,31.0,14.0,462,2.0,456
184,65,195,32.41505668934241,33.9243537414966,26.0,35.0,145,2.0,130
185,65,193,32.41505668934241,34.06367346938776,26.0,26.0,146,2.0,128
186,65,244,32.41505668934241,33.94757369614513,26.0,29.0,191,2.0,179
187,65,260,32.41505668934241,34.11011337868481,26.0,33.0,208,2.0,195
188,65,279,32.41505668934241,35.27111111111111,26.0,27.0,247,3.0,214
189,65,415,32.41505668934241,33.52961451247165,26.0,25.0,353,1.0,350
190,65,460,32.41505668934241,34.50485260770975,26.0,27.0,405,2.0,395
191,195,65,33.9243537414966,35.22467120181406,35.0,27.0,142,1.0,130
192,195,152,33.9243537414966,36.710748299319725,35.0,29.0,127,3.0,43
193,195,279,33.9243537414966,35.27111111111111,35.0,27.0,102,1.0,84
194,195,260,33.9243537414966,36.87328798185941,35.0,33.0,143,3.0,65
195,195,415,33.9243537414966,35.64263038548753,35.0,25.0,232,2.0,220
196,195,415,33.9243537414966,36.339229024943315,35.0,26.0,243,2.0,220
197,195,617,33.9243537414966,34.969251700680275,35.0,14.0,424,1.0,422
198,195,617,33.9243537414966,35.66585034013605,35.0,15.0,429,2.0,422
199,195,617,33.9243537414966,36.36244897959184,35.0,15.0,435,2.0,422
200,193,65,34.06367346938776,35.22467120181406,26.0,27.0,137,1.0,128
201,193,152,34.06367346938776,36.710748299319725,26.0,29.0,121,3.0,41
202,193,279,34.06367346938776,35.27111111111111,26.0,27.0,100,1.0,86
203,193,260,34.06367346938776,36.87328798185941,26.0,33.0,138,3.0,67
204,193,415,34.06367346938776,35.64263038548753,26.0,25.0,232,2.0,222
205,193,415,34.06367346938776,36.339229024943315,26.0,26.0,243,2.0,222
206,193,617,34.06367346938776,35.66585034013605,26.0,15.0,430,2.0,424
207,193,617,34.06367346938776,36.36244897959184,26.0,15.0,435,2.0,424
208,65,152,35.22467120181406,36.710748299319725,27.0,29.0,108,1.0,87
209,65,192,35.22467120181406,37.105487528344675,27.0,27.0,151,2.0,127
210,65,260,35.22467120181406,36.87328798185941,27.0,33.0,208,2.0,195
211,65,249,35.22467120181406,37.05904761904762,27.0,27.0,200,2.0,184
212,65,415,35.22467120181406,36.339229024943315,27.0,26.0,353,1.0,350
213,65,488,35.22467120181406,37.73242630385488,27.0,25.0,437,3.0,423
214,152,161,36.710748299319725,38.42902494331066,29.0,20.0,75,2.0,9
215,152,120,36.710748299319725,39.566802721088436,29.0,20.0,127,3.0,32
216,152,389,36.710748299319725,38.42902494331066,29.0,27.0,248,2.0,237
217,152,291,36.710748299319725,39.59002267573696,29.0,31.0,186,3.0,139
218,152,488,36.710748299319725,37.73242630385488,29.0,25.0,339,1.0,336
219,152,461,36.710748299319725,38.42902494331066,29.0,26.0,318,2.0,309
220,152,461,36.710748299319725,39.125623582766444,29.0,27.0,326,2.0,309
221,152,617,36.710748299319725,38.47546485260771,29.0,13.0,471,2.0,465
222,152,617,36.710748299319725,39.172063492063494,29.0,15.0,477,2.0,465
223,192,161,37.105487528344675,38.42902494331066,27.0,20.0,65,1.0,31
224,192,120,37.105487528344675,39.566802721088436,27.0,20.0,128,2.0,72
225,192,43,37.105487528344675,40.00798185941043,27.0,17.0,194,3.0,149
226,192,389,37.105487528344675,38.42902494331066,27.0,27.0,205,1.0,197
227,192,291,37.105487528344675,39.59002267573696,27.0,31.0,146,2.0,99
228,192,461,37.105487528344675,38.42902494331066,27.0,26.0,275,1.0,269
229,192,461,37.105487528344675,39.125623582766444,27.0,27.0,283,2.0,269
230,192,617,37.105487528344675,38.47546485260771,27.0,13.0,429,1.0,425
231,192,617,37.105487528344675,39.172063492063494,27.0,15.0,434,2.0,425
232,161,120,38.42902494331066,39.566802721088436,20.0,20.0,64,1.0,41
233,161,43,38.42902494331066,40.00798185941043,20.0,17.0,136,2.0,118
234,161,170,38.42902494331066,41.23863945578231,20.0,20.0,121,3.0,9
235,161,291,38.42902494331066,39.59002267573696,20.0,31.0,139,1.0,130
236,161,270,38.42902494331066,40.30984126984127,20.0,31.0,136,2.0,109
237,161,389,38.42902494331066,41.23863945578231,20.0,26.0,258,3.0,228
238,161,465,38.42902494331066,40.170521541950116,20.0,26.0,313,2.0,304
239,161,630,38.42902494331066,40.542040816326534,20.0,15.0,478,2.0,469
240,161,625,38.42902494331066,41.26185941043084,20.0,15.0,480,3.0,464
241,120,170,39.566802721088436,41.23863945578231,20.0,20.0,88,2.0,50
242,120,197,39.566802721088436,42.32997732426304,20.0,32.0,142,3.0,77
243,120,389,39.566802721088436,41.23863945578231,20.0,26.0,278,2.0,269
244,120,244,39.566802721088436,42.399637188208615,20.0,38.0,174,3.0,124
245,120,461,39.566802721088436,41.9352380952381,20.0,26.0,356,2.0,341
246,43,170,40.00798185941043,41.23863945578231,17.0,20.0,138,1.0,127
247,43,197,40.00798185941043,42.32997732426304,17.0,32.0,184,2.0,154
248,43,389,40.00798185941043,41.23863945578231,17.0,26.0,350,1.0,346
249,43,244,40.00798185941043,42.399637188208615,17.0,38.0,226,2.0,201
250,43,461,40.00798185941043,41.9352380952381,17.0,26.0,426,2.0,418
251,43,415,40.00798185941043,42.6550566893424,17.0,26.0,389,3.0,372
252,170,197,41.23863945578231,42.32997732426304,20.0,32.0,54,1.0,27
253,170,144,41.23863945578231,43.932154195011336,20.0,27.0,119,3.0,26
254,170,244,41.23863945578231,42.399637188208615,20.0,38.0,89,1.0,74
255,170,265,41.23863945578231,43.932154195011336,20.0,30.0,150,3.0,95
256,170,415,41.23863945578231,42.6550566893424,20.0,26.0,252,1.0,245
257,170,464,41.23863945578231,43.83927437641724,20.0,28.0,315,3.0,294
258,170,617,41.23863945578231,42.678276643990934,20.0,16.0,451,1.0,447
259,170,618,41.23863945578231,43.32843537414966,20.0,16.0,457,2.0,448
260,197,144,42.32997732426304,43.932154195011336,32.0,27.0,87,2.0,53
261,197,152,42.32997732426304,44.72163265306123,32.0,20.0,112,2.0,45
262,197,265,42.32997732426304,43.932154195011336,32.0,30.0,97,2.0,68
263,197,256,42.32997732426304,44.35011337868481,32.0,29.0,105,2.0,59
264,197,464,42.32997732426304,43.83927437641724,32.0,28.0,275,2.0,267
265,197,461,42.32997732426304,44.74485260770975,32.0,26.0,284,2.0,264
266,197,618,42.32997732426304,44.74485260770975,32.0,15.0,434,2.0,421
267,144,194,43.932154195011336,45.7665306122449,27.0,28.0,93,2.0,50
268,144,147,43.932154195011336,46.69532879818594,27.0,26.0,119,3.0,3
269,144,217,43.932154195011336,45.72009070294785,27.0,31.0,106,2.0,73
270,144,389,43.932154195011336,46.13804988662132,27.0,26.0,263,2.0,245
271,144,461,43.932154195011336,45.44145124716553,27.0,25.0,324,2.0,317
272,144,457,43.932154195011336,46.16126984126984,27.0,28.0,327,2.0,313
273,144,617,43.932154195011336,45.48789115646259,27.0,13.0,478,2.0,473
274,144,617,43.932154195011336,46.18448979591837,27.0,14.0,483,2.0,473
275,152,194,44.72163265306123,45.7665306122449,20.0,28.0,62,1.0,42
276,152,147,44.72163265306123,46.69532879818594,20.0,26.0,85,2.0,5
277,152,389,44.72163265306123,46.13804988662132,20.0,26.0,245,1.0,237
278,152,292,44.72163265306123,47.18294784580499,20.0,33.0,176,2.0,140
279,152,457,44.72163265306123,46.16126984126984,20.0,28.0,311,1.0,305
280,152,452,44.72163265306123,47.18294784580499,20.0,27.0,318,2.0,300
281,152,617,44.72163265306123,46.18448979591837,20.0,14.0,469,1.0,465
282,152,625,44.72163265306123,47.57768707482993,20.0,15.0,489,3.0,473
283,194,171,45.7665306122449,47.94920634920635,28.0,33.0,97,2.0,23
284,194,174,45.7665306122449,48.01886621315193,28.0,32.0,99,2.0,20
285,194,292,45.7665306122449,47.18294784580499,28.0,33.0,115,1.0,98
286,194,260,45.7665306122449,48.18140589569161,28.0,35.0,123,2.0,66
287,194,452,45.7665306122449,47.18294784580499,28.0,27.0,265,1.0,258
288,194,625,45.7665306122449,47.57768707482993,28.0,15.0,438,2.0,431
289,147,171,46.69532879818594,47.94920634920635,26.0,33.0,59,1.0,24
290,147,174,46.69532879818594,48.01886621315193,26.0,32.0,63,1.0,27
291,147,170,46.69532879818594,49.64426303854875,26.0,17.0,129,3.0,23
292,147,260,46.69532879818594,48.18140589569161,26.0,35.0,130,1.0,113
293,147,389,46.69532879818594,49.64426303854875,26.0,27.0,273,3.0,242
294,147,415,46.69532879818594,48.970884353741496,26.0,26.0,285,2.0,268
295,147,427,46.69532879818594,49.66748299319728,26.0,25.0,308,3.0,280
296,147,630,46.69532879818594,48.970884353741496,26.0,13.0,493,2.0,483
297,147,617,46.69532879818594,48.99410430839002,26.0,14.0,480,2.0,470
298,171,170,47.94920634920635,49.64426303854875,33.0,17.0,73,2.0,1
299,171,86,47.94920634920635,50.549841269841274,33.0,24.0,141,3.0,85
300,171,389,47.94920634920635,49.64426303854875,33.0,27.0,230,2.0,218
301,171,389,47.94920634920635,50.36408163265306,33.0,26.0,242,2.0,218
302,171,415,47.94920634920635,48.970884353741496,33.0,26.0,248,1.0,244
303,171,427,47.94920634920635,49.66748299319728,33.0,25.0,266,2.0,256
304,171,488,47.94920634920635,50.36408163265306,33.0,26.0,334,2.0,317
305,171,630,47.94920634920635,48.970884353741496,33.0,13.0,461,1.0,459
306,171,617,47.94920634920635,48.99410430839002,33.0,14.0,448,1.0,446
307,171,617,47.94920634920635,50.387301587301586,33.0,14.0,458,2.0,446
308,174,170,48.01886621315193,49.64426303854875,32.0,17.0,70,2.0,4
309,174,86,48.01886621315193,50.549841269841274,32.0,24.0,140,3.0,88
310,174,389,48.01886621315193,49.64426303854875,32.0,27.0,226,2.0,215
311,174,389,48.01886621315193,50.36408163265306,32.0,26.0,238,2.0,215
312,174,427,48.01886621315193,49.66748299319728,32.0,25.0,263,2.0,253
313,174,488,48.01886621315193,50.36408163265306,32.0,26.0,330,2.0,314
314,174,617,48.01886621315193,50.387301587301586,32.0,14.0,455,2.0,443
315,170,194,49.64426303854875,51.85015873015873,17.0,25.0,98,2.0,24
316,170,203,49.64426303854875,52.198458049886625,17.0,32.0,115,3.0,33
317,170,276,49.64426303854875,51.38575963718821,17.0,25.0,130,2.0,106
318,170,225,49.64426303854875,52.38421768707483,17.0,35.0,130,3.0,55
319,170,482,49.64426303854875,51.68761904761905,17.0,26.0,324,2.0,312
320,170,484,49.64426303854875,52.47709750566894,17.0,26.0,337,3.0,314
321,170,615,49.64426303854875,51.66439909297052,17.0,16.0,453,2.0,445
322,170,617,49.64426303854875,52.50031746031746,17.0,14.0,464,3.0,447
323,86,194,50.549841269841274,51.85015873015873,24.0,25.0,122,1.0,108
324,86,203,50.549841269841274,52.198458049886625,24.0,32.0,137,2.0,117
325,86,171,50.549841269841274,53.080816326530616,24.0,30.0,138,3.0,85
326,86,225,50.549841269841274,52.38421768707483,24.0,35.0,160,2.0,139
327,86,482,50.549841269841274,51.68761904761905,24.0,26.0,399,1.0,396
328,86,484,50.549841269841274,52.47709750566894,24.0,26.0,407,2.0,398
329,194,171,51.85015873015873,53.080816326530616,25.0,30.0,58,1.0,23
330,194,261,51.85015873015873,53.84707482993198,25.0,33.0,109,2.0,67
331,194,230,51.85015873015873,53.98639455782313,25.0,29.0,99,2.0,36
332,194,485,51.85015873015873,53.68453514739229,25.0,27.0,302,2.0,291
333,194,415,51.85015873015873,54.590113378684805,25.0,25.0,251,3.0,221
334,194,617,51.85015873015873,53.19691609977324,25.0,13.0,427,1.0,423
335,194,618,51.85015873015873,54.56689342403628,25.0,13.0,440,3.0,424
336,203,194,52.198458049886625,53.98639455782313,32.0,24.0,78,2.0,9
337,203,261,52.198458049886625,53.84707482993198,32.0,33.0,92,2.0,58
338,203,230,52.198458049886625,53.98639455782313,32.0,29.0,82,2.0,27
339,203,286,52.198458049886625,54.984852607709755,32.0,31.0,146,3.0,83
340,203,485,52.198458049886625,53.68453514739229,32.0,27.0,289,1.0,282
341,203,415,52.198458049886625,54.590113378684805,32.0,25.0,236,2.0,212
342,203,618,52.198458049886625,54.56689342403628,32.0,13.0,427,2.0,415
343,171,65,53.080816326530616,55.472471655328796,30.0,28.0,148,2.0,106
344,171,286,53.080816326530616,54.984852607709755,30.0,31.0,141,2.0,115
345,171,415,53.080816326530616,54.590113378684805,30.0,25.0,253,2.0,244
346,171,491,53.080816326530616,55.797551020408164,30.0,25.0,341,3.0,320
347,171,618,53.080816326530616,54.56689342403628,30.0,13.0,452,1.0,447
348,171,637,53.080816326530616,55.309931972789116,30.0,12.0,476,2.0,466
349,171,617,53.080816326530616,56.0065306122449,30.0,13.0,463,3.0,446
350,194,65,53.98639455782313,55.472471655328796,24.0,28.0,144,1.0,129
351,194,196,53.98639455782313,56.65668934240363,24.0,31.0,115,3.0,2
352,194,228,53.98639455782313,56.65668934240363,24.0,34.0,120,3.0,34
353,194,491,53.98639455782313,55.797551020408164,24.0,25.0,307,2.0,297
354,194,422,53.98639455782313,56.401269841269844,24.0,26.0,251,2.0,228
355,194,637,53.98639455782313,55.309931972789116,24.0,12.0,447,1.0,443
356,194,617,53.98639455782313,56.0065306122449,24.0,13.0,432,2.0,423
357,65,196,55.472471655328796,56.65668934240363,28.0,31.0,141,1.0,131
358,65,197,55.472471655328796,57.95700680272109,28.0,29.0,170,2.0,132
359,65,194,55.472471655328796,58.30530612244898,28.0,31.0,178,3.0,129
360,65,228,55.472471655328796,56.65668934240363,28.0,34.0,171,1.0,163
361,65,258,55.472471655328796,57.95700680272109,28.0,30.0,221,2.0,193
362,65,258,55.472471655328796,57.980226757369614,28.0,37.0,221,3.0,193
363,65,488,55.472471655328796,57.376507936507934,28.0,25.0,431,2.0,423
364,65,420,55.472471655328796,58.00344671201814,28.0,24.0,371,3.0,355
365,196,197,56.65668934240363,57.95700680272109,31.0,29.0,56,1.0,1
366,196,194,56.65668934240363,58.30530612244898,31.0,31.0,71,2.0,2
367,196,65,56.65668934240363,59.48952380952381,31.0,27.0,179,3.0,131
368,196,258,56.65668934240363,57.95700680272109,31.0,30.0,84,1.0,62
369,196,258,56.65668934240363,57.980226757369614,31.0,37.0,84,1.0,62
370,196,231,56.65668934240363,59.2108843537415,31.0,40.0,115,3.0,35
371,196,420,56.65668934240363,58.00344671201814,31.0,24.0,231,1.0,224
372,196,541,56.65668934240363,59.512743764172335,31.0,23.0,366,3.0,345
373,196,617,56.65668934240363,58.11954648526077,31.0,13.0,426,1.0,421
374,196,625,56.65668934240363,59.512743764172335,31.0,11.0,446,3.0,429
375,197,65,57.95700680272109,59.48952380952381,29.0,27.0,148,2.0,132
376,197,231,57.95700680272109,59.2108843537415,29.0,40.0,64,1.0,34
377,197,541,57.95700680272109,59.512743764172335,29.0,23.0,350,2.0,344
378,197,625,57.95700680272109,59.512743764172335,29.0,11.0,433,2.0,428
379,194,65,58.30530612244898,59.48952380952381,31.0,27.0,139,1.0,129
380,194,541,58.30530612244898,59.512743764172335,31.0,23.0,351,1.0,347
381,194,625,58.30530612244898,59.512743764172335,31.0,11.0,434,1.0,431
382,231,65,1.3003174603174603,2.972154195011338,12.0,34.0,181,2.0,166
383,231,65,1.3003174603174603,2.995374149659864,12.0,34.0,181,2.0,166
384,231,65,1.3003174603174603,4.179591836734694,12.0,30.0,207,3.0,166
385,231,251,1.3003174603174603,2.972154195011338,12.0,19.0,75,2.0,20
386,231,235,1.3003174603174603,3.2043537414965986,12.0,23.0,82,2.0,4
387,231,251,1.3003174603174603,4.040272108843538,12.0,19.0,120,3.0,20
388,231,465,1.3003174603174603,3.1579138321995464,12.0,6.0,247,2.0,234
389,251,65,2.972154195011338,4.179591836734694,19.0,30.0,193,1.0,186
390,251,19,2.972154195011338,4.992290249433107,19.0,12.0,248,2.0,232
391,235,19,3.2043537414965986,4.992290249433107,23.0,12.0,229,2.0,216
392,251,197,4.040272108843538,6.664126984126984,19.0,34.0,125,3.0,54
393,251,259,4.040272108843538,6.780226757369615,19.0,35.0,118,3.0,8
394,251,454,4.040272108843538,6.710566893424036,19.0,25.0,233,3.0,203
395,251,420,4.040272108843538,6.989206349206349,19.0,15.0,211,3.0,169
396,251,618,4.040272108843538,6.664126984126984,19.0,5.0,384,3.0,367
397,259,194,6.780226757369615,8.17342403628118,35.0,31.0,88,1.0,65
398,259,201,6.780226757369615,8.986122448979591,35.0,22.0,111,2.0,58
399,259,232,6.780226757369615,7.8251247165532885,35.0,31.0,52,1.0,27
400,259,260,6.780226757369615,8.080544217687075,35.0,32.0,56,1.0,1
401,259,231,6.780226757369615,9.009342403628118,35.0,16.0,100,2.0,28
402,259,454,6.780226757369615,8.034104308390022,35.0,9.0,202,1.0,195
403,232,201,7.8251247165532885,8.986122448979591,31.0,22.0,59,1.0,31
404,232,77,7.8251247165532885,10.565079365079365,31.0,17.0,195,3.0,155
405,232,231,7.8251247165532885,9.009342403628118,31.0,16.0,51,1.0,1
406,260,77,8.080544217687075,10.565079365079365,32.0,17.0,212,2.0,183
407,231,77,9.009342403628118,10.565079365079365,16.0,17.0,168,2.0,154
408,231,154,9.009342403628118,11.261678004535147,16.0,13.0,124,2.0,77
409,231,195,11.215238095238096,13.049614512471656,11.0,22.0,87,2.0,36
410,231,393,11.215238095238096,12.469115646258503,11.0,26.0,171,1.0,162
411,231,389,11.215238095238096,13.862312925170068,11.0,27.0,195,3.0,158
412,231,428,11.215238095238096,12.469115646258503,11.0,27.0,204,1.0,197
413,231,415,11.215238095238096,13.885532879818594,11.0,27.0,217,3.0,184
414,231,626,11.215238095238096,12.469115646258503,11.0,15.0,399,1.0,395
415,231,617,11.215238095238096,13.212154195011339,11.0,15.0,395,2.0,386
416,393,185,12.469115646258503,14.605351473922903,26.0,24.0,227,2.0,208
417,393,389,12.469115646258503,13.862312925170068,26.0,27.0,60,1.0,4
418,393,242,12.469115646258503,14.628571428571428,26.0,27.0,177,2.0,151
419,393,415,12.469115646258503,13.885532879818594,26.0,27.0,65,1.0,22
420,393,457,12.469115646258503,14.582131519274377,26.0,26.0,111,2.0,64
421,393,617,12.469115646258503,14.605351473922903,26.0,15.0,242,2.0,224
422,393,630,12.469115646258503,15.27873015873016,26.0,15.0,266,3.0,237
423,393,856,12.469115646258503,13.862312925170068,26.0,6.0,467,1.0,463
424,389,77,13.862312925170068,15.928888888888888,27.0,20.0,324,2.0,312
425,389,457,13.862312925170068,15.975328798185942,27.0,27.0,114,2.0,68
426,389,415,13.862312925170068,16.69514739229025,27.0,26.0,125,3.0,26
427,389,630,13.862312925170068,15.27873015873016,27.0,15.0,249,1.0,241
428,389,630,13.862312925170068,16.69514739229025,27.0,15.0,270,3.0,241
429,242,77,14.628571428571428,15.928888888888888,27.0,20.0,174,1.0,165
430,242,152,14.628571428571428,16.973786848072564,27.0,24.0,135,2.0,90
431,242,389,14.628571428571428,15.975328798185942,27.0,26.0,158,1.0,147
432,242,225,14.628571428571428,16.857687074829933,27.0,26.0,97,2.0,17
433,242,457,14.628571428571428,15.975328798185942,27.0,27.0,223,1.0,215
434,242,415,14.628571428571428,16.69514739229025,27.0,26.0,195,2.0,173
435,242,484,14.628571428571428,17.39174603174603,27.0,24.0,270,3.0,242
436,242,630,14.628571428571428,16.69514739229025,27.0,15.0,398,2.0,388
437,242,630,14.628571428571428,17.39174603174603,27.0,12.0,406,3.0,388
438,389,195,15.975328798185942,17.972244897959182,26.0,29.0,212,2.0,194
439,389,194,15.975328798185942,18.552743764172337,26.0,30.0,224,3.0,195
440,389,260,15.975328798185942,17.87936507936508,26.0,25.0,153,2.0,129
441,389,259,15.975328798185942,18.018684807256236,26.0,28.0,157,2.0,130
442,389,484,15.975328798185942,17.39174603174603,26.0,24.0,113,1.0,95
443,389,461,15.975328798185942,18.088344671201813,26.0,25.0,116,2.0,72
444,389,630,15.975328798185942,17.39174603174603,26.0,12.0,249,1.0,241
445,389,617,15.975328798185942,18.808163265306124,26.0,14.0,259,3.0,228
446,225,195,16.857687074829933,17.972244897959182,26.0,29.0,57,1.0,30
447,225,194,16.857687074829933,18.552743764172337,26.0,30.0,79,2.0,31
448,225,146,16.857687074829933,19.43510204081633,26.0,24.0,136,3.0,79
449,225,260,16.857687074829933,17.87936507936508,26.0,25.0,56,1.0,35
450,225,259,16.857687074829933,18.018684807256236,26.0,28.0,60,1.0,34
451,225,291,16.857687074829933,19.319002267573698,26.0,28.0,125,2.0,66
452,225,461,16.857687074829933,18.088344671201813,26.0,25.0,242,1.0,236
453,225,462,16.857687074829933,19.504761904761907,26.0,25.0,263,3.0,237
454,225,617,16.857687074829933,18.808163265306124,26.0,14.0,401,2.0,392
455,225,617,16.857687074829933,19.504761904761907,26.0,12.0,408,3.0,392
456,260,146,17.87936507936508,19.43510204081633,25.0,24.0,132,2.0,114
457,260,195,17.87936507936508,20.712199546485262,25.0,24.0,138,3.0,65
458,260,291,17.87936507936508,19.319002267573698,25.0,28.0,69,1.0,31
459,260,232,17.87936507936508,20.06204081632653,25.0,27.0,98,2.0,28
460,260,462,17.87936507936508,19.504761904761907,25.0,25.0,214,2.0,202
461,260,617,17.87936507936508,19.504761904761907,25.0,12.0,364,2.0,357
462,260,617,17.87936507936508,20.224580498866214,25.0,14.0,371,2.0,357
463,259,146,18.018684807256236,19.43510204081633,28.0,24.0,128,1.0,113
464,259,195,18.018684807256236,20.712199546485262,28.0,24.0,132,3.0,64
465,259,291,18.018684807256236,19.319002267573698,28.0,28.0,64,1.0,32
466,259,232,18.018684807256236,20.06204081632653,28.0,27.0,92,2.0,27
467,259,462,18.018684807256236,19.504761904761907,28.0,25.0,213,1.0,203
468,259,461,18.018684807256236,20.89795918367347,28.0,26.0,237,3.0,202
469,259,617,18.018684807256236,19.504761904761907,28.0,12.0,364,1.0,358
470,259,617,18.018684807256236,20.224580498866214,28.0,14.0,370,2.0,358
471,291,195,19.319002267573698,20.712199546485262,28.0,24.0,113,1.0,96
472,291,65,19.319002267573698,21.43201814058957,28.0,21.0,244,2.0,226
473,291,73,19.319002267573698,22.151836734693877,28.0,22.0,250,3.0,218
474,291,232,19.319002267573698,21.873197278911565,28.0,24.0,125,3.0,59
475,291,292,19.319002267573698,22.151836734693877,28.0,26.0,122,3.0,1
476,291,461,19.319002267573698,20.89795918367347,28.0,26.0,183,2.0,170
477,291,462,19.319002267573698,21.594557823129254,28.0,26.0,197,2.0,171
478,291,637,19.319002267573698,21.61777777777778,28.0,13.0,360,2.0,346
479,232,65,20.06204081632653,21.43201814058957,27.0,21.0,177,1.0,167
480,232,73,20.06204081632653,22.151836734693877,27.0,22.0,183,2.0,159
481,232,292,20.06204081632653,22.151836734693877,27.0,26.0,108,2.0,60
482,232,409,20.06204081632653,23.034195011337868,27.0,24.0,218,3.0,177
483,232,462,20.06204081632653,21.594557823129254,27.0,26.0,239,2.0,230
484,232,415,20.06204081632653,22.31437641723356,27.0,24.0,207,2.0,183
485,232,462,20.06204081632653,23.010975056689343,27.0,25.0,263,3.0,230
486,232,637,20.06204081632653,21.61777777777778,27.0,13.0,411,2.0,405
487,232,617,20.06204081632653,22.31437641723356,27.0,12.0,397,2.0,385
488,232,617,20.06204081632653,23.034195011337868,27.0,13.0,406,3.0,385
489,232,86,21.873197278911565,23.54503401360544,24.0,27.0,163,2.0,146
490,232,409,21.873197278911565,23.034195011337868,24.0,24.0,184,1.0,177
491,232,462,21.873197278911565,23.010975056689343,24.0,25.0,235,1.0,230
492,232,462,21.873197278911565,24.404172335600908,24.0,25.0,255,3.0,230
493,232,617,21.873197278911565,23.034195011337868,24.0,13.0,388,1.0,385
494,232,617,21.873197278911565,24.427392290249433,24.0,12.0,400,3.0,385
495,292,86,22.151836734693877,23.54503401360544,26.0,27.0,215,1.0,206
496,292,86,22.151836734693877,24.938231292517006,26.0,24.0,238,3.0,206
497,292,232,22.151836734693877,24.380952380952383,26.0,27.0,113,2.0,60
498,292,462,22.151836734693877,24.404172335600908,26.0,25.0,196,2.0,170
499,292,461,22.151836734693877,25.10077097505669,26.0,25.0,211,3.0,169
500,292,617,22.151836734693877,24.427392290249433,26.0,12.0,339,2.0,325
501,292,617,22.151836734693877,25.123990929705215,26.0,14.0,349,3.0,325
502,409,86,23.034195011337868,24.938231292517006,24.0,24.0,333,2.0,323
503,409,65,23.034195011337868,25.40263038548753,24.0,21.0,359,2.0,344
504,409,232,23.034195011337868,24.380952380952383,24.0,27.0,186,1.0,177
505,409,292,23.034195011337868,25.007891156462584,24.0,24.0,145,2.0,117
506,409,462,23.034195011337868,24.404172335600908,24.0,25.0,79,1.0,53
507,409,461,23.034195011337868,25.10077097505669,24.0,25.0,103,2.0,52
508,409,617,23.034195011337868,24.427392290249433,24.0,12.0,216,1.0,208
509,409,617,23.034195011337868,25.123990929705215,24.0,14.0,227,2.0,208
510,232,65,24.380952380952383,25.40263038548753,27.0,21.0,173,1.0,167
511,232,204,24.380952380952383,26.51718820861678,27.0,20.0,96,2.0,28
512,232,260,24.380952380952383,26.05278911564626,27.0,25.0,77,2.0,28
513,232,415,24.380952380952383,26.51718820861678,27.0,26.0,205,2.0,183
514,232,461,24.380952380952383,27.213786848072562,27.0,28.0,259,3.0,229
515,232,617,24.380952380952383,26.51718820861678,27.0,14.0,396,2.0,385
516,232,617,24.380952380952383,27.23700680272109,27.0,16.0,404,3.0,385
517,292,204,25.007891156462584,26.51718820861678,24.0,20.0,109,2.0,88
518,292,152,25.007891156462584,27.654965986394558,24.0,20.0,181,3.0,140
519,292,260,25.007891156462584,26.05278911564626,24.0,25.0,55,1.0,32
520,292,396,25.007891156462584,27.933605442176873,24.0,25.0,163,3.0,104
521,292,415,25.007891156462584,26.51718820861678,24.0,26.0,139,2.0,123
522,292,461,25.007891156462584,27.213786848072562,24.0,28.0,194,2.0,169
523,292,617,25.007891156462584,26.51718820861678,24.0,14.0,331,2.0,325
524,292,617,25.007891156462584,27.23700680272109,24.0,16.0,339,2.0,325
525,260,152,26.05278911564626,27.654965986394558,25.0,20.0,128,2.0,108
526,260,72,26.05278911564626,28.305124716553287,25.0,27.0,212,2.0,188
527,260,396,26.05278911564626,27.933605442176873,25.0,25.0,158,2.0,136
528,260,265,26.05278911564626,28.328344671201815,25.0,29.0,98,2.0,5
529,260,461,26.05278911564626,27.213786848072562,25.0,28.0,207,1.0,201
530,260,497,26.05278911564626,28.583764172335602,25.0,25.0,261,3.0,237
531,260,617,26.05278911564626,27.23700680272109,25.0,16.0,361,1.0,357
532,260,615,26.05278911564626,28.560544217687074,25.0,12.0,371,3.0,355
533,396,72,27.933605442176873,29.048163265306123,25.0,23.0,328,1.0,324
534,396,161,27.933605442176873,30.696780045351474,25.0,20.0,263,3.0,235
535,396,275,27.933605442176873,29.1178231292517,25.0,27.0,131,1.0,121
536,396,389,27.933605442176873,30.00018140589569,25.0,27.0,89,2.0,7
537,396,415,27.933605442176873,29.326802721088438,25.0,25.0,63,1.0,19
538,396,415,27.933605442176873,30.02340136054422,25.0,27.0,92,2.0,19
539,396,617,27.933605442176873,29.350022675736962,25.0,14.0,229,1.0,221
540,396,617,27.933605442176873,30.046621315192745,25.0,15.0,239,2.0,221
541,396,856,27.933605442176873,30.00018140589569,25.0,6.0,469,2.0,460
542,265,161,28.328344671201815,30.696780045351474,29.0,20.0,146,2.0,104
543,265,389,28.328344671201815,30.00018140589569,29.0,27.0,143,2.0,124
544,265,415,28.328344671201815,30.02340136054422,29.0,27.0,167,2.0,150
545,265,617,28.328344671201815,29.350022675736962,29.0,14.0,355,1.0,352
546,265,617,28.328344671201815,30.046621315192745,29.0,15.0,360,2.0,352
547,275,161,29.1178231292517,30.696780045351474,27.0,20.0,133,2.0,114
548,275,174,29.1178231292517,31.74167800453515,27.0,31.0,152,3.0,101
549,275,282,29.1178231292517,31.67201814058957,27.0,32.0,110,3.0,7
550,275,457,29.1178231292517,31.41659863945578,27.0,26.0,207,2.0,182
551,275,630,29.1178231292517,31.41659863945578,27.0,14.0,369,2.0,355
552,389,174,30.00018140589569,31.74167800453515,27.0,31.0,228,2.0,215
553,389,65,30.00018140589569,32.41505668934241,27.0,26.0,340,2.0,324
554,389,282,30.00018140589569,31.67201814058957,27.0,32.0,129,2.0,107
555,389,265,30.00018140589569,32.71691609977324,27.0,32.0,170,3.0,124
556,389,457,30.00018140589569,31.41659863945578,27.0,26.0,91,1.0,68
557,389,415,30.00018140589569,32.13641723356009,27.0,26.0,96,2.0,26
558,389,630,30.00018140589569,31.41659863945578,27.0,14.0,249,1.0,241
559,389,617,30.00018140589569,32.8562358276644,27.0,14.0,259,3.0,228
560,389,852,30.00018140589569,32.08997732426304,27.0,6.0,472,2.0,463
561,282,195,31.67201814058957,33.9243537414966,32.0,35.0,130,2.0,87
562,282,193,31.67201814058957,34.06367346938776,32.0,26.0,136,2.0,89
563,282,265,31.67201814058957,32.71691609977324,32.0,32.0,48,1.0,17
564,282,244,31.67201814058957,33.94757369614513,32.0,29.0,105,2.0,38
565,282,260,31.67201814058957,34.11011337868481,32.0,33.0,107,2.0,22
566,282,415,31.67201814058957,33.52961451247165,32.0,25.0,155,2.0,133
567,282,460,31.67201814058957,34.50485260770975,32.0,27.0,216,3.0,178
568,282,617,31.67201814058957,32.8562358276644,32.0,14.0,339,1.0,335
569,282,630,31.67201814058957,33.52961451247165,32.0,14.0,357,2.0,348
570,265,195,32.71691609977324,33.9243537414966,32.0,35.0,87,1.0,70
571,265,193,32.71691609977324,34.06367346938776,32.0,26.0,92,1.0,72
572,265,65,32.71691609977324,35.22467120181406,32.0,27.0,227,3.0,200
573,265,244,32.71691609977324,33.94757369614513,32.0,29.0,57,1.0,21
574,265,260,32.71691609977324,34.11011337868481,32.0,33.0,60,1.0,5
575,265,279,32.71691609977324,35.27111111111111,32.0,27.0,111,3.0,14
576,265,460,32.71691609977324,34.50485260770975,32.0,27.0,210,2.0,195
577,265,415,32.71691609977324,35.64263038548753,32.0,25.0,196,3.0,150
578,265,617,32.71691609977324,34.969251700680275,32.0,14.0,365,2.0,352
579,265,617,32.71691609977324,35.66585034013605,32.0,15.0,374,3.0,352
580,244,65,33.94757369614513,35.22467120181406,29.0,27.0,187,1.0,179
581,244,152,33.94757369614513,36.710748299319725,29.0,29.0,150,3.0,92
582,244,279,33.94757369614513,35.27111111111111,29.0,27.0,67,1.0,35
583,244,260,33.94757369614513,36.87328798185941,29.0,33.0,127,3.0,16
584,244,415,33.94757369614513,35.64263038548753,29.0,25.0,186,2.0,171
585,244,415,33.94757369614513,36.339229024943315,29.0,26.0,200,2.0,171
586,244,617,33.94757369614513,34.969251700680275,29.0,14.0,376,1.0,373
587,244,617,33.94757369614513,35.66585034013605,29.0,15.0,380,2.0,373
588,244,617,33.94757369614513,36.36244897959184,29.0,15.0,387,2.0,373
589,260,65,34.11011337868481,35.22467120181406,33.0,27.0,201,1.0,195
590,260,152,34.11011337868481,36.710748299319725,33.0,29.0,156,3.0,108
591,260,279,34.11011337868481,35.27111111111111,33.0,27.0,53,1.0,19
592,260,249,34.11011337868481,37.05904761904762,33.0,27.0,127,3.0,11
593,260,415,34.11011337868481,35.64263038548753,33.0,25.0,168,2.0,155
594,260,415,34.11011337868481,36.339229024943315,33.0,26.0,182,2.0,155
595,260,617,34.11011337868481,35.66585034013605,33.0,15.0,363,2.0,357
596,260,617,34.11011337868481,36.36244897959184,33.0,15.0,370,2.0,357
597,260,617,34.11011337868481,37.05904761904762,33.0,15.0,379,3.0,357
598,279,152,35.27111111111111,36.710748299319725,27.0,29.0,141,1.0,127
599,279,192,35.27111111111111,37.105487528344675,27.0,27.0,118,2.0,87
600,279,260,35.27111111111111,36.87328798185941,27.0,33.0,72,2.0,19
601,279,249,35.27111111111111,37.05904761904762,27.0,27.0,83,2.0,30
602,279,415,35.27111111111111,36.339229024943315,27.0,26.0,144,1.0,136
603,279,488,35.27111111111111,37.73242630385488,27.0,25.0,234,2.0,209
604,279,617,35.27111111111111,36.36244897959184,27.0,15.0,341,1.0,338
605,279,617,35.27111111111111,37.05904761904762,27.0,15.0,347,2.0,338
606,260,161,36.87328798185941,38.42902494331066,33.0,20.0,120,2.0,99
607,260,120,36.87328798185941,39.566802721088436,33.0,20.0,182,3.0,140
608,260,389,36.87328798185941,38.42902494331066,33.0,27.0,145,2.0,129
609,260,291,36.87328798185941,39.59002267573696,33.0,31.0,121,3.0,31
610,260,461,36.87328798185941,38.42902494331066,33.0,26.0,212,2.0,201
611,260,461,36.87328798185941,39.125623582766444,33.0,27.0,223,2.0,201
612,260,617,36.87328798185941,38.47546485260771,33.0,13.0,364,2.0,357
613,260,617,36.87328798185941,39.172063492063494,33.0,15.0,370,2.0,357
614,249,161,37.05904761904762,38.42902494331066,27.0,20.0,106,1.0,88
615,249,120,37.05904761904762,39.566802721088436,27.0,20.0,168,3.0,129
616,249,43,37.05904761904762,40.00798185941043,27.0,17.0,242,3.0,206
617,249,389,37.05904761904762,38.42902494331066,27.0,27.0,152,1.0,140
618,249,291,37.05904761904762,39.59002267573696,27.0,31.0,117,3.0,42
619,249,461,37.05904761904762,38.42902494331066,27.0,26.0,220,1.0,212
620,249,461,37.05904761904762,39.125623582766444,27.0,27.0,230,2.0,212
621,249,617,37.05904761904762,38.47546485260771,27.0,13.0,373,1.0,368
622,249,617,37.05904761904762,39.172063492063494,27.0,15.0,379,2.0,368
623,389,120,38.42902494331066,39.566802721088436,27.0,20.0,273,1.0,269
624,389,43,38.42902494331066,40.00798185941043,27.0,17.0,353,2.0,346
625,389,170,38.42902494331066,41.23863945578231,27.0,20.0,250,3.0,219
626,389,291,38.42902494331066,39.59002267573696,27.0,31.0,110,1.0,98
627,389,270,38.42902494331066,40.30984126984127,27.0,31.0,144,2.0,119
628,389,465,38.42902494331066,40.170521541950116,27.0,26.0,107,2.0,76
629,389,630,38.42902494331066,40.542040816326534,27.0,15.0,258,2.0,241
630,389,625,38.42902494331066,41.26185941043084,27.0,15.0,266,3.0,236
631,389,825,38.42902494331066,39.86866213151927,27.0,6.0,440,1.0,436
632,291,170,39.59002267573696,41.23863945578231,31.0,20.0,140,2.0,121
633,291,197,39.59002267573696,42.32997732426304,31.0,32.0,151,3.0,94
634,291,389,39.59002267573696,41.23863945578231,31.0,26.0,121,2.0,98
635,291,244,39.59002267573696,42.399637188208615,31.0,38.0,130,3.0,47
636,291,461,39.59002267573696,41.9352380952381,31.0,26.0,198,2.0,170
637,291,625,39.59002267573696,41.26185941043084,31.0,15.0,342,2.0,334
638,270,197,40.30984126984127,42.32997732426304,31.0,32.0,114,2.0,73
639,270,244,40.30984126984127,42.399637188208615,31.0,38.0,94,2.0,26
640,270,461,40.30984126984127,41.9352380952381,31.0,26.0,203,2.0,191
641,270,415,40.30984126984127,42.6550566893424,31.0,26.0,177,2.0,145
642,270,617,40.30984126984127,42.678276643990934,31.0,16.0,362,2.0,347
643,389,197,41.23863945578231,42.32997732426304,26.0,32.0,198,1.0,192
644,389,144,41.23863945578231,43.932154195011336,26.0,27.0,271,3.0,245
645,389,244,41.23863945578231,42.399637188208615,26.0,38.0,153,1.0,145
646,389,265,41.23863945578231,43.932154195011336,26.0,30.0,170,3.0,124
647,389,415,41.23863945578231,42.6550566893424,26.0,26.0,66,1.0,26
648,389,464,41.23863945578231,43.83927437641724,26.0,28.0,135,3.0,75
649,389,617,41.23863945578231,42.678276643990934,26.0,16.0,236,1.0,228
650,389,618,41.23863945578231,43.32843537414966,26.0,16.0,246,2.0,229
651,389,843,41.23863945578231,43.30521541950113,26.0,8.0,463,2.0,454
652,244,144,42.399637188208615,43.932154195011336,38.0,27.0,120,2.0,100
653,244,152,42.399637188208615,44.72163265306123,38.0,20.0,136,2.0,92
654,244,265,42.399637188208615,43.932154195011336,38.0,30.0,69,2.0,21
655,244,256,42.399637188208615,44.35011337868481,38.0,29.0,85,2.0,12
656,244,464,42.399637188208615,43.83927437641724,38.0,28.0,229,1.0,220
657,244,461,42.399637188208615,44.74485260770975,38.0,26.0,239,2.0,217
658,244,618,42.399637188208615,44.74485260770975,38.0,15.0,387,2.0,374
659,265,194,43.932154195011336,45.7665306122449,30.0,28.0,106,2.0,71
660,265,147,43.932154195011336,46.69532879818594,30.0,26.0,168,3.0,118
661,265,217,43.932154195011336,45.72009070294785,30.0,31.0,91,2.0,48
662,265,389,43.932154195011336,46.13804988662132,30.0,26.0,156,2.0,124
663,265,461,43.932154195011336,45.44145124716553,30.0,25.0,206,2.0,196
664,265,457,43.932154195011336,46.16126984126984,30.0,28.0,215,2.0,192
665,265,617,43.932154195011336,45.48789115646259,30.0,13.0,358,2.0,352
666,265,617,43.932154195011336,46.18448979591837,30.0,14.0,365,2.0,352
667,256,194,44.35011337868481,45.7665306122449,29.0,28.0,87,1.0,62
668,256,147,44.35011337868481,46.69532879818594,29.0,26.0,149,2.0,109
669,256,217,44.35011337868481,45.72009070294785,29.0,31.0,71,1.0,39
670,256,389,44.35011337868481,46.13804988662132,29.0,26.0,154,2.0,133
671,256,292,44.35011337868481,47.18294784580499,29.0,33.0,127,3.0,36
672,256,461,44.35011337868481,45.44145124716553,29.0,25.0,210,1.0,205
673,256,457,44.35011337868481,46.16126984126984,29.0,28.0,216,2.0,201
674,256,452,44.35011337868481,47.18294784580499,29.0,27.0,231,3.0,196
675,256,617,44.35011337868481,45.48789115646259,29.0,13.0,364,1.0,361
676,256,617,44.35011337868481,46.18448979591837,29.0,14.0,370,2.0,361
677,217,171,45.72009070294785,47.94920634920635,31.0,33.0,106,2.0,46
678,217,174,45.72009070294785,48.01886621315193,31.0,32.0,108,2.0,43
679,217,292,45.72009070294785,47.18294784580499,31.0,33.0,98,1.0,75
680,217,260,45.72009070294785,48.18140589569161,31.0,35.0,114,2.0,43
681,217,452,45.72009070294785,47.18294784580499,31.0,27.0,243,1.0,235
682,217,625,45.72009070294785,47.57768707482993,31.0,15.0,416,2.0,408
683,389,171,46.13804988662132,47.94920634920635,26.0,33.0,232,2.0,218
684,389,174,46.13804988662132,48.01886621315193,26.0,32.0,230,2.0,215
685,389,292,46.13804988662132,47.18294784580499,26.0,33.0,107,1.0,97
686,389,260,46.13804988662132,48.18140589569161,26.0,35.0,156,2.0,129
687,389,452,46.13804988662132,47.18294784580499,26.0,27.0,77,1.0,63
688,389,415,46.13804988662132,48.970884353741496,26.0,26.0,125,3.0,26
689,389,625,46.13804988662132,47.57768707482993,26.0,15.0,244,1.0,236
690,389,630,46.13804988662132,48.970884353741496,26.0,13.0,270,3.0,241
691,389,617,46.13804988662132,48.99410430839002,26.0,14.0,259,3.0,228
692,389,866,46.13804988662132,47.18294784580499,26.0,7.0,479,1.0,477
693,292,170,47.18294784580499,49.64426303854875,33.0,17.0,162,2.0,122
694,292,389,47.18294784580499,49.64426303854875,33.0,27.0,144,2.0,97
695,292,415,47.18294784580499,48.970884353741496,33.0,26.0,145,2.0,123
696,292,427,47.18294784580499,49.66748299319728,33.0,25.0,172,2.0,135
697,292,630,47.18294784580499,48.970884353741496,33.0,13.0,347,2.0,338
698,292,617,47.18294784580499,48.99410430839002,33.0,14.0,334,2.0,325
699,260,170,48.18140589569161,49.64426303854875,35.0,17.0,110,1.0,90
700,260,86,48.18140589569161,50.549841269841274,35.0,24.0,202,2.0,174
701,260,389,48.18140589569161,49.64426303854875,35.0,27.0,144,1.0,129
702,260,389,48.18140589569161,50.36408163265306,35.0,26.0,160,2.0,129
703,260,427,48.18140589569161,49.66748299319728,35.0,25.0,179,1.0,167
704,260,488,48.18140589569161,50.36408163265306,35.0,26.0,247,2.0,228
705,260,617,48.18140589569161,50.387301587301586,35.0,14.0,369,2.0,357
706,389,194,49.64426303854875,51.85015873015873,27.0,25.0,217,2.0,195
707,389,203,49.64426303854875,52.198458049886625,27.0,32.0,216,3.0,186
708,389,276,49.64426303854875,51.38575963718821,27.0,25.0,136,2.0,113
709,389,225,49.64426303854875,52.38421768707483,27.0,35.0,202,3.0,164
710,389,482,49.64426303854875,51.68761904761905,27.0,26.0,128,2.0,93
711,389,484,49.64426303854875,52.47709750566894,27.0,26.0,155,3.0,95
712,389,615,49.64426303854875,51.66439909297052,27.0,16.0,242,2.0,226
713,389,617,49.64426303854875,52.50031746031746,27.0,14.0,259,3.0,228
714,389,856,49.64426303854875,51.7340589569161,27.0,10.0,476,2.0,467
715,389,827,49.64426303854875,52.05913832199547,27.0,8.0,450,2.0,438
716,389,194,50.36408163265306,51.85015873015873,26.0,25.0,205,1.0,195
717,389,203,50.36408163265306,52.198458049886625,26.0,32.0,202,2.0,186
718,389,171,50.36408163265306,53.080816326530616,26.0,30.0,247,3.0,218
719,389,276,50.36408163265306,51.38575963718821,26.0,25.0,121,1.0,113
720,389,225,50.36408163265306,52.38421768707483,26.0,35.0,186,2.0,164
721,389,482,50.36408163265306,51.68761904761905,26.0,26.0,109,1.0,93
722,389,484,50.36408163265306,52.47709750566894,26.0,26.0,132,2.0,95
723,389,615,50.36408163265306,51.66439909297052,26.0,16.0,233,1.0,226
724,389,617,50.36408163265306,52.50031746031746,26.0,14.0,246,2.0,228
725,389,617,50.36408163265306,53.19691609977324,26.0,13.0,259,3.0,228
726,389,856,50.36408163265306,51.7340589569161,26.0,10.0,471,1.0,467
727,389,827,50.36408163265306,52.05913832199547,26.0,8.0,444,2.0,438
728,276,171,51.38575963718821,53.080816326530616,25.0,30.0,128,2.0,105
729,276,194,51.38575963718821,53.98639455782313,25.0,24.0,139,3.0,82
730,276,261,51.38575963718821,53.84707482993198,25.0,33.0,107,2.0,15
731,276,230,51.38575963718821,53.98639455782313,25.0,29.0,121,3.0,46
732,276,484,51.38575963718821,52.47709750566894,25.0,26.0,213,1.0,208
733,276,485,51.38575963718821,53.68453514739229,25.0,27.0,231,2.0,209
734,276,617,51.38575963718821,52.50031746031746,25.0,14.0,344,1.0,341
735,276,617,51.38575963718821,53.19691609977324,25.0,13.0,350,2.0,341
736,225,194,52.38421768707483,53.98639455782313,35.0,24.0,76,2.0,31
737,225,261,52.38421768707483,53.84707482993198,35.0,33.0,73,1.0,36
738,225,230,52.38421768707483,53.98639455782313,35.0,29.0,69,2.0,5
739,225,286,52.38421768707483,54.984852607709755,35.0,31.0,128,3.0,61
740,225,485,52.38421768707483,53.68453514739229,35.0,27.0,266,1.0,260
741,225,415,52.38421768707483,54.590113378684805,35.0,25.0,212,2.0,190
742,225,618,52.38421768707483,54.56689342403628,35.0,13.0,404,2.0,393
743,225,637,52.38421768707483,55.309931972789116,35.0,12.0,431,3.0,412
744,261,65,53.84707482993198,55.472471655328796,33.0,28.0,208,2.0,196
745,261,196,53.84707482993198,56.65668934240363,33.0,31.0,137,3.0,65
746,261,286,53.84707482993198,54.984852607709755,33.0,31.0,55,1.0,25
747,261,228,53.84707482993198,56.65668934240363,33.0,34.0,125,3.0,33
748,261,491,53.84707482993198,55.797551020408164,33.0,25.0,245,2.0,230
749,261,422,53.84707482993198,56.401269841269844,33.0,26.0,195,3.0,161
750,261,637,53.84707482993198,55.309931972789116,33.0,12.0,381,1.0,376
751,261,617,53.84707482993198,56.0065306122449,33.0,13.0,368,2.0,356
752,230,65,53.98639455782313,55.472471655328796,29.0,28.0,177,1.0,165
753,230,196,53.98639455782313,56.65668934240363,29.0,31.0,120,3.0,34
754,230,228,53.98639455782313,56.65668934240363,29.0,34.0,115,3.0,2
755,230,491,53.98639455782313,55.797551020408164,29.0,25.0,272,2.0,261
756,230,422,53.98639455782313,56.401269841269844,29.0,26.0,218,2.0,192
757,230,637,53.98639455782313,55.309931972789116,29.0,12.0,411,1.0,407
758,230,617,53.98639455782313,56.0065306122449,29.0,13.0,397,2.0,387
759,286,196,54.984852607709755,56.65668934240363,31.0,31.0,115,2.0,90
760,286,197,54.984852607709755,57.95700680272109,31.0,29.0,156,3.0,89
761,286,228,54.984852607709755,56.65668934240363,31.0,34.0,92,2.0,58
762,286,258,54.984852607709755,57.95700680272109,31.0,30.0,131,3.0,28
763,286,422,54.984852607709755,56.401269841269844,31.0,26.0,149,1.0,136
764,286,488,54.984852607709755,57.376507936507934,31.0,25.0,227,2.0,202
765,286,617,54.984852607709755,56.0065306122449,31.0,13.0,334,1.0,331
766,286,618,54.984852607709755,57.376507936507934,31.0,13.0,348,2.0,332
767,228,197,56.65668934240363,57.95700680272109,34.0,29.0,64,1.0,31
768,228,194,56.65668934240363,58.30530612244898,34.0,31.0,79,2.0,34
769,228,65,56.65668934240363,59.48952380952381,34.0,27.0,204,3.0,163
770,228,258,56.65668934240363,57.95700680272109,34.0,30.0,64,1.0,30
771,228,258,56.65668934240363,57.980226757369614,34.0,37.0,64,1.0,30
772,228,231,56.65668934240363,59.2108843537415,34.0,40.0,110,3.0,3
773,228,420,56.65668934240363,58.00344671201814,34.0,24.0,201,1.0,192
774,228,541,56.65668934240363,59.512743764172335,34.0,23.0,336,3.0,313
775,228,617,56.65668934240363,58.11954648526077,34.0,13.0,394,1.0,389
776,228,625,56.65668934240363,59.512743764172335,34.0,11.0,416,3.0,397
777,258,65,57.95700680272109,59.48952380952381,30.0,27.0,204,2.0,193
778,258,231,57.95700680272109,59.2108843537415,30.0,40.0,60,1.0,27
779,258,541,57.95700680272109,59.512743764172335,30.0,23.0,291,2.0,283
780,258,625,57.95700680272109,59.512743764172335,30.0,11.0,373,2.0,367
781,258,65,57.980226757369614,59.48952380952381,37.0,27.0,204,2.0,193
782,258,231,57.980226757369614,59.2108843537415,37.0,40.0,59,1.0,27
783,258,541,57.980226757369614,59.512743764172335,37.0,23.0,291,2.0,283
784,258,625,57.980226757369614,59.512743764172335,37.0,11.0,373,2.0,367
785,465,65,3.1579138321995464,4.179591836734694,6.0,30.0,402,1.0,400
786,465,19,3.1579138321995464,4.992290249433107,6.0,12.0,453,2.0,446
787,454,194,6.710566893424036,8.17342403628118,25.0,31.0,268,1.0,260
788,454,201,6.710566893424036,8.986122448979591,25.0,22.0,271,2.0,253
789,454,232,6.710566893424036,7.8251247165532885,25.0,31.0,227,1.0,222
790,454,260,6.710566893424036,8.080544217687075,25.0,32.0,203,1.0,194
791,454,231,6.710566893424036,9.009342403628118,25.0,16.0,244,2.0,223
792,420,194,6.989206349206349,8.17342403628118,15.0,31.0,232,1.0,226
793,420,201,6.989206349206349,8.986122448979591,15.0,22.0,235,2.0,219
794,420,260,6.989206349206349,8.080544217687075,15.0,32.0,167,1.0,160
795,420,231,6.989206349206349,9.009342403628118,15.0,16.0,208,2.0,189
796,420,454,6.989206349206349,8.034104308390022,15.0,9.0,56,1.0,34
797,454,77,8.034104308390022,10.565079365079365,9.0,17.0,392,3.0,377
798,428,185,12.469115646258503,14.605351473922903,27.0,24.0,260,2.0,243
799,428,389,12.469115646258503,13.862312925170068,27.0,27.0,72,1.0,39
800,428,242,12.469115646258503,14.628571428571428,27.0,27.0,208,2.0,186
801,428,415,12.469115646258503,13.885532879818594,27.0,27.0,62,1.0,13
802,428,457,12.469115646258503,14.582131519274377,27.0,26.0,96,2.0,29
803,428,617,12.469115646258503,14.605351473922903,27.0,15.0,210,2.0,189
804,428,630,12.469115646258503,15.27873015873016,27.0,15.0,235,3.0,202
805,428,856,12.469115646258503,13.862312925170068,27.0,6.0,432,1.0,428
806,415,77,13.885532879818594,15.928888888888888,27.0,20.0,349,2.0,338
807,415,389,13.885532879818594,15.975328798185942,27.0,26.0,94,2.0,26
808,415,225,13.885532879818594,16.857687074829933,27.0,26.0,229,3.0,190
809,415,457,13.885532879818594,15.975328798185942,27.0,27.0,99,2.0,42
810,415,630,13.885532879818594,15.27873015873016,27.0,15.0,223,1.0,215
811,415,630,13.885532879818594,16.69514739229025,27.0,15.0,247,3.0,215
812,457,77,14.582131519274377,15.928888888888888,26.0,20.0,384,1.0,380
813,457,152,14.582131519274377,16.973786848072564,26.0,24.0,322,2.0,305
814,457,389,14.582131519274377,15.975328798185942,26.0,26.0,91,1.0,68
815,457,225,14.582131519274377,16.857687074829933,26.0,26.0,252,2.0,232
816,457,415,14.582131519274377,16.69514739229025,26.0,26.0,100,2.0,42
817,457,484,14.582131519274377,17.39174603174603,26.0,24.0,124,3.0,27
818,457,630,14.582131519274377,16.69514739229025,26.0,15.0,195,2.0,173
819,457,630,14.582131519274377,17.39174603174603,26.0,12.0,211,3.0,173
820,457,195,15.975328798185942,17.972244897959182,27.0,29.0,276,2.0,262
821,457,194,15.975328798185942,18.552743764172337,27.0,30.0,285,3.0,263
822,457,260,15.975328798185942,17.87936507936508,27.0,25.0,213,2.0,197
823,457,259,15.975328798185942,18.018684807256236,27.0,28.0,217,2.0,198
824,457,484,15.975328798185942,17.39174603174603,27.0,24.0,67,1.0,27
825,457,461,15.975328798185942,18.088344671201813,27.0,25.0,91,2.0,4
826,457,630,15.975328798185942,17.39174603174603,27.0,12.0,183,1.0,173
827,457,617,15.975328798185942,18.808163265306124,27.0,14.0,201,3.0,160
828,415,195,16.69514739229025,17.972244897959182,26.0,29.0,227,1.0,220
829,415,194,16.69514739229025,18.552743764172337,26.0,30.0,235,2.0,221
830,415,146,16.69514739229025,19.43510204081633,26.0,24.0,294,3.0,269
831,415,260,16.69514739229025,17.87936507936508,26.0,25.0,163,1.0,155
832,415,259,16.69514739229025,18.018684807256236,26.0,28.0,166,1.0,156
833,415,291,16.69514739229025,19.319002267573698,26.0,28.0,168,3.0,124
834,415,461,16.69514739229025,18.088344671201813,26.0,25.0,76,1.0,46
835,415,462,16.69514739229025,19.504761904761907,26.0,25.0,130,3.0,47
836,415,617,16.69514739229025,18.808163265306124,26.0,14.0,222,2.0,202
837,415,617,16.69514739229025,19.504761904761907,26.0,12.0,235,3.0,202
838,484,194,17.39174603174603,18.552743764172337,24.0,30.0,294,1.0,290
839,484,146,17.39174603174603,19.43510204081633,24.0,24.0,349,2.0,338
840,484,291,17.39174603174603,19.319002267573698,24.0,28.0,210,2.0,193
841,484,232,17.39174603174603,20.06204081632653,24.0,27.0,277,3.0,252
842,484,462,17.39174603174603,19.504761904761907,24.0,25.0,94,2.0,22
843,484,617,17.39174603174603,18.808163265306124,24.0,14.0,146,1.0,133
844,484,617,17.39174603174603,19.504761904761907,24.0,12.0,161,2.0,133
845,484,617,17.39174603174603,20.224580498866214,24.0,14.0,180,3.0,133
846,461,146,18.088344671201813,19.43510204081633,25.0,24.0,320,1.0,315
847,461,195,18.088344671201813,20.712199546485262,25.0,24.0,289,3.0,266
848,461,291,18.088344671201813,19.319002267573698,25.0,28.0,178,1.0,170
849,461,232,18.088344671201813,20.06204081632653,25.0,27.0,244,2.0,229
850,461,462,18.088344671201813,19.504761904761907,25.0,25.0,61,1.0,1
851,461,617,18.088344671201813,19.504761904761907,25.0,12.0,168,1.0,156
852,461,617,18.088344671201813,20.224580498866214,25.0,14.0,181,2.0,156
853,462,195,19.504761904761907,20.712199546485262,25.0,24.0,272,1.0,267
854,462,65,19.504761904761907,21.43201814058957,25.0,21.0,406,2.0,397
855,462,73,19.504761904761907,22.151836734693877,25.0,22.0,405,3.0,389
856,462,232,19.504761904761907,21.873197278911565,25.0,24.0,252,2.0,230
857,462,292,19.504761904761907,22.151836734693877,25.0,26.0,205,3.0,170
858,462,461,19.504761904761907,20.89795918367347,25.0,26.0,60,1.0,1
859,462,415,19.504761904761907,22.31437641723356,25.0,24.0,130,3.0,47
860,462,637,19.504761904761907,21.61777777777778,25.0,13.0,197,2.0,175
861,462,617,19.504761904761907,22.31437641723356,25.0,12.0,197,3.0,155
862,461,73,20.89795918367347,22.151836734693877,26.0,22.0,392,1.0,388
863,461,86,20.89795918367347,23.54503401360544,26.0,27.0,392,3.0,375
864,461,292,20.89795918367347,22.151836734693877,26.0,26.0,177,1.0,169
865,461,409,20.89795918367347,23.034195011337868,26.0,24.0,106,2.0,52
866,461,415,20.89795918367347,22.31437641723356,26.0,24.0,76,1.0,46
867,461,462,20.89795918367347,23.010975056689343,26.0,25.0,91,2.0,1
868,461,617,20.89795918367347,22.31437641723356,26.0,12.0,168,1.0,156
869,461,617,20.89795918367347,23.034195011337868,26.0,13.0,181,2.0,156
870,462,86,21.594557823129254,23.54503401360544,26.0,27.0,385,2.0,376
871,462,409,21.594557823129254,23.034195011337868,26.0,24.0,82,1.0,53
872,462,232,21.594557823129254,24.380952380952383,26.0,27.0,259,3.0,230
873,462,617,21.594557823129254,23.034195011337868,26.0,13.0,167,1.0,155
874,462,617,21.594557823129254,24.427392290249433,26.0,12.0,197,3.0,155
875,415,86,22.31437641723356,23.54503401360544,24.0,27.0,333,1.0,329
876,415,86,22.31437641723356,24.938231292517006,24.0,24.0,348,3.0,329
877,415,232,22.31437641723356,24.380952380952383,24.0,27.0,203,2.0,183
878,415,292,22.31437641723356,25.007891156462584,24.0,24.0,169,3.0,123
879,415,462,22.31437641723356,24.404172335600908,24.0,25.0,102,2.0,47
880,415,461,22.31437641723356,25.10077097505669,24.0,25.0,129,3.0,46
881,415,617,22.31437641723356,24.427392290249433,24.0,12.0,222,2.0,202
882,415,617,22.31437641723356,25.123990929705215,24.0,14.0,235,3.0,202
883,462,86,23.010975056689343,24.938231292517006,25.0,24.0,385,2.0,376
884,462,65,23.010975056689343,25.40263038548753,25.0,21.0,410,2.0,397
885,462,232,23.010975056689343,24.380952380952383,25.0,27.0,237,1.0,230
886,462,292,23.010975056689343,25.007891156462584,25.0,24.0,191,2.0,170
887,462,461,23.010975056689343,25.10077097505669,25.0,25.0,90,2.0,1
888,462,617,23.010975056689343,24.427392290249433,25.0,12.0,167,1.0,155
889,462,617,23.010975056689343,25.123990929705215,25.0,14.0,180,2.0,155
890,462,204,24.404172335600908,26.51718820861678,25.0,20.0,274,2.0,258
891,462,260,24.404172335600908,26.05278911564626,25.0,25.0,214,2.0,202
892,462,415,24.404172335600908,26.51718820861678,25.0,26.0,102,2.0,47
893,462,461,24.404172335600908,27.213786848072562,25.0,28.0,121,3.0,1
894,462,617,24.404172335600908,26.51718820861678,25.0,14.0,180,2.0,155
895,462,617,24.404172335600908,27.23700680272109,25.0,16.0,197,3.0,155
896,461,204,25.10077097505669,26.51718820861678,25.0,20.0,264,1.0,257
897,461,152,25.10077097505669,27.654965986394558,25.0,20.0,328,3.0,309
898,461,396,25.10077097505669,27.933605442176873,25.0,25.0,138,3.0,65
899,461,415,25.10077097505669,26.51718820861678,25.0,26.0,76,1.0,46
900,461,617,25.10077097505669,26.51718820861678,25.0,14.0,168,1.0,156
901,461,617,25.10077097505669,27.23700680272109,25.0,16.0,181,2.0,156
902,415,152,26.51718820861678,27.654965986394558,26.0,20.0,268,1.0,263
903,415,72,26.51718820861678,28.305124716553287,26.0,27.0,352,2.0,343
904,415,72,26.51718820861678,29.048163265306123,26.0,23.0,360,3.0,343
905,415,396,26.51718820861678,27.933605442176873,26.0,25.0,64,1.0,19
906,415,265,26.51718820861678,28.328344671201815,26.0,29.0,169,2.0,150
907,415,275,26.51718820861678,29.1178231292517,26.0,27.0,179,3.0,140
908,415,497,26.51718820861678,28.583764172335602,26.0,25.0,121,2.0,82
909,415,615,26.51718820861678,28.560544217687074,26.0,12.0,219,2.0,200
910,415,617,26.51718820861678,29.350022675736962,26.0,14.0,236,3.0,202
911,461,72,27.213786848072562,28.305124716553287,28.0,27.0,392,1.0,389
912,461,72,27.213786848072562,29.048163265306123,28.0,23.0,397,2.0,389
913,461,265,27.213786848072562,28.328344671201815,28.0,29.0,202,1.0,196
914,461,275,27.213786848072562,29.1178231292517,28.0,27.0,203,2.0,186
915,461,389,27.213786848072562,30.00018140589569,28.0,27.0,140,3.0,72
916,461,497,27.213786848072562,28.583764172335602,28.0,25.0,69,1.0,36
917,461,415,27.213786848072562,29.326802721088438,28.0,25.0,102,2.0,46
918,461,415,27.213786848072562,30.02340136054422,28.0,27.0,129,3.0,46
919,461,615,27.213786848072562,28.560544217687074,28.0,12.0,165,1.0,154
920,461,617,27.213786848072562,29.350022675736962,28.0,14.0,181,2.0,156
921,461,617,27.213786848072562,30.046621315192745,28.0,15.0,198,3.0,156
922,461,856,27.213786848072562,30.00018140589569,28.0,6.0,413,3.0,395
923,497,161,28.583764172335602,30.696780045351474,25.0,20.0,348,2.0,336
924,497,389,28.583764172335602,30.00018140589569,25.0,27.0,124,1.0,108
925,497,415,28.583764172335602,30.02340136054422,25.0,27.0,103,1.0,82
926,497,457,28.583764172335602,31.41659863945578,25.0,26.0,128,3.0,40
927,497,617,28.583764172335602,30.046621315192745,25.0,15.0,136,1.0,120
928,497,630,28.583764172335602,31.41659863945578,25.0,14.0,180,3.0,133
929,497,856,28.583764172335602,30.00018140589569,25.0,6.0,364,1.0,359
930,415,161,29.326802721088438,30.696780045351474,25.0,20.0,261,1.0,254
931,415,174,29.326802721088438,31.74167800453515,25.0,31.0,262,2.0,241
932,415,282,29.326802721088438,31.67201814058957,25.0,32.0,167,2.0,133
933,415,457,29.326802721088438,31.41659863945578,25.0,26.0,99,2.0,42
934,415,630,29.326802721088438,31.41659863945578,25.0,14.0,233,2.0,215
935,415,852,29.326802721088438,32.08997732426304,25.0,6.0,453,3.0,437
936,415,174,30.02340136054422,31.74167800453515,27.0,31.0,252,2.0,241
937,415,65,30.02340136054422,32.41505668934241,27.0,26.0,365,2.0,350
938,415,282,30.02340136054422,31.67201814058957,27.0,32.0,151,2.0,133
939,415,265,30.02340136054422,32.71691609977324,27.0,32.0,190,3.0,150
940,415,457,30.02340136054422,31.41659863945578,27.0,26.0,73,1.0,42
941,415,630,30.02340136054422,31.41659863945578,27.0,14.0,223,1.0,215
942,415,617,30.02340136054422,32.8562358276644,27.0,14.0,236,3.0,202
943,415,852,30.02340136054422,32.08997732426304,27.0,6.0,446,2.0,437
944,457,195,31.41659863945578,33.9243537414966,26.0,35.0,283,3.0,262
945,457,193,31.41659863945578,34.06367346938776,26.0,26.0,288,3.0,264
946,457,265,31.41659863945578,32.71691609977324,26.0,32.0,200,1.0,192
947,457,244,31.41659863945578,33.94757369614513,26.0,29.0,239,3.0,213
948,457,260,31.41659863945578,34.11011337868481,26.0,33.0,229,3.0,197
949,457,415,31.41659863945578,33.52961451247165,26.0,25.0,100,2.0,42
950,457,617,31.41659863945578,32.8562358276644,26.0,14.0,172,1.0,160
951,457,630,31.41659863945578,33.52961451247165,26.0,14.0,195,2.0,173
952,457,854,31.41659863945578,33.50639455782313,26.0,5.0,407,2.0,397
953,415,195,32.13641723356009,33.9243537414966,26.0,35.0,233,2.0,220
954,415,193,32.13641723356009,34.06367346938776,26.0,26.0,237,2.0,222
955,415,244,32.13641723356009,33.94757369614513,26.0,29.0,188,2.0,171
956,415,260,32.13641723356009,34.11011337868481,26.0,33.0,177,2.0,155
957,415,460,32.13641723356009,34.50485260770975,26.0,27.0,111,2.0,45
958,415,630,32.13641723356009,33.52961451247165,26.0,14.0,223,1.0,215
959,415,617,32.13641723356009,34.969251700680275,26.0,14.0,236,3.0,202
960,415,854,32.13641723356009,33.50639455782313,26.0,5.0,443,1.0,439
961,415,65,33.52961451247165,35.22467120181406,25.0,27.0,358,2.0,350
962,415,279,33.52961451247165,35.27111111111111,25.0,27.0,155,2.0,136
963,415,617,33.52961451247165,34.969251700680275,25.0,14.0,211,1.0,202
964,415,617,33.52961451247165,35.66585034013605,25.0,15.0,222,2.0,202
965,415,617,33.52961451247165,36.36244897959184,25.0,15.0,236,3.0,202
966,460,152,34.50485260770975,36.710748299319725,27.0,29.0,322,2.0,308
967,460,192,34.50485260770975,37.105487528344675,27.0,27.0,290,3.0,268
968,460,260,34.50485260770975,36.87328798185941,27.0,33.0,225,2.0,200
969,460,249,34.50485260770975,37.05904761904762,27.0,27.0,238,3.0,211
970,460,415,34.50485260770975,35.64263038548753,27.0,25.0,67,1.0,45
971,460,415,34.50485260770975,36.339229024943315,27.0,26.0,91,2.0,45
972,460,617,34.50485260770975,35.66585034013605,27.0,15.0,165,1.0,157
973,460,617,34.50485260770975,36.36244897959184,27.0,15.0,176,2.0,157
974,460,617,34.50485260770975,37.05904761904762,27.0,15.0,192,3.0,157
975,415,152,35.64263038548753,36.710748299319725,25.0,29.0,267,1.0,263
976,415,192,35.64263038548753,37.105487528344675,25.0,27.0,232,1.0,223
977,415,161,35.64263038548753,38.42902494331066,25.0,20.0,281,3.0,254
978,415,260,35.64263038548753,36.87328798185941,25.0,33.0,164,1.0,155
979,415,249,35.64263038548753,37.05904761904762,25.0,27.0,177,1.0,166
980,415,389,35.64263038548753,38.42902494331066,25.0,27.0,123,3.0,26
981,415,488,35.64263038548753,37.73242630385488,25.0,25.0,116,2.0,73
982,415,461,35.64263038548753,38.42902494331066,25.0,26.0,129,3.0,46
983,415,617,35.64263038548753,37.05904761904762,25.0,15.0,211,1.0,202
984,415,617,35.64263038548753,38.47546485260771,25.0,13.0,236,3.0,202
985,415,161,36.339229024943315,38.42902494331066,26.0,20.0,269,2.0,254
986,415,389,36.339229024943315,38.42902494331066,26.0,27.0,94,2.0,26
987,415,488,36.339229024943315,37.73242630385488,26.0,25.0,94,1.0,73
988,415,461,36.339229024943315,38.42902494331066,26.0,26.0,101,2.0,46
989,415,461,36.339229024943315,39.125623582766444,26.0,27.0,129,3.0,46
990,415,617,36.339229024943315,38.47546485260771,26.0,13.0,222,2.0,202
991,415,617,36.339229024943315,39.172063492063494,26.0,15.0,236,3.0,202
992,488,120,37.73242630385488,39.566802721088436,25.0,20.0,376,2.0,368
993,488,43,37.73242630385488,40.00798185941043,25.0,17.0,456,2.0,445
994,488,291,37.73242630385488,39.59002267573696,25.0,31.0,213,2.0,197
995,488,270,37.73242630385488,40.30984126984127,25.0,31.0,245,3.0,218
996,488,461,37.73242630385488,39.125623582766444,25.0,27.0,66,1.0,27
997,488,465,37.73242630385488,40.170521541950116,25.0,26.0,107,2.0,23
998,488,617,37.73242630385488,39.172063492063494,25.0,15.0,143,1.0,129
999,488,630,37.73242630385488,40.542040816326534,25.0,15.0,187,3.0,142
1000,488,825,37.73242630385488,39.86866213151927,25.0,6.0,349,2.0,337
1001,461,120,38.42902494331066,39.566802721088436,26.0,20.0,345,1.0,341
1002,461,43,38.42902494331066,40.00798185941043,26.0,17.0,423,2.0,418
1003,461,170,38.42902494331066,41.23863945578231,26.0,20.0,315,3.0,291
1004,461,291,38.42902494331066,39.59002267573696,26.0,31.0,177,1.0,170
1005,461,270,38.42902494331066,40.30984126984127,26.0,31.0,207,2.0,191
1006,461,389,38.42902494331066,41.23863945578231,26.0,26.0,141,3.0,72
1007,461,465,38.42902494331066,40.170521541950116,26.0,26.0,75,2.0,4
1008,461,630,38.42902494331066,40.542040816326534,26.0,15.0,192,2.0,169
1009,461,625,38.42902494331066,41.26185941043084,26.0,15.0,204,3.0,164
1010,461,825,38.42902494331066,39.86866213151927,26.0,6.0,369,1.0,364
1011,461,170,39.125623582766444,41.23863945578231,27.0,20.0,305,2.0,291
1012,461,270,39.125623582766444,40.30984126984127,27.0,31.0,198,1.0,191
1013,461,389,39.125623582766444,41.23863945578231,27.0,26.0,116,2.0,72
1014,461,465,39.125623582766444,40.170521541950116,27.0,26.0,45,1.0,4
1015,461,630,39.125623582766444,40.542040816326534,27.0,15.0,180,1.0,169
1016,461,625,39.125623582766444,41.26185941043084,27.0,15.0,188,2.0,164
1017,465,170,40.170521541950116,41.23863945578231,26.0,20.0,299,1.0,295
1018,465,197,40.170521541950116,42.32997732426304,26.0,32.0,284,2.0,268
1019,465,389,40.170521541950116,41.23863945578231,26.0,26.0,89,1.0,76
1020,465,244,40.170521541950116,42.399637188208615,26.0,38.0,241,2.0,221
1021,465,461,40.170521541950116,41.9352380952381,26.0,26.0,76,2.0,4
1022,465,415,40.170521541950116,42.6550566893424,26.0,26.0,118,2.0,50
1023,465,625,40.170521541950116,41.26185941043084,26.0,15.0,167,1.0,160
1024,465,617,40.170521541950116,42.678276643990934,26.0,16.0,186,3.0,152
1025,461,144,41.9352380952381,43.932154195011336,26.0,27.0,328,2.0,317
1026,461,152,41.9352380952381,44.72163265306123,26.0,20.0,331,3.0,309
1027,461,265,41.9352380952381,43.932154195011336,26.0,30.0,214,2.0,196
1028,461,256,41.9352380952381,44.35011337868481,26.0,29.0,230,2.0,205
1029,461,464,41.9352380952381,43.83927437641724,26.0,28.0,82,2.0,3
1030,461,618,41.9352380952381,43.32843537414966,26.0,16.0,168,1.0,157
1031,461,618,41.9352380952381,44.74485260770975,26.0,15.0,198,3.0,157
1032,461,843,41.9352380952381,43.30521541950113,26.0,8.0,387,1.0,382
1033,415,144,42.6550566893424,43.932154195011336,26.0,27.0,277,1.0,271
1034,415,152,42.6550566893424,44.72163265306123,26.0,20.0,278,2.0,263
1035,415,265,42.6550566893424,43.932154195011336,26.0,30.0,160,1.0,150
1036,415,256,42.6550566893424,44.35011337868481,26.0,29.0,175,2.0,159
1037,415,464,42.6550566893424,43.83927437641724,26.0,28.0,71,1.0,49
1038,415,461,42.6550566893424,44.74485260770975,26.0,26.0,101,2.0,46
1039,415,461,42.6550566893424,45.44145124716553,26.0,25.0,129,3.0,46
1040,415,618,42.6550566893424,44.74485260770975,26.0,15.0,222,2.0,203
1041,415,617,42.6550566893424,45.48789115646259,26.0,13.0,236,3.0,202
1042,415,848,42.6550566893424,45.41823129251701,26.0,7.0,449,3.0,433
1043,464,194,43.83927437641724,45.7665306122449,28.0,28.0,282,2.0,270
1044,464,147,43.83927437641724,46.69532879818594,28.0,26.0,340,3.0,317
1045,464,217,43.83927437641724,45.72009070294785,28.0,31.0,260,2.0,247
1046,464,389,43.83927437641724,46.13804988662132,28.0,26.0,124,2.0,75
1047,464,461,43.83927437641724,45.44145124716553,28.0,25.0,69,2.0,3
1048,464,457,43.83927437641724,46.16126984126984,28.0,28.0,100,2.0,7
1049,464,617,43.83927437641724,45.48789115646259,28.0,13.0,169,2.0,153
1050,464,617,43.83927437641724,46.18448979591837,28.0,14.0,183,2.0,153
1051,464,848,43.83927437641724,45.41823129251701,28.0,7.0,390,2.0,384
1052,464,821,43.83927437641724,46.46312925170068,28.0,6.0,374,3.0,357
1053,461,194,44.74485260770975,45.7665306122449,26.0,28.0,271,1.0,267
1054,461,147,44.74485260770975,46.69532879818594,26.0,26.0,325,2.0,314
1055,461,389,44.74485260770975,46.13804988662132,26.0,26.0,94,1.0,72
1056,461,292,44.74485260770975,47.18294784580499,26.0,33.0,199,2.0,169
1057,461,457,44.74485260770975,46.16126984126984,26.0,28.0,61,1.0,4
1058,461,452,44.74485260770975,47.18294784580499,26.0,27.0,105,2.0,9
1059,461,617,44.74485260770975,46.18448979591837,26.0,14.0,168,1.0,156
1060,461,625,44.74485260770975,47.57768707482993,26.0,15.0,204,3.0,164
1061,461,821,44.74485260770975,46.46312925170068,26.0,6.0,368,2.0,360
1062,461,866,44.74485260770975,47.18294784580499,26.0,7.0,418,2.0,405
1063,461,147,45.44145124716553,46.69532879818594,25.0,26.0,319,1.0,314
1064,461,171,45.44145124716553,47.94920634920635,25.0,33.0,309,3.0,290
1065,461,174,45.44145124716553,48.01886621315193,25.0,32.0,308,3.0,287
1066,461,292,45.44145124716553,47.18294784580499,25.0,33.0,185,2.0,169
1067,461,260,45.44145124716553,48.18140589569161,25.0,35.0,233,3.0,201
1068,461,452,45.44145124716553,47.18294784580499,25.0,27.0,76,2.0,9
1069,461,625,45.44145124716553,47.57768707482993,25.0,15.0,188,2.0,164
1070,461,821,45.44145124716553,46.46312925170068,25.0,6.0,363,1.0,360
1071,461,866,45.44145124716553,47.18294784580499,25.0,7.0,412,2.0,405
1072,457,171,46.16126984126984,47.94920634920635,28.0,33.0,296,2.0,286
1073,457,174,46.16126984126984,48.01886621315193,28.0,32.0,294,2.0,283
1074,457,292,46.16126984126984,47.18294784580499,28.0,33.0,171,1.0,165
1075,457,260,46.16126984126984,48.18140589569161,28.0,35.0,215,2.0,197
1076,457,452,46.16126984126984,47.18294784580499,28.0,27.0,44,1.0,5
1077,457,415,46.16126984126984,48.970884353741496,28.0,26.0,128,3.0,42
1078,457,625,46.16126984126984,47.57768707482993,28.0,15.0,179,1.0,168
1079,457,630,46.16126984126984,48.970884353741496,28.0,13.0,211,3.0,173
1080,457,617,46.16126984126984,48.99410430839002,28.0,14.0,201,3.0,160
1081,457,866,46.16126984126984,47.18294784580499,28.0,7.0,411,1.0,409
1082,452,170,47.18294784580499,49.64426303854875,27.0,17.0,301,2.0,282
1083,452,389,47.18294784580499,49.64426303854875,27.0,27.0,123,2.0,63
1084,452,415,47.18294784580499,48.970884353741496,27.0,26.0,85,2.0,37
1085,452,427,47.18294784580499,49.66748299319728,27.0,25.0,110,2.0,25
1086,452,630,47.18294784580499,48.970884353741496,27.0,13.0,194,2.0,178
1087,452,617,47.18294784580499,48.99410430839002,27.0,14.0,183,2.0,165
1088,452,855,47.18294784580499,49.64426303854875,27.0,5.0,417,2.0,403
1089,415,86,48.970884353741496,50.549841269841274,26.0,24.0,336,2.0,329
1090,415,194,48.970884353741496,51.85015873015873,26.0,25.0,253,3.0,221
1091,415,389,48.970884353741496,50.36408163265306,26.0,26.0,65,1.0,26
1092,415,276,48.970884353741496,51.38575963718821,26.0,25.0,174,2.0,139
1093,415,488,48.970884353741496,50.36408163265306,26.0,26.0,94,1.0,73
1094,415,482,48.970884353741496,51.68761904761905,26.0,26.0,135,3.0,67
1095,415,617,48.970884353741496,50.387301587301586,26.0,14.0,211,1.0,202
1096,415,615,48.970884353741496,51.66439909297052,26.0,16.0,231,3.0,200
1097,415,856,48.970884353741496,51.7340589569161,26.0,10.0,457,3.0,441
1098,427,194,49.66748299319728,51.85015873015873,25.0,25.0,251,2.0,233
1099,427,203,49.66748299319728,52.198458049886625,25.0,32.0,249,3.0,224
1100,427,276,49.66748299319728,51.38575963718821,25.0,25.0,168,2.0,151
1101,427,225,49.66748299319728,52.38421768707483,25.0,35.0,233,3.0,202
1102,427,482,49.66748299319728,51.68761904761905,25.0,26.0,103,2.0,55
1103,427,484,49.66748299319728,52.47709750566894,25.0,26.0,134,3.0,57
1104,427,615,49.66748299319728,51.66439909297052,25.0,16.0,207,2.0,188
1105,427,617,49.66748299319728,52.50031746031746,25.0,14.0,226,3.0,190
1106,427,856,49.66748299319728,51.7340589569161,25.0,10.0,438,2.0,429
1107,427,827,49.66748299319728,52.05913832199547,25.0,8.0,413,2.0,400
1108,488,194,50.36408163265306,51.85015873015873,26.0,25.0,301,1.0,294
1109,488,203,50.36408163265306,52.198458049886625,26.0,32.0,296,2.0,285
1110,488,171,50.36408163265306,53.080816326530616,26.0,30.0,338,3.0,317
1111,488,276,50.36408163265306,51.38575963718821,26.0,25.0,217,1.0,212
1112,488,225,50.36408163265306,52.38421768707483,26.0,35.0,277,2.0,263
1113,488,482,50.36408163265306,51.68761904761905,26.0,26.0,57,1.0,6
1114,488,484,50.36408163265306,52.47709750566894,26.0,26.0,91,2.0,4
1115,488,615,50.36408163265306,51.66439909297052,26.0,16.0,139,1.0,127
1116,488,617,50.36408163265306,52.50031746031746,26.0,14.0,158,2.0,129
1117,488,617,50.36408163265306,53.19691609977324,26.0,13.0,178,3.0,129
1118,488,856,50.36408163265306,51.7340589569161,26.0,10.0,373,1.0,368
1119,488,827,50.36408163265306,52.05913832199547,26.0,8.0,347,2.0,339
1120,482,171,51.68761904761905,53.080816326530616,26.0,30.0,317,1.0,311
1121,482,194,51.68761904761905,53.98639455782313,26.0,24.0,305,2.0,288
1122,482,261,51.68761904761905,53.84707482993198,26.0,33.0,240,2.0,221
1123,482,230,51.68761904761905,53.98639455782313,26.0,29.0,271,2.0,252
1124,482,485,51.68761904761905,53.68453514739229,26.0,27.0,86,2.0,3
1125,482,415,51.68761904761905,54.590113378684805,26.0,25.0,142,3.0,67
1126,482,617,51.68761904761905,53.19691609977324,26.0,13.0,150,2.0,135
1127,482,618,51.68761904761905,54.56689342403628,26.0,13.0,184,3.0,136
1128,482,849,51.68761904761905,53.84707482993198,26.0,6.0,379,2.0,367
1129,484,194,52.47709750566894,53.98639455782313,26.0,24.0,297,2.0,290
1130,484,261,52.47709750566894,53.84707482993198,26.0,33.0,231,1.0,223
1131,484,230,52.47709750566894,53.98639455782313,26.0,29.0,262,2.0,254
1132,484,286,52.47709750566894,54.984852607709755,26.0,31.0,226,3.0,198
1133,484,485,52.47709750566894,53.68453514739229,26.0,27.0,52,1.0,1
1134,484,415,52.47709750566894,54.590113378684805,26.0,25.0,114,2.0,69
1135,484,618,52.47709750566894,54.56689342403628,26.0,13.0,161,2.0,134
1136,484,637,52.47709750566894,55.309931972789116,26.0,12.0,196,3.0,153
1137,484,849,52.47709750566894,53.84707482993198,26.0,6.0,370,1.0,365
1138,485,65,53.68453514739229,55.472471655328796,27.0,28.0,427,2.0,420
1139,485,196,53.68453514739229,56.65668934240363,27.0,31.0,316,3.0,289
1140,485,286,53.68453514739229,54.984852607709755,27.0,31.0,207,1.0,199
1141,485,228,53.68453514739229,56.65668934240363,27.0,34.0,287,3.0,257
1142,485,491,53.68453514739229,55.797551020408164,27.0,25.0,91,2.0,6
1143,485,422,53.68453514739229,56.401269841269844,27.0,26.0,133,3.0,63
1144,485,637,53.68453514739229,55.309931972789116,27.0,12.0,167,2.0,152
1145,485,617,53.68453514739229,56.0065306122449,27.0,13.0,166,2.0,132
1146,485,843,53.68453514739229,55.77433106575964,27.0,7.0,369,2.0,358
1147,415,196,54.590113378684805,56.65668934240363,25.0,31.0,236,2.0,219
1148,415,228,54.590113378684805,56.65668934240363,25.0,34.0,207,2.0,187
1149,415,491,54.590113378684805,55.797551020408164,25.0,25.0,92,1.0,76
1150,415,422,54.590113378684805,56.401269841269844,25.0,26.0,78,2.0,7
1151,415,488,54.590113378684805,57.376507936507934,25.0,25.0,140,3.0,73
1152,415,617,54.590113378684805,56.0065306122449,25.0,13.0,211,1.0,202
1153,415,618,54.590113378684805,57.376507936507934,25.0,13.0,236,3.0,203
1154,415,843,54.590113378684805,55.77433106575964,25.0,7.0,431,1.0,428
1155,491,197,55.797551020408164,57.95700680272109,25.0,29.0,308,2.0,294
1156,491,194,55.797551020408164,58.30530612244898,25.0,31.0,316,3.0,297
1157,491,258,55.797551020408164,57.95700680272109,25.0,30.0,251,2.0,233
1158,491,258,55.797551020408164,57.980226757369614,25.0,37.0,251,2.0,233
1159,491,488,55.797551020408164,57.376507936507934,25.0,25.0,68,2.0,3
1160,491,420,55.797551020408164,58.00344671201814,25.0,24.0,119,2.0,71
1161,491,618,55.797551020408164,57.376507936507934,25.0,13.0,144,2.0,127
1162,491,617,55.797551020408164,58.11954648526077,25.0,13.0,161,2.0,126
1163,491,826,55.797551020408164,57.88734693877551,25.0,9.0,347,2.0,335
1164,491,845,55.797551020408164,58.653605442176875,25.0,7.0,375,3.0,354
1165,422,197,56.401269841269844,57.95700680272109,26.0,29.0,235,2.0,225
1166,422,194,56.401269841269844,58.30530612244898,26.0,31.0,242,2.0,228
1167,422,258,56.401269841269844,57.95700680272109,26.0,30.0,177,2.0,164
1168,422,258,56.401269841269844,57.980226757369614,26.0,37.0,178,2.0,164
1169,422,231,56.401269841269844,59.2108843537415,26.0,40.0,226,3.0,191
1170,422,420,56.401269841269844,58.00344671201814,26.0,24.0,69,2.0,2
1171,422,617,56.401269841269844,58.11954648526077,26.0,13.0,209,2.0,195
1172,422,826,56.401269841269844,57.88734693877551,26.0,9.0,409,1.0,404
1173,422,845,56.401269841269844,58.653605442176875,26.0,7.0,434,2.0,423
1174,488,65,57.376507936507934,59.48952380952381,25.0,27.0,433,2.0,423
1175,488,231,57.376507936507934,59.2108843537415,25.0,40.0,269,2.0,257
1176,488,541,57.376507936507934,59.512743764172335,25.0,23.0,106,2.0,53
1177,488,625,57.376507936507934,59.512743764172335,25.0,11.0,165,2.0,137
1178,488,845,57.376507936507934,58.653605442176875,25.0,7.0,361,1.0,357
1179,420,65,58.00344671201814,59.48952380952381,24.0,27.0,361,1.0,355
1180,420,231,58.00344671201814,59.2108843537415,24.0,40.0,196,1.0,189
1181,420,541,58.00344671201814,59.512743764172335,24.0,23.0,137,2.0,121
1182,420,625,58.00344671201814,59.512743764172335,24.0,11.0,215,2.0,205
1183,618,194,6.664126984126984,8.17342403628118,5.0,31.0,429,2.0,424
1184,618,201,6.664126984126984,8.986122448979591,5.0,22.0,429,2.0,417
1185,618,232,6.664126984126984,7.8251247165532885,5.0,31.0,389,1.0,386
1186,618,260,6.664126984126984,8.080544217687075,5.0,32.0,363,1.0,358
1187,618,231,6.664126984126984,9.009342403628118,5.0,16.0,400,2.0,387
1188,618,454,6.664126984126984,8.034104308390022,5.0,9.0,174,1.0,164
1189,626,185,12.469115646258503,14.605351473922903,15.0,24.0,450,2.0,441
1190,626,389,12.469115646258503,13.862312925170068,15.0,27.0,244,1.0,237
1191,626,242,12.469115646258503,14.628571428571428,15.0,27.0,395,2.0,384
1192,626,415,12.469115646258503,13.885532879818594,15.0,27.0,220,1.0,211
1193,626,457,12.469115646258503,14.582131519274377,15.0,26.0,192,2.0,169
1194,626,617,12.469115646258503,14.605351473922903,15.0,15.0,92,2.0,9
1195,626,630,12.469115646258503,15.27873015873016,15.0,15.0,121,3.0,4
1196,626,856,12.469115646258503,13.862312925170068,15.0,6.0,238,1.0,230
1197,617,185,13.212154195011339,14.605351473922903,15.0,24.0,436,1.0,432
1198,617,242,13.212154195011339,14.628571428571428,15.0,27.0,380,1.0,375
1199,617,389,13.212154195011339,15.975328798185942,15.0,26.0,257,3.0,228
1200,617,457,13.212154195011339,14.582131519274377,15.0,26.0,171,1.0,160
1201,617,457,13.212154195011339,15.975328798185942,15.0,27.0,199,3.0,160
1202,617,630,13.212154195011339,15.27873015873016,15.0,15.0,90,2.0,13
1203,617,152,14.605351473922903,16.973786848072564,15.0,24.0,476,2.0,465
1204,617,389,14.605351473922903,15.975328798185942,15.0,26.0,236,1.0,228
1205,617,225,14.605351473922903,16.857687074829933,15.0,26.0,404,2.0,392
1206,617,457,14.605351473922903,15.975328798185942,15.0,27.0,171,1.0,160
1207,617,415,14.605351473922903,16.69514739229025,15.0,26.0,221,2.0,202
1208,617,484,14.605351473922903,17.39174603174603,15.0,24.0,179,3.0,133
1209,617,630,14.605351473922903,16.69514739229025,15.0,15.0,91,2.0,13
1210,617,630,14.605351473922903,17.39174603174603,15.0,12.0,121,3.0,13
1211,630,152,15.27873015873016,16.973786848072564,15.0,24.0,484,2.0,478
1212,630,195,15.27873015873016,17.972244897959182,15.0,29.0,450,3.0,435
1213,630,225,15.27873015873016,16.857687074829933,15.0,26.0,411,2.0,405
1214,630,260,15.27873015873016,17.87936507936508,15.0,25.0,387,3.0,370
1215,630,259,15.27873015873016,18.018684807256236,15.0,28.0,389,3.0,371
1216,630,415,15.27873015873016,16.69514739229025,15.0,26.0,223,1.0,215
1217,630,484,15.27873015873016,17.39174603174603,15.0,24.0,172,2.0,146
1218,630,461,15.27873015873016,18.088344671201813,15.0,25.0,208,3.0,169
1219,630,195,16.69514739229025,17.972244897959182,15.0,29.0,438,1.0,435
1220,630,194,16.69514739229025,18.552743764172337,15.0,30.0,443,2.0,436
1221,630,146,16.69514739229025,19.43510204081633,15.0,24.0,498,3.0,484
1222,630,260,16.69514739229025,17.87936507936508,15.0,25.0,373,1.0,370
1223,630,259,16.69514739229025,18.018684807256236,15.0,28.0,375,1.0,371
1224,630,291,16.69514739229025,19.319002267573698,15.0,28.0,357,3.0,339
1225,630,461,16.69514739229025,18.088344671201813,15.0,25.0,179,1.0,169
1226,630,462,16.69514739229025,19.504761904761907,15.0,25.0,207,3.0,168
1227,630,617,16.69514739229025,18.808163265306124,15.0,14.0,92,2.0,13
1228,630,617,16.69514739229025,19.504761904761907,15.0,12.0,122,3.0,13
1229,630,194,17.39174603174603,18.552743764172337,12.0,30.0,439,1.0,436
1230,630,146,17.39174603174603,19.43510204081633,12.0,24.0,492,2.0,484
1231,630,291,17.39174603174603,19.319002267573698,12.0,28.0,349,2.0,339
1232,630,232,17.39174603174603,20.06204081632653,12.0,27.0,414,3.0,398
1233,630,462,17.39174603174603,19.504761904761907,12.0,25.0,191,2.0,168
1234,630,617,17.39174603174603,18.808163265306124,12.0,14.0,62,1.0,13
1235,630,617,17.39174603174603,19.504761904761907,12.0,12.0,92,2.0,13
1236,630,617,17.39174603174603,20.224580498866214,12.0,14.0,123,3.0,13
1237,617,195,18.808163265306124,20.712199546485262,14.0,24.0,430,2.0,422
1238,617,232,18.808163265306124,20.06204081632653,14.0,27.0,389,1.0,385
1239,617,461,18.808163265306124,20.89795918367347,14.0,26.0,180,2.0,156
1240,617,462,18.808163265306124,21.594557823129254,14.0,26.0,196,3.0,155
1241,617,637,18.808163265306124,21.61777777777778,14.0,13.0,123,3.0,20
1242,617,195,19.504761904761907,20.712199546485262,12.0,24.0,425,1.0,422
1243,617,232,19.504761904761907,21.873197278911565,12.0,24.0,398,2.0,385
1244,617,292,19.504761904761907,22.151836734693877,12.0,26.0,344,3.0,325
1245,617,461,19.504761904761907,20.89795918367347,12.0,26.0,167,1.0,156
1246,617,462,19.504761904761907,21.594557823129254,12.0,26.0,179,2.0,155
1247,617,415,19.504761904761907,22.31437641723356,12.0,24.0,235,3.0,202
1248,617,637,19.504761904761907,21.61777777777778,12.0,13.0,93,2.0,20
1249,617,232,20.224580498866214,21.873197278911565,14.0,24.0,391,2.0,385
1250,617,292,20.224580498866214,22.151836734693877,14.0,26.0,335,2.0,325
1251,617,409,20.224580498866214,23.034195011337868,14.0,24.0,241,3.0,208
1252,617,462,20.224580498866214,21.594557823129254,14.0,26.0,166,1.0,155
1253,617,415,20.224580498866214,22.31437641723356,14.0,24.0,221,2.0,202
1254,617,462,20.224580498866214,23.010975056689343,14.0,25.0,196,3.0,155
1255,617,637,20.224580498866214,21.61777777777778,14.0,13.0,63,1.0,20
1256,637,409,21.61777777777778,23.034195011337868,13.0,24.0,236,1.0,228
1257,637,232,21.61777777777778,24.380952380952383,13.0,27.0,422,3.0,405
1258,637,462,21.61777777777778,23.010975056689343,13.0,25.0,185,1.0,175
1259,637,462,21.61777777777778,24.404172335600908,13.0,25.0,212,3.0,175
1260,637,617,21.61777777777778,23.034195011337868,13.0,13.0,64,1.0,20
1261,637,617,21.61777777777778,24.427392290249433,13.0,12.0,123,3.0,20
1262,617,232,22.31437641723356,24.380952380952383,12.0,27.0,395,2.0,385
1263,617,292,22.31437641723356,25.007891156462584,12.0,24.0,345,3.0,325
1264,617,462,22.31437641723356,24.404172335600908,12.0,25.0,179,2.0,155
1265,617,461,22.31437641723356,25.10077097505669,12.0,25.0,197,3.0,156
1266,617,232,23.034195011337868,24.380952380952383,13.0,27.0,389,1.0,385
1267,617,292,23.034195011337868,25.007891156462584,13.0,24.0,336,2.0,325
1268,617,462,23.034195011337868,24.404172335600908,13.0,25.0,166,1.0,155
1269,617,461,23.034195011337868,25.10077097505669,13.0,25.0,180,2.0,156
1270,617,204,24.427392290249433,26.51718820861678,12.0,20.0,423,2.0,413
1271,617,260,24.427392290249433,26.05278911564626,12.0,25.0,364,2.0,357
1272,617,415,24.427392290249433,26.51718820861678,12.0,26.0,221,2.0,202
1273,617,461,24.427392290249433,27.213786848072562,12.0,28.0,197,3.0,156
1274,617,204,25.123990929705215,26.51718820861678,14.0,20.0,417,1.0,413
1275,617,152,25.123990929705215,27.654965986394558,14.0,20.0,478,3.0,465
1276,617,396,25.123990929705215,27.933605442176873,14.0,25.0,252,3.0,221
1277,617,415,25.123990929705215,26.51718820861678,14.0,26.0,211,1.0,202
1278,617,461,25.123990929705215,27.213786848072562,14.0,28.0,180,2.0,156
1279,617,152,26.51718820861678,27.654965986394558,14.0,20.0,468,1.0,465
1280,617,396,26.51718820861678,27.933605442176873,14.0,25.0,229,1.0,221
1281,617,265,26.51718820861678,28.328344671201815,14.0,29.0,361,2.0,352
1282,617,275,26.51718820861678,29.1178231292517,14.0,27.0,360,3.0,342
1283,617,497,26.51718820861678,28.583764172335602,14.0,25.0,149,2.0,120
1284,617,415,26.51718820861678,29.326802721088438,14.0,25.0,235,3.0,202
1285,617,615,26.51718820861678,28.560544217687074,14.0,12.0,88,2.0,2
1286,617,265,27.23700680272109,28.328344671201815,16.0,29.0,355,1.0,352
1287,617,275,27.23700680272109,29.1178231292517,16.0,27.0,351,2.0,342
1288,617,389,27.23700680272109,30.00018140589569,16.0,27.0,257,3.0,228
1289,617,497,27.23700680272109,28.583764172335602,16.0,25.0,133,1.0,120
1290,617,415,27.23700680272109,29.326802721088438,16.0,25.0,221,2.0,202
1291,617,415,27.23700680272109,30.02340136054422,16.0,27.0,235,3.0,202
1292,617,615,27.23700680272109,28.560544217687074,16.0,12.0,57,1.0,2
1293,617,856,27.23700680272109,30.00018140589569,16.0,6.0,267,3.0,239
1294,615,161,28.560544217687074,30.696780045351474,12.0,20.0,463,2.0,454
1295,615,389,28.560544217687074,30.00018140589569,12.0,27.0,234,1.0,226
1296,615,415,28.560544217687074,30.02340136054422,12.0,27.0,210,1.0,200
1297,615,457,28.560544217687074,31.41659863945578,12.0,26.0,200,3.0,158
1298,615,617,28.560544217687074,30.046621315192745,12.0,15.0,64,1.0,2
1299,615,630,28.560544217687074,31.41659863945578,12.0,14.0,124,3.0,15
1300,615,856,28.560544217687074,30.00018140589569,12.0,6.0,249,1.0,241
1301,617,161,29.350022675736962,30.696780045351474,14.0,20.0,460,1.0,456
1302,617,174,29.350022675736962,31.74167800453515,14.0,31.0,455,2.0,443
1303,617,282,29.350022675736962,31.67201814058957,14.0,32.0,350,2.0,335
1304,617,457,29.350022675736962,31.41659863945578,14.0,26.0,183,2.0,160
1305,617,415,29.350022675736962,32.13641723356009,14.0,26.0,235,3.0,202
1306,617,630,29.350022675736962,31.41659863945578,14.0,14.0,90,2.0,13
1307,617,852,29.350022675736962,32.08997732426304,14.0,6.0,263,3.0,235
1308,617,174,30.046621315192745,31.74167800453515,15.0,31.0,449,2.0,443
1309,617,282,30.046621315192745,31.67201814058957,15.0,32.0,342,2.0,335
1310,617,265,30.046621315192745,32.71691609977324,15.0,32.0,370,3.0,352
1311,617,457,30.046621315192745,31.41659863945578,15.0,26.0,171,1.0,160
1312,617,415,30.046621315192745,32.13641723356009,15.0,26.0,221,2.0,202
1313,617,630,30.046621315192745,31.41659863945578,15.0,14.0,60,1.0,13
1314,617,852,30.046621315192745,32.08997732426304,15.0,6.0,251,2.0,235
1315,630,195,31.41659863945578,33.9243537414966,14.0,35.0,448,3.0,435
1316,630,193,31.41659863945578,34.06367346938776,14.0,26.0,452,3.0,437
1317,630,265,31.41659863945578,32.71691609977324,14.0,32.0,369,1.0,365
1318,630,244,31.41659863945578,33.94757369614513,14.0,29.0,401,3.0,386
1319,630,260,31.41659863945578,34.11011337868481,14.0,33.0,388,3.0,370
1320,630,415,31.41659863945578,33.52961451247165,14.0,25.0,233,2.0,215
1321,630,617,31.41659863945578,32.8562358276644,14.0,14.0,63,1.0,13
1322,630,854,31.41659863945578,33.50639455782313,14.0,5.0,241,2.0,224
1323,617,195,32.8562358276644,33.9243537414966,14.0,35.0,424,1.0,422
1324,617,193,32.8562358276644,34.06367346938776,14.0,26.0,427,1.0,424
1325,617,244,32.8562358276644,33.94757369614513,14.0,29.0,376,1.0,373
1326,617,260,32.8562358276644,34.11011337868481,14.0,33.0,361,1.0,357
1327,617,279,32.8562358276644,35.27111111111111,14.0,27.0,354,2.0,338
1328,617,460,32.8562358276644,34.50485260770975,14.0,27.0,172,2.0,157
1329,617,415,32.8562358276644,35.64263038548753,14.0,25.0,235,3.0,202
1330,630,279,33.52961451247165,35.27111111111111,14.0,27.0,359,2.0,351
1331,630,415,33.52961451247165,35.64263038548753,14.0,25.0,233,2.0,215
1332,630,415,33.52961451247165,36.339229024943315,14.0,26.0,247,3.0,215
1333,630,617,33.52961451247165,34.969251700680275,14.0,14.0,63,1.0,13
1334,630,617,33.52961451247165,35.66585034013605,14.0,15.0,93,2.0,13
1335,630,617,33.52961451247165,36.36244897959184,14.0,15.0,123,3.0,13
1336,617,152,34.969251700680275,36.710748299319725,14.0,29.0,471,2.0,465
1337,617,192,34.969251700680275,37.105487528344675,14.0,27.0,435,2.0,425
1338,617,260,34.969251700680275,36.87328798185941,14.0,33.0,366,2.0,357
1339,617,249,34.969251700680275,37.05904761904762,14.0,27.0,379,2.0,368
1340,617,415,34.969251700680275,36.339229024943315,14.0,26.0,210,1.0,202
1341,617,488,34.969251700680275,37.73242630385488,14.0,25.0,176,3.0,129
1342,617,152,35.66585034013605,36.710748299319725,15.0,29.0,467,1.0,465
1343,617,192,35.66585034013605,37.105487528344675,15.0,27.0,429,1.0,425
1344,617,161,35.66585034013605,38.42902494331066,15.0,20.0,471,3.0,456
1345,617,260,35.66585034013605,36.87328798185941,15.0,33.0,361,1.0,357
1346,617,249,35.66585034013605,37.05904761904762,15.0,27.0,373,1.0,368
1347,617,389,35.66585034013605,38.42902494331066,15.0,27.0,257,3.0,228
1348,617,488,35.66585034013605,37.73242630385488,15.0,25.0,157,2.0,129
1349,617,461,35.66585034013605,38.42902494331066,15.0,26.0,196,3.0,156
1350,617,161,36.36244897959184,38.42902494331066,15.0,20.0,465,2.0,456
1351,617,389,36.36244897959184,38.42902494331066,15.0,27.0,245,2.0,228
1352,617,488,36.36244897959184,37.73242630385488,15.0,25.0,142,1.0,129
1353,617,461,36.36244897959184,38.42902494331066,15.0,26.0,180,2.0,156
1354,617,461,36.36244897959184,39.125623582766444,15.0,27.0,196,3.0,156
1355,617,161,37.05904761904762,38.42902494331066,15.0,20.0,460,1.0,456
1356,617,120,37.05904761904762,39.566802721088436,15.0,20.0,509,3.0,497
1357,617,389,37.05904761904762,38.42902494331066,15.0,27.0,236,1.0,228
1358,617,291,37.05904761904762,39.59002267573696,15.0,31.0,344,3.0,326
1359,617,461,37.05904761904762,38.42902494331066,15.0,26.0,167,1.0,156
1360,617,461,37.05904761904762,39.125623582766444,15.0,27.0,180,2.0,156
1361,617,825,37.05904761904762,39.86866213151927,15.0,6.0,241,3.0,208
1362,617,120,38.47546485260771,39.566802721088436,13.0,20.0,499,1.0,497
1363,617,170,38.47546485260771,41.23863945578231,13.0,20.0,463,3.0,447
1364,617,291,38.47546485260771,39.59002267573696,13.0,31.0,330,1.0,326
1365,617,270,38.47546485260771,40.30984126984127,13.0,31.0,356,2.0,347
1366,617,389,38.47546485260771,41.23863945578231,13.0,26.0,257,3.0,228
1367,617,465,38.47546485260771,40.170521541950116,13.0,26.0,169,2.0,152
1368,617,630,38.47546485260771,40.542040816326534,13.0,15.0,90,2.0,13
1369,617,625,38.47546485260771,41.26185941043084,13.0,15.0,120,3.0,8
1370,617,825,38.47546485260771,39.86866213151927,13.0,6.0,216,1.0,208
1371,617,170,39.172063492063494,41.23863945578231,15.0,20.0,456,2.0,447
1372,617,270,39.172063492063494,40.30984126984127,15.0,31.0,350,1.0,347
1373,617,389,39.172063492063494,41.23863945578231,15.0,26.0,245,2.0,228
1374,617,461,39.172063492063494,41.9352380952381,15.0,26.0,196,3.0,156
1375,617,630,39.172063492063494,40.542040816326534,15.0,15.0,60,1.0,13
1376,617,625,39.172063492063494,41.26185941043084,15.0,15.0,90,2.0,8
1377,630,197,40.542040816326534,42.32997732426304,15.0,32.0,440,2.0,433
1378,630,244,40.542040816326534,42.399637188208615,15.0,38.0,394,2.0,386
1379,630,461,40.542040816326534,41.9352380952381,15.0,26.0,179,1.0,169
1380,630,415,40.542040816326534,42.6550566893424,15.0,26.0,233,2.0,215
1381,630,617,40.542040816326534,42.678276643990934,15.0,16.0,93,2.0,13
1382,630,618,40.542040816326534,43.32843537414966,15.0,16.0,121,3.0,12
1383,630,843,40.542040816326534,43.30521541950113,15.0,8.0,244,3.0,213
1384,625,197,41.26185941043084,42.32997732426304,15.0,32.0,430,1.0,428
1385,625,144,41.26185941043084,43.932154195011336,15.0,27.0,495,3.0,481
1386,625,244,41.26185941043084,42.399637188208615,15.0,38.0,384,1.0,381
1387,625,265,41.26185941043084,43.932154195011336,15.0,30.0,378,3.0,360
1388,625,415,41.26185941043084,42.6550566893424,15.0,26.0,218,1.0,210
1389,625,464,41.26185941043084,43.83927437641724,15.0,28.0,196,3.0,161
1390,625,617,41.26185941043084,42.678276643990934,15.0,16.0,62,1.0,8
1391,625,618,41.26185941043084,43.32843537414966,15.0,16.0,89,2.0,7
1392,625,843,41.26185941043084,43.30521541950113,15.0,8.0,235,2.0,218
1393,617,144,42.678276643990934,43.932154195011336,16.0,27.0,476,1.0,473
1394,617,152,42.678276643990934,44.72163265306123,16.0,20.0,473,2.0,465
1395,617,265,42.678276643990934,43.932154195011336,16.0,30.0,356,1.0,352
1396,617,256,42.678276643990934,44.35011337868481,16.0,29.0,368,2.0,361
1397,617,464,42.678276643990934,43.83927437641724,16.0,28.0,161,1.0,153
1398,617,461,42.678276643990934,44.74485260770975,16.0,26.0,180,2.0,156
1399,617,461,42.678276643990934,45.44145124716553,16.0,25.0,196,3.0,156
1400,617,618,42.678276643990934,44.74485260770975,16.0,15.0,89,2.0,1
1401,617,848,42.678276643990934,45.41823129251701,16.0,7.0,259,3.0,231
1402,618,152,43.32843537414966,44.72163265306123,16.0,20.0,470,1.0,466
1403,618,194,43.32843537414966,45.7665306122449,16.0,28.0,437,2.0,424
1404,618,256,43.32843537414966,44.35011337868481,16.0,29.0,365,1.0,362
1405,618,217,43.32843537414966,45.72009070294785,16.0,31.0,414,2.0,401
1406,618,389,43.32843537414966,46.13804988662132,16.0,26.0,259,3.0,229
1407,618,461,43.32843537414966,44.74485260770975,16.0,26.0,168,1.0,157
1408,618,461,43.32843537414966,45.44145124716553,16.0,25.0,181,2.0,157
1409,618,457,43.32843537414966,46.16126984126984,16.0,28.0,202,3.0,161
1410,618,617,43.32843537414966,45.48789115646259,16.0,13.0,93,2.0,1
1411,618,617,43.32843537414966,46.18448979591837,16.0,14.0,123,3.0,1
1412,618,848,43.32843537414966,45.41823129251701,16.0,7.0,247,2.0,230
1413,618,194,44.74485260770975,45.7665306122449,15.0,28.0,426,1.0,424
1414,618,147,44.74485260770975,46.69532879818594,15.0,26.0,478,2.0,471
1415,618,389,44.74485260770975,46.13804988662132,15.0,26.0,237,1.0,229
1416,618,292,44.74485260770975,47.18294784580499,15.0,33.0,342,2.0,326
1417,618,457,44.74485260770975,46.16126984126984,15.0,28.0,172,1.0,161
1418,618,452,44.74485260770975,47.18294784580499,15.0,27.0,196,2.0,166
1419,618,617,44.74485260770975,46.18448979591837,15.0,14.0,62,1.0,1
1420,618,625,44.74485260770975,47.57768707482993,15.0,15.0,122,3.0,7
1421,618,821,44.74485260770975,46.46312925170068,15.0,6.0,216,2.0,203
1422,618,866,44.74485260770975,47.18294784580499,15.0,7.0,269,2.0,248
1423,617,147,45.48789115646259,46.69532879818594,13.0,26.0,473,1.0,470
1424,617,171,45.48789115646259,47.94920634920635,13.0,33.0,458,2.0,446
1425,617,174,45.48789115646259,48.01886621315193,13.0,32.0,456,3.0,443
1426,617,292,45.48789115646259,47.18294784580499,13.0,33.0,333,2.0,325
1427,617,260,45.48789115646259,48.18140589569161,13.0,35.0,375,3.0,357
1428,617,452,45.48789115646259,47.18294784580499,13.0,27.0,180,2.0,165
1429,617,625,45.48789115646259,47.57768707482993,13.0,15.0,90,2.0,8
1430,617,866,45.48789115646259,47.18294784580499,13.0,7.0,259,2.0,249
1431,617,171,46.18448979591837,47.94920634920635,14.0,33.0,452,2.0,446
1432,617,174,46.18448979591837,48.01886621315193,14.0,32.0,450,2.0,443
1433,617,260,46.18448979591837,48.18140589569161,14.0,35.0,367,2.0,357
1434,617,415,46.18448979591837,48.970884353741496,14.0,26.0,235,3.0,202
1435,617,625,46.18448979591837,47.57768707482993,14.0,15.0,61,1.0,8
1436,617,630,46.18448979591837,48.970884353741496,14.0,13.0,121,3.0,13
1437,625,170,47.57768707482993,49.64426303854875,15.0,17.0,464,2.0,455
1438,625,389,47.57768707482993,49.64426303854875,15.0,27.0,252,2.0,236
1439,625,389,47.57768707482993,50.36408163265306,15.0,26.0,265,3.0,236
1440,625,415,47.57768707482993,48.970884353741496,15.0,26.0,218,1.0,210
1441,625,427,47.57768707482993,49.66748299319728,15.0,25.0,217,2.0,198
1442,625,488,47.57768707482993,50.36408163265306,15.0,26.0,182,3.0,137
1443,625,630,47.57768707482993,48.970884353741496,15.0,13.0,60,1.0,5
1444,625,617,47.57768707482993,48.99410430839002,15.0,14.0,62,1.0,8
1445,625,617,47.57768707482993,50.387301587301586,15.0,14.0,121,3.0,8
1446,625,855,47.57768707482993,49.64426303854875,15.0,5.0,247,2.0,230
1447,630,194,48.970884353741496,51.85015873015873,13.0,25.0,453,3.0,436
1448,630,389,48.970884353741496,50.36408163265306,13.0,26.0,248,1.0,241
1449,630,276,48.970884353741496,51.38575963718821,13.0,25.0,369,2.0,354
1450,630,488,48.970884353741496,50.36408163265306,13.0,26.0,154,1.0,142
1451,630,482,48.970884353741496,51.68761904761905,13.0,26.0,189,3.0,148
1452,630,617,48.970884353741496,50.387301587301586,13.0,14.0,62,1.0,13
1453,630,615,48.970884353741496,51.66439909297052,13.0,16.0,117,3.0,15
1454,630,856,48.970884353741496,51.7340589569161,13.0,10.0,255,3.0,226
1455,617,194,48.99410430839002,51.85015873015873,14.0,25.0,441,3.0,423
1456,617,389,48.99410430839002,50.36408163265306,14.0,26.0,236,1.0,228
1457,617,276,48.99410430839002,51.38575963718821,14.0,25.0,356,2.0,341
1458,617,488,48.99410430839002,50.36408163265306,14.0,26.0,142,1.0,129
1459,617,482,48.99410430839002,51.68761904761905,14.0,26.0,178,3.0,135
1460,617,615,48.99410430839002,51.66439909297052,14.0,16.0,115,3.0,2
1461,617,856,48.99410430839002,51.7340589569161,14.0,10.0,267,3.0,239
1462,617,194,50.387301587301586,51.85015873015873,14.0,25.0,428,1.0,423
1463,617,203,50.387301587301586,52.198458049886625,14.0,32.0,421,2.0,414
1464,617,171,50.387301587301586,53.080816326530616,14.0,30.0,461,3.0,446
1465,617,225,50.387301587301586,52.38421768707483,14.0,35.0,401,2.0,392
1466,617,482,50.387301587301586,51.68761904761905,14.0,26.0,146,1.0,135
1467,617,484,50.387301587301586,52.47709750566894,14.0,26.0,161,2.0,133
1468,617,615,50.387301587301586,51.66439909297052,14.0,16.0,55,1.0,2
1469,617,856,50.387301587301586,51.7340589569161,14.0,10.0,246,1.0,239
1470,617,827,50.387301587301586,52.05913832199547,14.0,8.0,222,2.0,210
1471,615,171,51.66439909297052,53.080816326530616,16.0,30.0,448,1.0,444
1472,615,194,51.66439909297052,53.98639455782313,16.0,24.0,433,2.0,421
1473,615,261,51.66439909297052,53.84707482993198,16.0,33.0,366,2.0,354
1474,615,230,51.66439909297052,53.98639455782313,16.0,29.0,398,2.0,385
1475,615,485,51.66439909297052,53.68453514739229,16.0,27.0,156,2.0,130
1476,615,415,51.66439909297052,54.590113378684805,16.0,25.0,236,3.0,200
1477,615,617,51.66439909297052,53.19691609977324,16.0,13.0,66,2.0,2
1478,615,618,51.66439909297052,54.56689342403628,16.0,13.0,125,3.0,3
1479,615,849,51.66439909297052,53.84707482993198,16.0,6.0,252,2.0,234
1480,617,194,52.50031746031746,53.98639455782313,14.0,24.0,428,1.0,423
1481,617,261,52.50031746031746,53.84707482993198,14.0,33.0,361,1.0,356
1482,617,230,52.50031746031746,53.98639455782313,14.0,29.0,392,1.0,387
1483,617,286,52.50031746031746,54.984852607709755,14.0,31.0,348,2.0,331
1484,617,485,52.50031746031746,53.68453514739229,14.0,27.0,142,1.0,132
1485,617,415,52.50031746031746,54.590113378684805,14.0,25.0,221,2.0,202
1486,617,618,52.50031746031746,54.56689342403628,14.0,13.0,89,2.0,1
1487,617,637,52.50031746031746,55.309931972789116,14.0,12.0,123,3.0,20
1488,617,849,52.50031746031746,53.84707482993198,14.0,6.0,239,1.0,232
1489,617,286,53.19691609977324,54.984852607709755,13.0,31.0,340,2.0,331
1490,617,415,53.19691609977324,54.590113378684805,13.0,25.0,211,1.0,202
1491,617,491,53.19691609977324,55.797551020408164,13.0,25.0,169,3.0,126
1492,617,618,53.19691609977324,54.56689342403628,13.0,13.0,59,1.0,1
1493,617,637,53.19691609977324,55.309931972789116,13.0,12.0,93,2.0,20
1494,617,843,53.19691609977324,55.77433106575964,13.0,7.0,252,3.0,226
1495,618,196,54.56689342403628,56.65668934240363,13.0,31.0,431,2.0,422
1496,618,228,54.56689342403628,56.65668934240363,13.0,34.0,400,2.0,390
1497,618,491,54.56689342403628,55.797551020408164,13.0,25.0,138,1.0,127
1498,618,422,54.56689342403628,56.401269841269844,13.0,26.0,211,2.0,196
1499,618,488,54.56689342403628,57.376507936507934,13.0,25.0,178,3.0,130
1500,618,617,54.56689342403628,56.0065306122449,13.0,13.0,62,1.0,1
1501,618,843,54.56689342403628,55.77433106575964,13.0,7.0,231,1.0,225
1502,637,196,55.309931972789116,56.65668934240363,12.0,31.0,445,1.0,441
1503,637,197,55.309931972789116,57.95700680272109,12.0,29.0,455,3.0,440
1504,637,228,55.309931972789116,56.65668934240363,12.0,34.0,413,1.0,409
1505,637,258,55.309931972789116,57.95700680272109,12.0,30.0,396,3.0,379
1506,637,258,55.309931972789116,57.980226757369614,12.0,37.0,396,3.0,379
1507,637,422,55.309931972789116,56.401269841269844,12.0,26.0,220,1.0,215
1508,637,488,55.309931972789116,57.376507936507934,12.0,25.0,174,2.0,149
1509,637,420,55.309931972789116,58.00344671201814,12.0,24.0,246,3.0,217
1510,637,618,55.309931972789116,57.376507936507934,12.0,13.0,91,2.0,19
1511,637,617,55.309931972789116,58.11954648526077,12.0,13.0,123,3.0,20
1512,637,826,55.309931972789116,57.88734693877551,12.0,9.0,219,3.0,189
1513,617,197,56.0065306122449,57.95700680272109,13.0,29.0,428,2.0,420
1514,617,194,56.0065306122449,58.30530612244898,13.0,31.0,434,2.0,423
1515,617,258,56.0065306122449,57.95700680272109,13.0,30.0,369,2.0,359
1516,617,258,56.0065306122449,57.980226757369614,13.0,37.0,369,2.0,359
1517,617,488,56.0065306122449,57.376507936507934,13.0,25.0,142,1.0,129
1518,617,420,56.0065306122449,58.00344671201814,13.0,24.0,215,2.0,197
1519,617,618,56.0065306122449,57.376507936507934,13.0,13.0,59,1.0,1
1520,617,826,56.0065306122449,57.88734693877551,13.0,9.0,224,2.0,209
1521,617,845,56.0065306122449,58.653605442176875,13.0,7.0,255,3.0,228
1522,618,231,57.376507936507934,59.2108843537415,13.0,40.0,395,2.0,387
1523,618,541,57.376507936507934,59.512743764172335,13.0,23.0,120,2.0,77
1524,618,625,57.376507936507934,59.512743764172335,13.0,11.0,92,2.0,7
1525,618,845,57.376507936507934,58.653605442176875,13.0,7.0,234,1.0,227
1526,617,231,58.11954648526077,59.2108843537415,13.0,40.0,389,1.0,386
1527,617,541,58.11954648526077,59.512743764172335,13.0,23.0,97,1.0,76
1528,617,625,58.11954648526077,59.512743764172335,13.0,11.0,61,1.0,8
1529,856,389,13.862312925170068,15.975328798185942,6.0,26.0,476,2.0,467
1530,856,457,13.862312925170068,15.975328798185942,6.0,27.0,409,2.0,399
1531,856,415,13.862312925170068,16.69514739229025,6.0,26.0,458,3.0,441
1532,856,630,13.862312925170068,15.27873015873016,6.0,15.0,234,1.0,226
1533,856,630,13.862312925170068,16.69514739229025,6.0,15.0,257,3.0,226
1534,856,457,30.00018140589569,31.41659863945578,6.0,26.0,404,1.0,399
1535,856,415,30.00018140589569,32.13641723356009,6.0,26.0,450,2.0,441
1536,856,630,30.00018140589569,31.41659863945578,6.0,14.0,234,1.0,226
1537,856,617,30.00018140589569,32.8562358276644,6.0,14.0,269,3.0,239
1538,856,852,30.00018140589569,32.08997732426304,6.0,6.0,90,2.0,4
1539,852,415,32.08997732426304,33.52961451247165,6.0,25.0,441,1.0,437
1540,852,460,32.08997732426304,34.50485260770975,6.0,27.0,406,2.0,392
1541,852,630,32.08997732426304,33.52961451247165,6.0,14.0,230,1.0,222
1542,852,617,32.08997732426304,34.969251700680275,6.0,14.0,266,3.0,235
1543,852,854,32.08997732426304,33.50639455782313,6.0,5.0,61,1.0,2
1544,854,415,33.50639455782313,35.64263038548753,5.0,25.0,449,2.0,439
1545,854,415,33.50639455782313,36.339229024943315,5.0,26.0,456,3.0,439
1546,854,617,33.50639455782313,34.969251700680275,5.0,14.0,245,1.0,237
1547,854,617,33.50639455782313,35.66585034013605,5.0,15.0,255,2.0,237
1548,854,617,33.50639455782313,36.36244897959184,5.0,15.0,267,3.0,237
1549,825,389,39.86866213151927,41.23863945578231,6.0,26.0,440,1.0,436
1550,825,461,39.86866213151927,41.9352380952381,6.0,26.0,375,2.0,364
1551,825,415,39.86866213151927,42.6550566893424,6.0,26.0,427,3.0,410
1552,825,625,39.86866213151927,41.26185941043084,6.0,15.0,209,1.0,200
1553,825,617,39.86866213151927,42.678276643990934,6.0,16.0,241,3.0,208
1554,843,389,43.30521541950113,46.13804988662132,8.0,26.0,470,3.0,454
1555,843,461,43.30521541950113,44.74485260770975,8.0,26.0,387,1.0,382
1556,843,461,43.30521541950113,45.44145124716553,8.0,25.0,393,2.0,382
1557,843,457,43.30521541950113,46.16126984126984,8.0,28.0,405,3.0,386
1558,843,618,43.30521541950113,44.74485260770975,8.0,15.0,233,1.0,225
1559,843,617,43.30521541950113,45.48789115646259,8.0,13.0,245,2.0,226
1560,843,617,43.30521541950113,46.18448979591837,8.0,14.0,258,3.0,226
1561,843,848,43.30521541950113,45.41823129251701,8.0,7.0,91,2.0,5
1562,848,452,45.41823129251701,47.18294784580499,7.0,27.0,403,2.0,396
1563,848,625,45.41823129251701,47.57768707482993,7.0,15.0,242,2.0,223
1564,848,821,45.41823129251701,46.46312925170068,7.0,6.0,52,1.0,27
1565,848,866,45.41823129251701,47.18294784580499,7.0,7.0,78,2.0,18
1566,821,415,46.46312925170068,48.970884353741496,6.0,26.0,420,3.0,406
1567,821,625,46.46312925170068,47.57768707482993,6.0,15.0,202,1.0,196
1568,821,630,46.46312925170068,48.970884353741496,6.0,13.0,219,3.0,191
1569,821,617,46.46312925170068,48.99410430839002,6.0,14.0,231,3.0,204
1570,866,389,47.18294784580499,49.64426303854875,7.0,27.0,489,2.0,477
1571,866,415,47.18294784580499,48.970884353741496,7.0,26.0,458,2.0,451
1572,866,427,47.18294784580499,49.66748299319728,7.0,25.0,452,2.0,439
1573,866,630,47.18294784580499,48.970884353741496,7.0,13.0,248,2.0,236
1574,866,617,47.18294784580499,48.99410430839002,7.0,14.0,261,2.0,249
1575,866,855,47.18294784580499,49.64426303854875,7.0,5.0,107,2.0,11
1576,855,482,49.64426303854875,51.68761904761905,5.0,26.0,383,2.0,373
1577,855,484,49.64426303854875,52.47709750566894,5.0,26.0,391,3.0,371
1578,855,615,49.64426303854875,51.66439909297052,5.0,16.0,255,2.0,240
1579,855,617,49.64426303854875,52.50031746031746,5.0,14.0,268,3.0,238
1580,855,856,49.64426303854875,51.7340589569161,5.0,10.0,90,2.0,1
1581,855,827,49.64426303854875,52.05913832199547,5.0,8.0,108,2.0,28
1582,856,485,51.7340589569161,53.68453514739229,10.0,27.0,380,2.0,371
1583,856,415,51.7340589569161,54.590113378684805,10.0,25.0,458,3.0,441
1584,856,617,51.7340589569161,53.19691609977324,10.0,13.0,247,1.0,239
1585,856,618,51.7340589569161,54.56689342403628,10.0,13.0,267,3.0,238
1586,856,849,51.7340589569161,53.84707482993198,10.0,6.0,91,2.0,7
1587,827,485,52.05913832199547,53.68453514739229,8.0,27.0,349,2.0,342
1588,827,415,52.05913832199547,54.590113378684805,8.0,25.0,426,3.0,412
1589,827,617,52.05913832199547,53.19691609977324,8.0,13.0,216,1.0,210
1590,827,618,52.05913832199547,54.56689342403628,8.0,13.0,235,3.0,209
1591,827,849,52.05913832199547,53.84707482993198,8.0,6.0,80,2.0,22
1592,849,491,53.84707482993198,55.797551020408164,6.0,25.0,368,2.0,358
1593,849,422,53.84707482993198,56.401269841269844,6.0,26.0,441,3.0,427
1594,849,637,53.84707482993198,55.309931972789116,6.0,12.0,221,1.0,212
1595,849,617,53.84707482993198,56.0065306122449,6.0,13.0,250,2.0,232
1596,849,843,53.84707482993198,55.77433106575964,6.0,7.0,83,2.0,6
1597,843,488,55.77433106575964,57.376507936507934,7.0,25.0,362,2.0,355
1598,843,420,55.77433106575964,58.00344671201814,7.0,24.0,434,2.0,423
1599,843,618,55.77433106575964,57.376507936507934,7.0,13.0,235,2.0,225
1600,843,617,55.77433106575964,58.11954648526077,7.0,13.0,248,2.0,226
1601,843,826,55.77433106575964,57.88734693877551,7.0,9.0,93,2.0,17
1602,843,845,55.77433106575964,58.653605442176875,7.0,7.0,124,3.0,2
1603,826,541,57.88734693877551,59.512743764172335,9.0,23.0,293,2.0,285
1604,826,625,57.88734693877551,59.512743764172335,9.0,11.0,213,2.0,201
