,f0,f1,t0,t1,dB0,dB1,dist,utime,ufreq
0,6,200,0.9520181405895691,2.066575963718821,4.0,25.0,200,1.0,194
1,6,89,0.9520181405895691,3.6687528344671203,4.0,19.0,143,3.0,83
2,6,214,0.9520181405895691,2.1362358276643993,4.0,32.0,214,1.0,208
3,6,248,0.9520181405895691,3.320453514739229,4.0,22.0,263,2.0,242
4,194,89,1.7647165532879818,3.6687528344671203,27.0,19.0,133,2.0,105
5,194,248,1.7647165532879818,3.320453514739229,27.0,22.0,86,2.0,54
6,194,596,1.7647165532879818,3.3436734693877552,27.0,6.0,408,2.0,402
7,194,474,1.7647165532879818,4.4117913832199545,27.0,14.0,302,3.0,280
8,194,619,1.7647165532879818,3.2275736961451247,27.0,4.0,430,1.0,425
9,194,655,1.7647165532879818,4.388571428571429,27.0,14.0,475,3.0,461
10,200,89,2.066575963718821,3.6687528344671203,25.0,19.0,131,2.0,111
11,200,69,2.066575963718821,4.899410430839002,25.0,30.0,179,3.0,131
12,200,248,2.066575963718821,3.320453514739229,25.0,22.0,72,1.0,48
13,200,261,2.066575963718821,4.85297052154195,25.0,21.0,135,3.0,61
14,200,596,2.066575963718821,3.3436734693877552,25.0,6.0,400,1.0,396
15,200,474,2.066575963718821,4.4117913832199545,25.0,14.0,292,2.0,274
16,200,619,2.066575963718821,3.2275736961451247,25.0,4.0,422,1.0,419
17,200,655,2.066575963718821,4.388571428571429,25.0,14.0,466,2.0,455
18,200,616,2.066575963718821,4.992290249433107,25.0,13.0,435,3.0,416
19,89,69,3.6687528344671203,4.899410430839002,19.0,30.0,57,1.0,20
20,89,73,3.6687528344671203,5.944308390022676,19.0,33.0,99,2.0,16
21,89,73,3.6687528344671203,6.339047619047619,19.0,30.0,116,3.0,16
22,89,261,3.6687528344671203,4.85297052154195,19.0,21.0,179,1.0,172
23,89,247,3.6687528344671203,5.294149659863946,19.0,31.0,173,2.0,158
24,89,278,3.6687528344671203,6.431927437641724,19.0,24.0,223,3.0,189
25,89,585,3.6687528344671203,6.315827664399093,19.0,10.0,509,3.0,496
26,69,73,4.899410430839002,5.944308390022676,30.0,33.0,45,1.0,4
27,69,73,4.899410430839002,6.339047619047619,30.0,30.0,62,1.0,4
28,69,73,4.899410430839002,7.337505668934241,30.0,32.0,105,2.0,4
29,69,278,4.899410430839002,6.431927437641724,30.0,24.0,219,2.0,209
30,69,221,4.899410430839002,7.291065759637188,30.0,21.0,184,2.0,152
31,69,463,4.899410430839002,7.267845804988662,30.0,3.0,407,2.0,394
32,73,65,5.944308390022676,8.916462585034013,33.0,38.0,128,3.0,8
33,73,221,5.944308390022676,7.291065759637188,33.0,21.0,159,1.0,148
34,73,246,5.944308390022676,8.452063492063493,33.0,32.0,204,3.0,173
35,73,463,5.944308390022676,7.267845804988662,33.0,3.0,394,1.0,390
36,73,65,6.339047619047619,8.916462585034013,30.0,38.0,111,3.0,8
37,73,246,6.339047619047619,8.452063492063493,30.0,32.0,195,2.0,173
38,73,65,7.337505668934241,8.916462585034013,32.0,38.0,68,2.0,8
39,73,64,7.337505668934241,9.404081632653062,32.0,39.0,89,2.0,9
40,73,246,7.337505668934241,8.452063492063493,32.0,32.0,180,1.0,173
41,73,230,7.337505668934241,9.7059410430839,32.0,21.0,187,2.0,157
42,65,64,8.916462585034013,10.495419501133787,38.0,40.0,68,2.0,1
43,65,163,8.916462585034013,10.983038548752834,38.0,37.0,132,2.0,98
44,65,260,8.916462585034013,10.936598639455783,38.0,37.0,214,2.0,195
45,65,213,8.916462585034013,11.609977324263038,38.0,36.0,188,3.0,148
46,65,487,8.916462585034013,10.936598639455783,38.0,19.0,431,2.0,422
47,64,163,9.404081632653062,10.983038548752834,39.0,37.0,120,2.0,99
48,64,162,9.404081632653062,12.213696145124716,39.0,35.0,156,3.0,98
49,64,260,9.404081632653062,10.936598639455783,39.0,37.0,207,2.0,196
50,64,213,9.404081632653062,11.609977324263038,39.0,36.0,177,2.0,149
51,64,487,9.404081632653062,10.936598639455783,39.0,19.0,428,2.0,423
52,64,162,10.495419501133787,12.213696145124716,40.0,35.0,123,2.0,98
53,64,62,10.495419501133787,13.374693877551021,40.0,29.0,124,3.0,2
54,64,213,10.495419501133787,11.609977324263038,40.0,36.0,157,1.0,149
55,64,268,10.495419501133787,12.60843537414966,40.0,21.0,223,2.0,204
56,64,265,10.495419501133787,13.119274376417234,40.0,20.0,231,3.0,201
57,64,546,10.495419501133787,13.421133786848072,40.0,3.0,498,3.0,482
58,163,162,10.983038548752834,12.213696145124716,37.0,35.0,53,1.0,1
59,163,62,10.983038548752834,13.374693877551021,37.0,29.0,144,2.0,101
60,163,268,10.983038548752834,12.60843537414966,37.0,21.0,126,2.0,105
61,163,265,10.983038548752834,13.119274376417234,37.0,20.0,137,2.0,102
62,163,600,10.983038548752834,12.445895691609978,37.0,22.0,442,1.0,437
63,163,546,10.983038548752834,13.421133786848072,37.0,3.0,397,2.0,383
64,163,621,10.983038548752834,12.213696145124716,37.0,21.0,461,1.0,458
65,162,62,12.213696145124716,13.374693877551021,35.0,29.0,112,1.0,100
66,162,204,12.213696145124716,14.930430839002268,35.0,29.0,124,3.0,42
67,162,213,12.213696145124716,14.97687074829932,35.0,40.0,129,3.0,51
68,162,213,12.213696145124716,15.000090702947846,35.0,35.0,130,3.0,51
69,162,546,12.213696145124716,13.421133786848072,35.0,3.0,388,1.0,384
70,162,597,12.213696145124716,14.930430839002268,35.0,17.0,450,3.0,435
71,62,204,13.374693877551021,14.930430839002268,29.0,29.0,157,2.0,142
72,62,162,13.374693877551021,15.39482993197279,29.0,33.0,133,2.0,100
73,62,213,13.374693877551021,14.97687074829932,29.0,40.0,166,2.0,151
74,62,213,13.374693877551021,15.000090702947846,29.0,35.0,166,2.0,151
75,204,162,14.930430839002268,16.950566893424035,29.0,30.0,97,2.0,42
76,204,183,14.930430839002268,17.60072562358277,29.0,36.0,117,3.0,21
77,204,240,14.930430839002268,16.50938775510204,29.0,29.0,77,2.0,36
78,204,614,14.930430839002268,16.46294784580499,29.0,23.0,415,2.0,410
79,204,604,14.930430839002268,17.716825396825396,29.0,18.0,418,3.0,400
80,204,615,14.930430839002268,16.46294784580499,29.0,24.0,416,2.0,411
81,204,622,14.930430839002268,17.020226757369613,29.0,17.0,428,2.0,418
82,162,183,15.39482993197279,17.60072562358277,33.0,36.0,97,2.0,21
83,162,240,15.39482993197279,16.50938775510204,33.0,29.0,92,1.0,78
84,162,255,15.39482993197279,17.949024943310658,33.0,31.0,144,3.0,93
85,162,257,15.39482993197279,17.99546485260771,33.0,28.0,147,3.0,95
86,162,614,15.39482993197279,16.46294784580499,33.0,23.0,454,1.0,452
87,162,604,15.39482993197279,17.716825396825396,33.0,18.0,453,2.0,442
88,162,611,15.39482993197279,17.99546485260771,33.0,13.0,463,3.0,449
89,162,615,15.39482993197279,16.46294784580499,33.0,24.0,455,1.0,453
90,162,622,15.39482993197279,17.020226757369613,33.0,17.0,465,2.0,460
91,162,74,16.950566893424035,18.52952380952381,30.0,35.0,111,2.0,88
92,162,164,16.950566893424035,19.272562358276645,30.0,20.0,100,2.0,2
93,162,257,16.950566893424035,17.99546485260771,30.0,28.0,105,1.0,95
94,162,264,16.950566893424035,19.29578231292517,30.0,19.0,144,2.0,102
95,162,611,16.950566893424035,17.99546485260771,30.0,13.0,451,1.0,449
96,162,440,16.950566893424035,19.272562358276645,30.0,10.0,295,2.0,278
97,183,164,17.60072562358277,19.272562358276645,36.0,20.0,74,2.0,19
98,183,264,17.60072562358277,19.29578231292517,36.0,19.0,109,2.0,81
99,183,232,17.60072562358277,20.572879818594103,36.0,34.0,137,3.0,49
100,183,440,17.60072562358277,19.272562358276645,36.0,10.0,267,2.0,257
101,74,183,18.52952380952381,20.805079365079365,35.0,29.0,147,2.0,109
102,74,232,18.52952380952381,20.572879818594103,35.0,34.0,181,2.0,158
103,74,550,18.52952380952381,20.805079365079365,35.0,11.0,486,2.0,476
104,164,183,19.272562358276645,20.805079365079365,20.0,29.0,69,2.0,19
105,164,81,19.272562358276645,21.61777777777778,20.0,35.0,131,2.0,83
106,164,232,19.272562358276645,20.572879818594103,20.0,34.0,88,1.0,68
107,164,291,19.272562358276645,21.89641723356009,20.0,13.0,170,3.0,127
108,164,550,19.272562358276645,20.805079365079365,20.0,11.0,392,2.0,386
109,164,605,19.272562358276645,21.106938775510205,20.0,21.0,448,2.0,441
110,183,22,20.805079365079365,22.918095238095237,29.0,28.0,185,2.0,161
111,183,64,20.805079365079365,23.289614512471655,29.0,36.0,160,2.0,119
112,183,291,20.805079365079365,21.89641723356009,29.0,13.0,118,1.0,108
113,183,228,20.805079365079365,22.871655328798187,29.0,28.0,100,2.0,45
114,183,255,20.805079365079365,23.26639455782313,29.0,34.0,128,2.0,72
115,183,461,20.805079365079365,22.80199546485261,29.0,26.0,291,2.0,278
116,183,421,20.805079365079365,23.26639455782313,29.0,8.0,261,2.0,238
117,183,615,20.805079365079365,22.80199546485261,29.0,20.0,440,2.0,432
118,183,622,20.805079365079365,23.312834467120183,29.0,11.0,452,3.0,439
119,81,22,21.61777777777778,22.918095238095237,35.0,28.0,81,1.0,59
120,81,64,21.61777777777778,23.289614512471655,35.0,36.0,74,2.0,17
121,81,228,21.61777777777778,22.871655328798187,35.0,28.0,157,1.0,147
122,81,255,21.61777777777778,23.26639455782313,35.0,34.0,188,2.0,174
123,81,242,21.61777777777778,23.986213151927437,35.0,28.0,191,2.0,161
124,81,461,21.61777777777778,22.80199546485261,35.0,26.0,383,1.0,380
125,81,421,21.61777777777778,23.26639455782313,35.0,8.0,347,2.0,340
126,22,64,22.918095238095237,24.68281179138322,28.0,32.0,87,2.0,42
127,22,64,22.918095238095237,25.054331065759637,28.0,33.0,101,2.0,42
128,22,242,22.918095238095237,23.986213151927437,28.0,28.0,225,1.0,220
129,22,228,22.918095238095237,25.58839002267574,28.0,24.0,236,3.0,206
130,64,228,23.289614512471655,25.58839002267574,36.0,24.0,192,2.0,164
131,64,32,24.68281179138322,26.563628117913833,32.0,23.0,87,2.0,32
132,64,66,24.68281179138322,27.190566893424037,32.0,35.0,108,3.0,2
133,64,244,24.68281179138322,26.377868480725624,32.0,19.0,194,2.0,180
134,64,236,24.68281179138322,27.16734693877551,32.0,32.0,203,2.0,172
135,64,490,24.68281179138322,26.911927437641722,32.0,-4.0,437,2.0,426
136,64,32,25.054331065759637,26.563628117913833,33.0,23.0,72,2.0,32
137,64,66,25.054331065759637,27.190566893424037,33.0,35.0,92,2.0,2
138,64,244,25.054331065759637,26.377868480725624,33.0,19.0,189,1.0,180
139,64,236,25.054331065759637,27.16734693877551,33.0,32.0,195,2.0,172
140,64,246,25.054331065759637,28.026485260770976,33.0,24.0,223,3.0,182
141,64,490,25.054331065759637,26.911927437641722,33.0,-4.0,433,2.0,426
142,32,102,26.563628117913833,28.699863945578233,23.0,16.0,116,2.0,70
143,32,246,26.563628117913833,28.026485260770976,23.0,24.0,223,1.0,214
144,66,102,27.190566893424037,28.699863945578233,35.0,16.0,74,2.0,36
145,66,164,27.190566893424037,29.675102040816327,35.0,15.0,145,2.0,98
146,66,32,27.190566893424037,30.046621315192745,35.0,25.0,128,3.0,34
147,66,234,27.190566893424037,29.675102040816327,35.0,6.0,199,2.0,168
148,102,32,28.699863945578233,30.046621315192745,16.0,25.0,91,1.0,70
149,102,182,28.699863945578233,31.62557823129252,16.0,22.0,149,3.0,80
150,102,213,28.699863945578233,30.65034013605442,16.0,24.0,139,2.0,111
151,102,236,28.699863945578233,31.37015873015873,16.0,26.0,177,3.0,134
152,164,182,29.675102040816327,31.62557823129252,15.0,22.0,86,2.0,18
153,164,202,29.675102040816327,32.113197278911564,15.0,17.0,112,2.0,38
154,164,236,29.675102040816327,31.37015873015873,15.0,26.0,103,2.0,72
155,164,213,29.675102040816327,32.08997732426304,15.0,22.0,115,2.0,49
156,164,517,29.675102040816327,31.71845804988662,15.0,6.0,364,2.0,353
157,164,608,29.675102040816327,32.113197278911564,15.0,26.0,456,2.0,444
158,164,623,29.675102040816327,32.113197278911564,15.0,29.0,471,2.0,459
159,32,182,30.046621315192745,31.62557823129252,25.0,22.0,165,2.0,150
160,32,202,30.046621315192745,32.113197278911564,25.0,17.0,192,2.0,170
161,32,236,30.046621315192745,31.37015873015873,25.0,26.0,212,1.0,204
162,32,213,30.046621315192745,32.08997732426304,25.0,22.0,201,2.0,181
163,32,517,30.046621315192745,31.71845804988662,25.0,6.0,490,2.0,485
164,182,31,31.62557823129252,33.78503401360544,22.0,18.0,177,2.0,151
165,182,236,31.62557823129252,33.715374149659866,22.0,25.0,105,2.0,54
166,182,258,31.62557823129252,34.57451247165533,22.0,34.0,148,3.0,76
167,182,608,31.62557823129252,33.69215419501134,22.0,23.0,435,2.0,426
168,182,537,31.62557823129252,34.57451247165533,22.0,11.0,377,3.0,355
169,182,625,31.62557823129252,33.69215419501134,22.0,20.0,452,2.0,443
170,202,31,32.113197278911564,33.78503401360544,17.0,18.0,186,2.0,171
171,202,195,32.113197278911564,34.80671201814059,17.0,30.0,116,3.0,7
172,202,236,32.113197278911564,33.715374149659866,17.0,25.0,77,2.0,34
173,202,258,32.113197278911564,34.57451247165533,17.0,34.0,120,2.0,56
174,202,208,32.113197278911564,35.03891156462585,17.0,32.0,126,3.0,6
175,202,608,32.113197278911564,33.69215419501134,17.0,23.0,412,2.0,406
176,202,537,32.113197278911564,34.57451247165533,17.0,11.0,351,2.0,335
177,202,625,32.113197278911564,33.69215419501134,17.0,20.0,428,2.0,423
178,202,669,32.113197278911564,34.76027210884354,17.0,8.0,481,3.0,467
179,31,195,33.78503401360544,34.80671201814059,18.0,30.0,170,1.0,164
180,31,29,33.78503401360544,35.43365079365079,18.0,28.0,71,2.0,2
181,31,208,33.78503401360544,35.03891156462585,18.0,32.0,185,1.0,177
182,31,237,33.78503401360544,36.52498866213152,18.0,29.0,237,3.0,206
183,195,64,34.80671201814059,36.91972789115646,30.0,43.0,160,2.0,131
184,195,63,34.80671201814059,36.989387755102044,30.0,33.0,162,2.0,132
185,195,237,34.80671201814059,36.52498866213152,30.0,29.0,85,2.0,42
186,195,214,34.80671201814059,37.77886621315193,30.0,31.0,129,3.0,19
187,195,614,34.80671201814059,36.91972789115646,30.0,29.0,429,2.0,419
188,195,601,34.80671201814059,36.989387755102044,30.0,13.0,417,2.0,406
189,195,616,34.80671201814059,36.91972789115646,30.0,29.0,431,2.0,421
190,29,64,35.43365079365079,36.91972789115646,28.0,43.0,73,1.0,35
191,29,63,35.43365079365079,36.989387755102044,28.0,33.0,75,2.0,34
192,29,237,35.43365079365079,36.52498866213152,28.0,29.0,213,1.0,208
193,29,214,35.43365079365079,37.77886621315193,28.0,31.0,211,2.0,185
194,29,271,35.43365079365079,37.987845804988666,28.0,18.0,266,3.0,242
195,64,63,36.91972789115646,38.568344671201814,43.0,34.0,71,2.0,1
196,64,164,36.91972789115646,39.450702947845805,43.0,12.0,148,3.0,100
197,64,271,36.91972789115646,37.987845804988666,43.0,18.0,212,1.0,207
198,64,233,36.91972789115646,39.42748299319728,43.0,12.0,201,3.0,169
199,64,467,36.91972789115646,39.404263038548756,43.0,-4.0,417,2.0,403
200,63,164,36.989387755102044,39.450702947845805,33.0,12.0,146,2.0,101
201,63,233,36.989387755102044,39.42748299319728,33.0,12.0,200,2.0,170
202,63,467,36.989387755102044,39.404263038548756,33.0,-4.0,417,2.0,404
203,63,72,38.568344671201814,40.63492063492063,34.0,21.0,89,2.0,9
204,63,164,38.568344671201814,41.00643990929705,34.0,32.0,146,2.0,101
205,63,237,38.568344671201814,40.170521541950116,34.0,13.0,187,2.0,174
206,63,271,38.568344671201814,41.07609977324263,34.0,31.0,234,3.0,208
207,164,72,39.450702947845805,40.63492063492063,12.0,21.0,105,1.0,92
208,164,271,39.450702947845805,41.07609977324263,12.0,31.0,128,2.0,107
209,164,238,39.450702947845805,42.26031746031746,12.0,32.0,142,3.0,74
210,164,609,39.450702947845805,41.79591836734694,12.0,27.0,456,2.0,445
211,164,622,39.450702947845805,41.79591836734694,12.0,28.0,469,2.0,458
212,72,63,40.63492063492063,42.956916099773245,21.0,34.0,100,2.0,9
213,72,64,40.63492063492063,43.073015873015876,21.0,37.0,105,2.0,8
214,72,238,40.63492063492063,42.26031746031746,21.0,32.0,180,2.0,166
215,72,255,40.63492063492063,43.049795918367344,21.0,24.0,210,2.0,183
216,164,63,41.00643990929705,42.956916099773245,32.0,34.0,131,2.0,101
217,164,64,41.00643990929705,43.073015873015876,32.0,37.0,134,2.0,100
218,164,76,41.00643990929705,43.97859410430839,32.0,20.0,155,3.0,88
219,164,238,41.00643990929705,42.26031746031746,32.0,32.0,92,1.0,74
220,164,255,41.00643990929705,43.049795918367344,32.0,24.0,127,2.0,91
221,164,609,41.00643990929705,42.63183673469388,32.0,16.0,450,2.0,445
222,164,610,41.00643990929705,43.39809523809524,32.0,26.0,458,2.0,446
223,164,616,41.00643990929705,42.6550566893424,32.0,14.0,458,2.0,452
224,164,616,41.00643990929705,43.39809523809524,32.0,26.0,464,2.0,452
225,63,76,42.956916099773245,43.97859410430839,34.0,20.0,46,1.0,13
226,63,21,42.956916099773245,45.023492063492064,34.0,14.0,98,2.0,42
227,63,229,42.956916099773245,44.23401360544218,34.0,19.0,175,1.0,166
228,63,324,42.956916099773245,45.04671201814059,34.0,15.0,276,2.0,261
229,64,21,43.073015873015876,45.023492063492064,37.0,14.0,94,2.0,43
230,64,229,43.073015873015876,44.23401360544218,37.0,19.0,172,1.0,165
231,64,324,43.073015873015876,45.04671201814059,37.0,15.0,274,2.0,260
232,76,21,43.97859410430839,45.023492063492064,20.0,14.0,71,1.0,55
233,76,32,43.97859410430839,46.068390022675736,20.0,17.0,100,2.0,44
234,76,324,43.97859410430839,45.04671201814059,20.0,15.0,252,1.0,248
235,76,227,43.97859410430839,46.64888888888889,20.0,19.0,190,3.0,151
236,21,32,45.023492063492064,46.068390022675736,14.0,17.0,46,1.0,11
237,21,170,45.023492063492064,47.64734693877551,14.0,25.0,187,3.0,149
238,21,227,45.023492063492064,46.64888888888889,14.0,19.0,218,2.0,206
239,21,215,45.023492063492064,47.18294784580499,14.0,25.0,215,2.0,194
240,32,170,46.068390022675736,47.64734693877551,17.0,25.0,154,2.0,138
241,32,22,46.068390022675736,48.738684807256234,17.0,23.0,115,3.0,10
242,32,215,46.068390022675736,47.18294784580499,17.0,25.0,189,1.0,183
243,32,237,46.068390022675736,48.27428571428572,17.0,29.0,226,2.0,205
244,170,22,47.64734693877551,48.738684807256234,25.0,23.0,155,1.0,148
245,170,183,47.64734693877551,49.83002267573696,25.0,35.0,95,2.0,13
246,170,236,47.64734693877551,49.87646258503401,25.0,36.0,116,2.0,66
247,170,239,47.64734693877551,50.36408163265306,25.0,21.0,136,3.0,69
248,170,610,47.64734693877551,49.85324263038549,25.0,26.0,450,2.0,440
249,170,626,47.64734693877551,49.85324263038549,25.0,34.0,466,2.0,456
250,22,183,48.738684807256234,49.83002267573696,23.0,35.0,168,1.0,161
251,22,65,48.738684807256234,50.944580498866216,23.0,27.0,104,2.0,43
252,22,63,48.738684807256234,51.06068027210885,23.0,29.0,108,2.0,41
253,22,236,48.738684807256234,49.87646258503401,23.0,36.0,220,1.0,214
254,22,239,48.738684807256234,50.36408163265306,23.0,21.0,228,2.0,217
255,22,223,48.738684807256234,51.50185941043084,23.0,28.0,234,3.0,201
256,183,65,49.83002267573696,50.944580498866216,35.0,27.0,127,1.0,118
257,183,63,49.83002267573696,51.06068027210885,35.0,29.0,131,1.0,120
258,183,80,49.83002267573696,52.22167800453515,35.0,22.0,146,2.0,103
259,183,223,49.83002267573696,51.50185941043084,35.0,28.0,82,2.0,40
260,183,238,49.83002267573696,52.22167800453515,35.0,22.0,117,2.0,55
261,183,603,49.83002267573696,51.478639455782314,35.0,24.0,426,2.0,420
262,183,605,49.83002267573696,52.244897959183675,35.0,29.0,435,2.0,422
263,183,626,49.83002267573696,51.50185941043084,35.0,30.0,449,2.0,443
264,183,619,49.83002267573696,52.244897959183675,35.0,28.0,448,2.0,436
265,65,80,50.944580498866216,52.22167800453515,27.0,22.0,57,1.0,15
266,65,87,50.944580498866216,53.91673469387755,27.0,15.0,130,3.0,22
267,65,238,50.944580498866216,52.22167800453515,27.0,22.0,182,1.0,173
268,65,228,50.944580498866216,53.080816326530616,27.0,21.0,187,2.0,163
269,63,80,51.06068027210885,52.22167800453515,29.0,22.0,53,1.0,17
270,63,87,51.06068027210885,53.91673469387755,29.0,15.0,125,3.0,24
271,63,238,51.06068027210885,52.22167800453515,29.0,22.0,182,1.0,175
272,63,228,51.06068027210885,53.080816326530616,29.0,21.0,187,2.0,165
273,80,87,52.22167800453515,53.91673469387755,22.0,15.0,73,2.0,7
274,80,182,52.22167800453515,54.68299319727891,22.0,27.0,147,2.0,102
275,80,253,52.22167800453515,54.91519274376417,22.0,25.0,208,3.0,173
276,87,80,53.91673469387755,55.24027210884354,15.0,30.0,57,1.0,7
277,87,161,53.91673469387755,56.79600907029479,15.0,35.0,144,3.0,74
278,87,211,53.91673469387755,55.843990929705214,15.0,32.0,149,2.0,124
279,87,242,53.91673469387755,56.81922902494331,15.0,28.0,199,3.0,155
280,182,161,54.68299319727891,56.79600907029479,27.0,35.0,93,2.0,21
281,182,64,54.68299319727891,57.65514739229025,27.0,32.0,174,3.0,118
282,182,211,54.68299319727891,55.843990929705214,27.0,32.0,58,1.0,29
283,182,242,54.68299319727891,56.81922902494331,27.0,28.0,110,2.0,60
284,182,608,54.68299319727891,56.86566893424036,27.0,24.0,436,2.0,426
285,182,609,54.68299319727891,57.283628117913835,27.0,19.0,441,3.0,427
286,182,620,54.68299319727891,56.029750566893426,27.0,26.0,442,1.0,438
287,80,161,55.24027210884354,56.79600907029479,30.0,35.0,105,2.0,81
288,80,64,55.24027210884354,57.65514739229025,30.0,32.0,105,2.0,16
289,80,81,55.24027210884354,58.096326530612245,30.0,26.0,123,3.0,1
290,80,242,55.24027210884354,56.81922902494331,30.0,28.0,176,2.0,162
291,80,239,55.24027210884354,57.67836734693878,30.0,30.0,191,2.0,159
292,161,81,56.79600907029479,58.096326530612245,35.0,26.0,98,1.0,80
293,161,242,56.79600907029479,58.258866213151926,35.0,25.0,103,1.0,81
294,161,237,56.79600907029479,59.44308390022676,35.0,36.0,137,3.0,76
295,161,599,56.79600907029479,58.096326530612245,35.0,22.0,442,1.0,438
296,161,416,56.79600907029479,59.32698412698413,35.0,14.0,277,3.0,255
297,161,660,56.79600907029479,59.350204081632654,35.0,13.0,511,3.0,499
298,64,65,57.65514739229025,59.93070294784581,32.0,33.0,98,2.0,1
299,64,237,57.65514739229025,59.44308390022676,32.0,36.0,189,2.0,173
300,64,416,57.65514739229025,59.32698412698413,32.0,14.0,359,2.0,352
301,81,65,58.096326530612245,59.93070294784581,26.0,33.0,81,2.0,16
302,81,237,58.096326530612245,59.44308390022676,26.0,36.0,166,1.0,156
303,81,416,58.096326530612245,59.32698412698413,26.0,14.0,339,1.0,335
304,247,89,1.8575963718820863,3.6687528344671203,33.0,19.0,176,2.0,158
305,247,248,1.8575963718820863,3.320453514739229,33.0,22.0,63,1.0,1
306,247,596,1.8575963718820863,3.3436734693877552,33.0,6.0,355,1.0,349
307,247,474,1.8575963718820863,4.4117913832199545,33.0,14.0,252,3.0,227
308,247,619,1.8575963718820863,3.2275736961451247,33.0,4.0,377,1.0,372
309,247,655,1.8575963718820863,4.388571428571429,33.0,14.0,422,3.0,408
310,214,89,2.1362358276643993,3.6687528344671203,32.0,19.0,141,2.0,125
311,214,69,2.1362358276643993,4.899410430839002,32.0,30.0,188,3.0,145
312,214,248,2.1362358276643993,3.320453514739229,32.0,22.0,61,1.0,34
313,214,261,2.1362358276643993,4.85297052154195,32.0,21.0,126,3.0,47
314,214,596,2.1362358276643993,3.3436734693877552,32.0,6.0,386,1.0,382
315,214,474,2.1362358276643993,4.4117913832199545,32.0,14.0,278,2.0,260
316,214,619,2.1362358276643993,3.2275736961451247,32.0,4.0,408,1.0,405
317,214,655,2.1362358276643993,4.388571428571429,32.0,14.0,452,2.0,441
318,214,616,2.1362358276643993,4.992290249433107,32.0,13.0,420,3.0,402
319,248,69,3.320453514739229,4.899410430839002,22.0,30.0,191,2.0,179
320,248,73,3.320453514739229,5.944308390022676,22.0,33.0,208,3.0,175
321,248,261,3.320453514739229,4.85297052154195,22.0,21.0,67,2.0,13
322,248,247,3.320453514739229,5.294149659863946,22.0,31.0,85,2.0,1
323,248,474,3.320453514739229,4.4117913832199545,22.0,14.0,231,1.0,226
324,248,603,3.320453514739229,5.294149659863946,22.0,13.0,365,2.0,355
325,248,655,3.320453514739229,4.388571428571429,22.0,14.0,410,1.0,407
326,248,616,3.320453514739229,4.992290249433107,22.0,13.0,375,2.0,368
327,261,73,4.85297052154195,5.944308390022676,21.0,33.0,194,1.0,188
328,261,73,4.85297052154195,6.339047619047619,21.0,30.0,199,1.0,188
329,261,73,4.85297052154195,7.337505668934241,21.0,32.0,216,2.0,188
330,261,278,4.85297052154195,6.431927437641724,21.0,24.0,70,2.0,17
331,261,221,4.85297052154195,7.291065759637188,21.0,21.0,112,2.0,40
332,261,585,4.85297052154195,6.315827664399093,21.0,10.0,330,1.0,324
333,261,463,4.85297052154195,7.267845804988662,21.0,3.0,227,2.0,202
334,261,621,4.85297052154195,6.315827664399093,21.0,8.0,365,1.0,360
335,261,704,4.85297052154195,7.291065759637188,21.0,-3.0,455,2.0,443
336,247,73,5.294149659863946,6.339047619047619,31.0,30.0,180,1.0,174
337,247,73,5.294149659863946,7.337505668934241,31.0,32.0,195,2.0,174
338,247,278,5.294149659863946,6.431927437641724,31.0,24.0,58,1.0,31
339,247,221,5.294149659863946,7.291065759637188,31.0,21.0,90,2.0,26
340,247,585,5.294149659863946,6.315827664399093,31.0,10.0,341,1.0,338
341,247,463,5.294149659863946,7.267845804988662,31.0,3.0,232,2.0,216
342,247,601,5.294149659863946,8.034104308390022,31.0,25.0,373,3.0,354
343,247,621,5.294149659863946,6.315827664399093,31.0,8.0,377,1.0,374
344,247,704,5.294149659863946,7.291065759637188,31.0,-3.0,465,2.0,457
345,247,677,5.294149659863946,8.010884353741497,31.0,26.0,446,3.0,430
346,278,65,6.431927437641724,8.916462585034013,24.0,38.0,238,2.0,213
347,278,64,6.431927437641724,9.404081632653062,24.0,39.0,249,3.0,214
348,278,246,6.431927437641724,8.452063492063493,24.0,32.0,93,2.0,32
349,278,601,6.431927437641724,8.034104308390022,24.0,25.0,330,2.0,323
350,278,677,6.431927437641724,8.010884353741497,24.0,26.0,405,2.0,399
351,221,65,7.291065759637188,8.916462585034013,21.0,38.0,171,2.0,156
352,221,64,7.291065759637188,9.404081632653062,21.0,39.0,181,2.0,157
353,221,246,7.291065759637188,8.452063492063493,21.0,32.0,56,1.0,25
354,221,230,7.291065759637188,9.7059410430839,21.0,21.0,104,2.0,9
355,221,609,7.291065759637188,9.636281179138322,21.0,27.0,401,2.0,388
356,221,615,7.291065759637188,9.636281179138322,21.0,27.0,407,2.0,394
357,246,64,8.452063492063493,10.495419501133787,32.0,40.0,202,2.0,182
358,246,163,8.452063492063493,10.983038548752834,32.0,37.0,137,3.0,83
359,246,230,8.452063492063493,9.7059410430839,32.0,21.0,56,1.0,16
360,246,260,8.452063492063493,10.936598639455783,32.0,37.0,108,2.0,14
361,246,609,8.452063492063493,9.636281179138322,32.0,27.0,367,1.0,363
362,246,487,8.452063492063493,10.936598639455783,32.0,19.0,264,2.0,241
363,246,609,8.452063492063493,11.377777777777778,32.0,17.0,384,3.0,363
364,246,615,8.452063492063493,9.636281179138322,32.0,27.0,373,1.0,369
365,246,618,8.452063492063493,10.95981859410431,32.0,15.0,387,3.0,372
366,246,618,8.452063492063493,11.00625850340136,32.0,21.0,388,3.0,372
367,230,163,9.7059410430839,10.983038548752834,21.0,37.0,87,1.0,67
368,230,162,9.7059410430839,12.213696145124716,21.0,35.0,128,3.0,68
369,230,260,9.7059410430839,10.936598639455783,21.0,37.0,61,1.0,30
370,230,213,9.7059410430839,11.609977324263038,21.0,36.0,84,2.0,17
371,230,268,9.7059410430839,12.60843537414966,21.0,21.0,131,3.0,38
372,230,487,9.7059410430839,10.936598639455783,21.0,19.0,262,1.0,257
373,230,609,9.7059410430839,11.377777777777778,21.0,17.0,386,2.0,379
374,230,600,9.7059410430839,12.445895691609978,21.0,22.0,388,3.0,370
375,230,618,9.7059410430839,10.95981859410431,21.0,15.0,392,1.0,388
376,230,618,9.7059410430839,11.00625850340136,21.0,21.0,392,1.0,388
377,230,621,9.7059410430839,12.213696145124716,21.0,21.0,406,3.0,391
378,260,162,10.936598639455783,12.213696145124716,37.0,35.0,112,1.0,98
379,260,62,10.936598639455783,13.374693877551021,37.0,29.0,224,2.0,198
380,260,268,10.936598639455783,12.60843537414966,37.0,21.0,72,2.0,8
381,260,265,10.936598639455783,13.119274376417234,37.0,20.0,94,2.0,5
382,260,600,10.936598639455783,12.445895691609978,37.0,22.0,346,2.0,340
383,260,546,10.936598639455783,13.421133786848072,37.0,3.0,305,2.0,286
384,260,621,10.936598639455783,12.213696145124716,37.0,21.0,365,1.0,361
385,260,672,10.936598639455783,13.119274376417234,37.0,11.0,423,2.0,412
386,213,62,11.609977324263038,13.374693877551021,36.0,29.0,169,2.0,151
387,213,265,11.609977324263038,13.119274376417234,36.0,20.0,83,2.0,52
388,213,546,11.609977324263038,13.421133786848072,36.0,3.0,342,2.0,333
389,213,672,11.609977324263038,13.119274376417234,36.0,11.0,464,2.0,459
390,268,204,12.60843537414966,14.930430839002268,21.0,29.0,119,2.0,64
391,268,162,12.60843537414966,15.39482993197279,21.0,33.0,160,3.0,106
392,268,213,12.60843537414966,14.97687074829932,21.0,40.0,116,2.0,55
393,268,213,12.60843537414966,15.000090702947846,21.0,35.0,117,2.0,55
394,268,597,12.60843537414966,14.930430839002268,21.0,17.0,344,2.0,329
395,268,670,12.60843537414966,14.907210884353741,21.0,19.0,414,2.0,402
396,268,618,12.60843537414966,15.371609977324264,21.0,13.0,370,3.0,350
397,265,204,13.119274376417234,14.930430839002268,20.0,29.0,99,2.0,61
398,265,162,13.119274376417234,15.39482993197279,20.0,33.0,142,2.0,103
399,265,213,13.119274376417234,14.97687074829932,20.0,40.0,95,2.0,52
400,265,213,13.119274376417234,15.000090702947846,20.0,35.0,96,2.0,52
401,265,597,13.119274376417234,14.930430839002268,20.0,17.0,341,2.0,332
402,265,604,13.119274376417234,15.696689342403628,20.0,15.0,357,3.0,339
403,265,670,13.119274376417234,14.907210884353741,20.0,19.0,412,2.0,405
404,265,618,13.119274376417234,15.371609977324264,20.0,13.0,366,2.0,353
405,213,162,14.97687074829932,16.950566893424035,40.0,30.0,99,2.0,51
406,213,183,14.97687074829932,17.60072562358277,40.0,36.0,117,3.0,30
407,213,240,14.97687074829932,16.50938775510204,40.0,29.0,71,2.0,27
408,213,255,14.97687074829932,17.949024943310658,40.0,31.0,135,3.0,42
409,213,614,14.97687074829932,16.46294784580499,40.0,23.0,406,1.0,401
410,213,604,14.97687074829932,17.716825396825396,40.0,18.0,408,3.0,391
411,213,615,14.97687074829932,16.46294784580499,40.0,24.0,407,1.0,402
412,213,622,14.97687074829932,17.020226757369613,40.0,17.0,418,2.0,409
413,213,162,15.000090702947846,16.950566893424035,35.0,30.0,98,2.0,51
414,213,183,15.000090702947846,17.60072562358277,35.0,36.0,116,3.0,30
415,213,240,15.000090702947846,16.50938775510204,35.0,29.0,70,2.0,27
416,213,255,15.000090702947846,17.949024943310658,35.0,31.0,134,3.0,42
417,213,614,15.000090702947846,16.46294784580499,35.0,23.0,406,1.0,401
418,213,604,15.000090702947846,17.716825396825396,35.0,18.0,408,3.0,391
419,213,615,15.000090702947846,16.46294784580499,35.0,24.0,407,1.0,402
420,213,622,15.000090702947846,17.020226757369613,35.0,17.0,418,2.0,409
421,240,183,16.50938775510204,17.60072562358277,29.0,36.0,74,1.0,57
422,240,74,16.50938775510204,18.52952380952381,29.0,35.0,187,2.0,166
423,240,164,16.50938775510204,19.272562358276645,29.0,20.0,141,3.0,76
424,240,255,16.50938775510204,17.949024943310658,29.0,31.0,64,1.0,15
425,240,257,16.50938775510204,17.99546485260771,29.0,28.0,66,1.0,17
426,240,264,16.50938775510204,19.29578231292517,29.0,19.0,122,3.0,24
427,240,604,16.50938775510204,17.716825396825396,29.0,18.0,368,1.0,364
428,240,611,16.50938775510204,17.99546485260771,29.0,13.0,376,1.0,371
429,240,440,16.50938775510204,19.272562358276645,29.0,10.0,233,3.0,200
430,240,676,16.50938775510204,17.99546485260771,29.0,11.0,441,1.0,436
431,255,164,17.949024943310658,19.272562358276645,31.0,20.0,107,1.0,91
432,255,183,17.949024943310658,20.805079365079365,31.0,29.0,143,3.0,72
433,255,264,17.949024943310658,19.29578231292517,31.0,19.0,59,1.0,9
434,255,232,17.949024943310658,20.572879818594103,31.0,34.0,115,3.0,23
435,255,440,17.949024943310658,19.272562358276645,31.0,10.0,194,1.0,185
436,255,550,17.949024943310658,20.805079365079365,31.0,11.0,320,3.0,295
437,255,683,17.949024943310658,20.82829931972789,31.0,15.0,446,3.0,428
438,257,164,17.99546485260771,19.272562358276645,28.0,20.0,108,1.0,93
439,257,183,17.99546485260771,20.805079365079365,28.0,29.0,142,3.0,74
440,257,264,17.99546485260771,19.29578231292517,28.0,19.0,56,1.0,7
441,257,232,17.99546485260771,20.572879818594103,28.0,34.0,114,3.0,25
442,257,440,17.99546485260771,19.272562358276645,28.0,10.0,191,1.0,183
443,257,550,17.99546485260771,20.805079365079365,28.0,11.0,317,3.0,293
444,257,683,17.99546485260771,20.82829931972789,28.0,15.0,443,3.0,426
445,264,183,19.29578231292517,20.805079365079365,19.0,29.0,104,2.0,81
446,264,81,19.29578231292517,21.61777777777778,19.0,35.0,209,2.0,183
447,264,232,19.29578231292517,20.572879818594103,19.0,34.0,64,1.0,32
448,264,291,19.29578231292517,21.89641723356009,19.0,13.0,115,3.0,27
449,264,550,19.29578231292517,20.805079365079365,19.0,11.0,293,2.0,286
450,264,605,19.29578231292517,21.106938775510205,19.0,21.0,350,2.0,341
451,264,683,19.29578231292517,20.82829931972789,19.0,15.0,424,2.0,419
452,264,674,19.29578231292517,21.08371882086168,19.0,25.0,417,2.0,410
453,232,81,20.572879818594103,21.61777777777778,34.0,35.0,158,1.0,151
454,232,22,20.572879818594103,22.918095238095237,34.0,28.0,233,2.0,210
455,232,64,20.572879818594103,23.289614512471655,34.0,36.0,205,3.0,168
456,232,291,20.572879818594103,21.89641723356009,34.0,13.0,82,1.0,59
457,232,228,20.572879818594103,22.871655328798187,34.0,28.0,99,2.0,4
458,232,255,20.572879818594103,23.26639455782313,34.0,34.0,118,3.0,23
459,232,461,20.572879818594103,22.80199546485261,34.0,26.0,248,2.0,229
460,232,421,20.572879818594103,23.26639455782313,34.0,8.0,222,3.0,189
461,232,615,20.572879818594103,22.80199546485261,34.0,20.0,395,2.0,383
462,232,622,20.572879818594103,23.312834467120183,34.0,11.0,407,3.0,390
463,291,22,21.89641723356009,22.918095238095237,13.0,28.0,273,1.0,269
464,291,64,21.89641723356009,23.289614512471655,13.0,36.0,235,1.0,227
465,291,64,21.89641723356009,24.68281179138322,13.0,32.0,257,3.0,227
466,291,255,21.89641723356009,23.26639455782313,13.0,34.0,69,1.0,36
467,291,242,21.89641723356009,23.986213151927437,13.0,28.0,102,2.0,49
468,291,421,21.89641723356009,23.26639455782313,13.0,8.0,143,1.0,130
469,291,613,21.89641723356009,24.86857142857143,13.0,5.0,347,3.0,322
470,291,622,21.89641723356009,23.312834467120183,13.0,11.0,337,1.0,331
471,291,682,21.89641723356009,24.79891156462585,13.0,8.0,410,3.0,391
472,228,64,22.871655328798187,24.68281179138322,28.0,32.0,182,2.0,164
473,228,64,22.871655328798187,25.054331065759637,28.0,33.0,189,2.0,164
474,228,242,22.871655328798187,23.986213151927437,28.0,28.0,50,1.0,14
475,228,613,22.871655328798187,24.86857142857143,28.0,5.0,394,2.0,385
476,228,609,22.871655328798187,25.054331065759637,28.0,9.0,392,2.0,381
477,228,682,22.871655328798187,24.79891156462585,28.0,8.0,462,2.0,454
478,228,674,22.871655328798187,25.21687074829932,28.0,17.0,457,2.0,446
479,255,64,23.26639455782313,24.68281179138322,34.0,32.0,201,1.0,191
480,255,64,23.26639455782313,25.054331065759637,34.0,33.0,206,2.0,191
481,255,228,23.26639455782313,25.58839002267574,34.0,24.0,104,2.0,27
482,255,613,23.26639455782313,24.86857142857143,34.0,5.0,365,2.0,358
483,255,609,23.26639455782313,25.054331065759637,34.0,9.0,362,2.0,354
484,255,682,23.26639455782313,24.79891156462585,34.0,8.0,432,2.0,427
485,255,674,23.26639455782313,25.21687074829932,34.0,17.0,427,2.0,419
486,242,64,23.986213151927437,25.054331065759637,28.0,33.0,184,1.0,178
487,242,32,23.986213151927437,26.563628117913833,28.0,23.0,238,3.0,210
488,242,228,23.986213151927437,25.58839002267574,28.0,24.0,70,2.0,14
489,242,244,23.986213151927437,26.377868480725624,28.0,19.0,103,2.0,2
490,242,609,23.986213151927437,25.054331065759637,28.0,9.0,370,1.0,367
491,242,490,23.986213151927437,26.911927437641722,28.0,-4.0,278,3.0,248
492,242,674,23.986213151927437,25.21687074829932,28.0,17.0,435,1.0,432
493,242,682,23.986213151927437,26.772607709750567,28.0,5.0,456,3.0,440
494,228,66,25.58839002267574,27.190566893424037,24.0,35.0,176,2.0,162
495,228,236,25.58839002267574,27.16734693877551,24.0,32.0,68,2.0,8
496,228,246,25.58839002267574,28.026485260770976,24.0,24.0,107,2.0,18
497,228,490,25.58839002267574,26.911927437641722,24.0,-4.0,268,1.0,262
498,228,590,25.58839002267574,27.144126984126984,24.0,18.0,368,2.0,362
499,228,682,25.58839002267574,26.772607709750567,24.0,5.0,457,1.0,454
500,228,617,25.58839002267574,27.12090702947846,24.0,21.0,395,2.0,389
501,244,102,26.377868480725624,28.699863945578233,19.0,16.0,174,2.0,142
502,244,246,26.377868480725624,28.026485260770976,19.0,24.0,71,2.0,2
503,244,609,26.377868480725624,28.76952380952381,19.0,26.0,379,2.0,365
504,244,622,26.377868480725624,28.76952380952381,19.0,28.0,392,2.0,378
505,236,102,27.16734693877551,28.699863945578233,32.0,16.0,149,2.0,134
506,236,164,27.16734693877551,29.675102040816327,32.0,15.0,130,3.0,72
507,236,32,27.16734693877551,30.046621315192745,32.0,25.0,239,3.0,204
508,236,234,27.16734693877551,29.675102040816327,32.0,6.0,108,3.0,2
509,236,609,27.16734693877551,28.76952380952381,32.0,26.0,379,2.0,373
510,236,622,27.16734693877551,28.76952380952381,32.0,28.0,392,2.0,386
511,246,164,28.026485260770976,29.675102040816327,24.0,15.0,108,2.0,82
512,246,32,28.026485260770976,30.046621315192745,24.0,25.0,231,2.0,214
513,246,234,28.026485260770976,29.675102040816327,24.0,6.0,72,2.0,12
514,246,213,28.026485260770976,30.65034013605442,24.0,24.0,118,3.0,33
515,246,604,28.026485260770976,30.441360544217687,24.0,25.0,373,2.0,358
516,246,663,28.026485260770976,30.441360544217687,24.0,24.0,430,2.0,417
517,234,182,29.675102040816327,31.62557823129252,6.0,22.0,99,2.0,52
518,234,202,29.675102040816327,32.113197278911564,6.0,17.0,110,2.0,32
519,234,236,29.675102040816327,31.37015873015873,6.0,26.0,73,2.0,2
520,234,213,29.675102040816327,32.08997732426304,6.0,22.0,106,2.0,21
521,234,517,29.675102040816327,31.71845804988662,6.0,6.0,296,2.0,283
522,234,608,29.675102040816327,32.113197278911564,6.0,26.0,388,2.0,374
523,234,677,29.675102040816327,31.71845804988662,6.0,8.0,452,2.0,443
524,234,623,29.675102040816327,32.113197278911564,6.0,29.0,403,2.0,389
525,213,202,30.65034013605442,32.113197278911564,24.0,17.0,64,1.0,11
526,213,517,30.65034013605442,31.71845804988662,24.0,6.0,307,1.0,304
527,213,608,30.65034013605442,32.113197278911564,24.0,26.0,400,1.0,395
528,213,677,30.65034013605442,31.71845804988662,24.0,8.0,466,1.0,464
529,213,623,30.65034013605442,32.113197278911564,24.0,29.0,415,1.0,410
530,236,31,31.37015873015873,33.78503401360544,26.0,18.0,230,2.0,205
531,236,608,31.37015873015873,33.69215419501134,26.0,23.0,385,2.0,372
532,236,625,31.37015873015873,33.69215419501134,26.0,20.0,402,2.0,389
533,213,31,32.08997732426304,33.78503401360544,22.0,18.0,196,2.0,182
534,213,195,32.08997732426304,34.80671201814059,22.0,30.0,118,3.0,18
535,213,236,32.08997732426304,33.715374149659866,22.0,25.0,74,2.0,23
536,213,258,32.08997732426304,34.57451247165533,22.0,34.0,116,2.0,45
537,213,208,32.08997732426304,35.03891156462585,22.0,32.0,127,3.0,5
538,213,608,32.08997732426304,33.69215419501134,22.0,23.0,401,2.0,395
539,213,537,32.08997732426304,34.57451247165533,22.0,11.0,341,2.0,324
540,213,625,32.08997732426304,33.69215419501134,22.0,20.0,418,2.0,412
541,213,669,32.08997732426304,34.76027210884354,22.0,8.0,470,3.0,456
542,236,195,33.715374149659866,34.80671201814059,25.0,30.0,62,1.0,41
543,236,29,33.715374149659866,35.43365079365079,25.0,28.0,220,2.0,207
544,236,208,33.715374149659866,35.03891156462585,25.0,32.0,64,1.0,28
545,236,237,33.715374149659866,36.52498866213152,25.0,29.0,121,3.0,1
546,236,614,33.715374149659866,35.34077097505669,25.0,32.0,384,2.0,378
547,236,669,33.715374149659866,34.76027210884354,25.0,8.0,435,1.0,433
548,236,617,33.715374149659866,35.31755102040817,25.0,30.0,387,2.0,381
549,258,64,34.57451247165533,36.91972789115646,34.0,43.0,219,2.0,194
550,258,63,34.57451247165533,36.989387755102044,34.0,33.0,221,2.0,195
551,258,237,34.57451247165533,36.52498866213152,34.0,29.0,87,2.0,21
552,258,614,34.57451247165533,36.91972789115646,34.0,29.0,370,2.0,356
553,258,601,34.57451247165533,36.989387755102044,34.0,13.0,358,2.0,343
554,258,616,34.57451247165533,36.91972789115646,34.0,29.0,372,2.0,358
555,208,64,35.03891156462585,36.91972789115646,32.0,43.0,165,2.0,144
556,208,63,35.03891156462585,36.989387755102044,32.0,33.0,168,2.0,145
557,208,237,35.03891156462585,36.52498866213152,32.0,29.0,70,1.0,29
558,208,214,35.03891156462585,37.77886621315193,32.0,31.0,118,3.0,6
559,208,271,35.03891156462585,37.987845804988666,32.0,18.0,142,3.0,63
560,208,614,35.03891156462585,36.91972789115646,32.0,29.0,414,2.0,406
561,208,601,35.03891156462585,36.989387755102044,32.0,13.0,402,2.0,393
562,208,616,35.03891156462585,36.91972789115646,32.0,29.0,416,2.0,408
563,208,619,35.03891156462585,37.89496598639456,32.0,15.0,429,3.0,411
564,237,63,36.52498866213152,38.568344671201814,29.0,34.0,195,2.0,174
565,237,164,36.52498866213152,39.450702947845805,29.0,12.0,146,3.0,73
566,237,214,36.52498866213152,37.77886621315193,29.0,31.0,59,1.0,23
567,237,271,36.52498866213152,37.987845804988666,29.0,18.0,72,1.0,34
568,237,233,36.52498866213152,39.42748299319728,29.0,12.0,125,3.0,4
569,237,607,36.52498866213152,38.59156462585034,29.0,26.0,381,2.0,370
570,237,467,36.52498866213152,39.404263038548756,29.0,-4.0,261,3.0,230
571,237,619,36.52498866213152,37.89496598639456,29.0,15.0,387,1.0,382
572,237,626,36.52498866213152,38.568344671201814,29.0,30.0,399,2.0,389
573,214,164,37.77886621315193,39.450702947845805,31.0,12.0,88,2.0,50
574,214,72,37.77886621315193,40.63492063492063,31.0,21.0,188,3.0,142
575,214,233,37.77886621315193,39.42748299319728,31.0,12.0,73,2.0,19
576,214,237,37.77886621315193,40.170521541950116,31.0,13.0,106,2.0,23
577,214,467,37.77886621315193,39.404263038548756,31.0,-4.0,263,2.0,253
578,214,613,37.77886621315193,40.170521541950116,31.0,31.0,412,2.0,399
579,214,615,37.77886621315193,40.170521541950116,31.0,30.0,414,2.0,401
580,271,164,37.987845804988666,39.450702947845805,18.0,12.0,124,1.0,107
581,271,72,37.987845804988666,40.63492063492063,18.0,21.0,229,3.0,199
582,271,233,37.987845804988666,39.42748299319728,18.0,12.0,73,1.0,38
583,271,237,37.987845804988666,40.170521541950116,18.0,13.0,100,2.0,34
584,271,467,37.987845804988666,39.404263038548756,18.0,-4.0,205,1.0,196
585,271,613,37.987845804988666,40.170521541950116,18.0,31.0,355,2.0,342
586,271,615,37.987845804988666,40.170521541950116,18.0,30.0,357,2.0,344
587,233,72,39.42748299319728,40.63492063492063,12.0,21.0,169,1.0,161
588,233,164,39.42748299319728,41.00643990929705,12.0,32.0,97,2.0,69
589,233,271,39.42748299319728,41.07609977324263,12.0,31.0,81,2.0,38
590,233,238,39.42748299319728,42.26031746031746,12.0,32.0,122,3.0,5
591,233,609,39.42748299319728,41.79591836734694,12.0,27.0,390,2.0,376
592,233,622,39.42748299319728,41.79591836734694,12.0,28.0,402,2.0,389
593,237,63,40.170521541950116,42.956916099773245,13.0,34.0,211,3.0,174
594,237,64,40.170521541950116,43.073015873015876,13.0,37.0,213,3.0,173
595,237,238,40.170521541950116,42.26031746031746,13.0,32.0,90,2.0,1
596,237,255,40.170521541950116,43.049795918367344,13.0,24.0,125,3.0,18
597,237,609,40.170521541950116,41.79591836734694,13.0,27.0,379,2.0,372
598,237,609,40.170521541950116,42.63183673469388,13.0,16.0,387,2.0,372
599,237,622,40.170521541950116,41.79591836734694,13.0,28.0,391,2.0,385
600,237,616,40.170521541950116,42.6550566893424,13.0,14.0,394,2.0,379
601,271,63,41.07609977324263,42.956916099773245,31.0,34.0,223,2.0,208
602,271,64,41.07609977324263,43.073015873015876,31.0,37.0,224,2.0,207
603,271,76,41.07609977324263,43.97859410430839,31.0,20.0,232,3.0,195
604,271,238,41.07609977324263,42.26031746031746,31.0,32.0,61,1.0,33
605,271,255,41.07609977324263,43.049795918367344,31.0,24.0,86,2.0,16
606,271,609,41.07609977324263,42.63183673469388,31.0,16.0,345,2.0,338
607,271,610,41.07609977324263,43.39809523809524,31.0,26.0,353,2.0,339
608,271,616,41.07609977324263,42.6550566893424,31.0,14.0,352,2.0,345
609,271,616,41.07609977324263,43.39809523809524,31.0,26.0,359,2.0,345
610,271,616,41.07609977324263,44.04825396825397,31.0,25.0,368,3.0,345
611,238,76,42.26031746031746,43.97859410430839,32.0,20.0,178,2.0,162
612,238,21,42.26031746031746,45.023492063492064,32.0,14.0,247,3.0,217
613,238,229,42.26031746031746,44.23401360544218,32.0,19.0,85,2.0,9
614,238,324,42.26031746031746,45.04671201814059,32.0,15.0,148,3.0,86
615,238,610,42.26031746031746,43.39809523809524,32.0,26.0,375,1.0,372
616,238,602,42.26031746031746,44.0714739229025,32.0,23.0,372,2.0,364
617,238,614,42.26031746031746,45.00027210884354,32.0,29.0,394,3.0,376
618,238,616,42.26031746031746,43.39809523809524,32.0,26.0,381,1.0,378
619,238,616,42.26031746031746,44.04825396825397,32.0,25.0,386,2.0,378
620,238,623,42.26031746031746,45.00027210884354,32.0,29.0,403,3.0,385
621,255,21,43.049795918367344,45.023492063492064,24.0,14.0,249,2.0,234
622,255,229,43.049795918367344,44.23401360544218,24.0,19.0,57,1.0,26
623,255,324,43.049795918367344,45.04671201814059,24.0,15.0,110,2.0,69
624,255,602,43.049795918367344,44.0714739229025,24.0,23.0,350,1.0,347
625,255,614,43.049795918367344,45.00027210884354,24.0,29.0,369,2.0,359
626,255,623,43.049795918367344,45.00027210884354,24.0,29.0,377,2.0,368
627,229,32,44.23401360544218,46.068390022675736,19.0,17.0,212,2.0,197
628,229,227,44.23401360544218,46.64888888888889,19.0,19.0,104,2.0,2
629,229,215,44.23401360544218,47.18294784580499,19.0,25.0,128,3.0,14
630,229,591,44.23401360544218,46.625668934240366,19.0,21.0,376,2.0,362
631,229,618,44.23401360544218,46.625668934240366,19.0,32.0,402,2.0,389
632,229,673,44.23401360544218,47.18294784580499,19.0,11.0,462,3.0,444
633,324,32,45.04671201814059,46.068390022675736,15.0,17.0,295,1.0,292
634,324,170,45.04671201814059,47.64734693877551,15.0,25.0,190,3.0,154
635,324,227,45.04671201814059,46.64888888888889,15.0,19.0,119,2.0,97
636,324,215,45.04671201814059,47.18294784580499,15.0,25.0,143,2.0,109
637,324,591,45.04671201814059,46.625668934240366,15.0,21.0,276,2.0,267
638,324,601,45.04671201814059,47.275827664399095,15.0,11.0,293,2.0,277
639,324,618,45.04671201814059,46.625668934240366,15.0,32.0,302,2.0,294
640,324,673,45.04671201814059,47.18294784580499,15.0,11.0,361,2.0,349
641,324,822,45.04671201814059,46.625668934240366,15.0,19.0,503,2.0,498
642,227,22,46.64888888888889,48.738684807256234,19.0,23.0,224,2.0,205
643,227,237,46.64888888888889,48.27428571428572,19.0,29.0,71,2.0,10
644,227,614,46.64888888888889,48.251065759637186,19.0,26.0,393,2.0,387
645,227,623,46.64888888888889,48.251065759637186,19.0,29.0,402,2.0,396
646,215,22,47.18294784580499,48.738684807256234,25.0,23.0,204,2.0,193
647,215,183,47.18294784580499,49.83002267573696,25.0,35.0,118,3.0,32
648,215,237,47.18294784580499,48.27428571428572,25.0,29.0,52,1.0,22
649,215,236,47.18294784580499,49.87646258503401,25.0,36.0,118,3.0,21
650,215,614,47.18294784580499,48.251065759637186,25.0,26.0,402,1.0,399
651,215,610,47.18294784580499,49.85324263038549,25.0,26.0,411,3.0,395
652,215,623,47.18294784580499,48.251065759637186,25.0,29.0,411,1.0,408
653,215,626,47.18294784580499,49.85324263038549,25.0,34.0,427,3.0,411
654,237,183,48.27428571428572,49.83002267573696,29.0,35.0,86,2.0,54
655,237,65,48.27428571428572,50.944580498866216,29.0,27.0,207,3.0,172
656,237,63,48.27428571428572,51.06068027210885,29.0,29.0,211,3.0,174
657,237,236,48.27428571428572,49.87646258503401,29.0,36.0,69,2.0,1
658,237,239,48.27428571428572,50.36408163265306,29.0,21.0,90,2.0,2
659,237,610,48.27428571428572,49.85324263038549,29.0,26.0,379,2.0,373
660,237,626,48.27428571428572,49.85324263038549,29.0,34.0,395,2.0,389
661,237,664,48.27428571428572,50.78204081632653,29.0,-4.0,440,3.0,427
662,236,65,49.87646258503401,50.944580498866216,36.0,27.0,177,1.0,171
663,236,63,49.87646258503401,51.06068027210885,36.0,29.0,180,1.0,173
664,236,80,49.87646258503401,52.22167800453515,36.0,22.0,186,2.0,156
665,236,223,49.87646258503401,51.50185941043084,36.0,28.0,71,2.0,13
666,236,238,49.87646258503401,52.22167800453515,36.0,22.0,101,2.0,2
667,236,603,49.87646258503401,51.478639455782314,36.0,24.0,373,2.0,367
668,236,605,49.87646258503401,52.244897959183675,36.0,29.0,383,2.0,369
669,236,626,49.87646258503401,51.50185941043084,36.0,30.0,396,2.0,390
670,236,619,49.87646258503401,52.244897959183675,36.0,28.0,396,2.0,383
671,239,80,50.36408163265306,52.22167800453515,21.0,22.0,178,2.0,159
672,239,223,50.36408163265306,51.50185941043084,21.0,28.0,52,1.0,16
673,239,238,50.36408163265306,52.22167800453515,21.0,22.0,80,2.0,1
674,239,228,50.36408163265306,53.080816326530616,21.0,21.0,118,3.0,11
675,239,603,50.36408163265306,51.478639455782314,21.0,24.0,367,1.0,364
676,239,605,50.36408163265306,52.244897959183675,21.0,29.0,375,2.0,366
677,239,612,50.36408163265306,53.011156462585035,21.0,29.0,390,3.0,373
678,239,626,50.36408163265306,51.50185941043084,21.0,30.0,390,1.0,387
679,239,619,50.36408163265306,52.244897959183675,21.0,28.0,389,2.0,380
680,239,621,50.36408163265306,53.011156462585035,21.0,28.0,399,3.0,382
681,223,87,51.50185941043084,53.91673469387755,28.0,15.0,171,2.0,136
682,223,228,51.50185941043084,53.080816326530616,28.0,21.0,68,2.0,5
683,223,612,51.50185941043084,53.011156462585035,28.0,29.0,394,2.0,389
684,223,621,51.50185941043084,53.011156462585035,28.0,28.0,403,2.0,398
685,238,87,52.22167800453515,53.91673469387755,22.0,15.0,168,2.0,151
686,238,182,52.22167800453515,54.68299319727891,22.0,27.0,120,2.0,56
687,238,253,52.22167800453515,54.91519274376417,22.0,25.0,117,3.0,15
688,238,610,52.22167800453515,54.63655328798186,22.0,22.0,386,2.0,372
689,238,603,52.22167800453515,55.147392290249435,22.0,24.0,386,3.0,365
690,238,676,52.22167800453515,54.61333333333334,22.0,16.0,450,2.0,438
691,238,622,52.22167800453515,55.147392290249435,22.0,26.0,404,3.0,384
692,228,182,53.080816326530616,54.68299319727891,21.0,27.0,83,2.0,46
693,228,80,53.080816326530616,55.24027210884354,21.0,30.0,175,2.0,148
694,228,253,53.080816326530616,54.91519274376417,21.0,25.0,83,2.0,25
695,228,211,53.080816326530616,55.843990929705214,21.0,32.0,120,3.0,17
696,228,610,53.080816326530616,54.63655328798186,21.0,22.0,388,2.0,382
697,228,603,53.080816326530616,55.147392290249435,21.0,24.0,385,2.0,375
698,228,676,53.080816326530616,54.61333333333334,21.0,16.0,453,2.0,448
699,228,622,53.080816326530616,55.147392290249435,21.0,26.0,404,2.0,394
700,228,620,53.080816326530616,56.029750566893426,21.0,26.0,412,3.0,392
701,253,161,54.91519274376417,56.79600907029479,25.0,35.0,123,2.0,92
702,253,64,54.91519274376417,57.65514739229025,25.0,32.0,223,3.0,189
703,253,242,54.91519274376417,56.81922902494331,25.0,28.0,83,2.0,11
704,253,239,54.91519274376417,57.67836734693878,25.0,30.0,120,3.0,14
705,253,608,54.91519274376417,56.86566893424036,25.0,24.0,365,2.0,355
706,253,609,54.91519274376417,57.283628117913835,25.0,19.0,370,2.0,356
707,253,620,54.91519274376417,56.029750566893426,25.0,26.0,370,1.0,367
708,253,661,54.91519274376417,57.7015873015873,25.0,18.0,425,3.0,408
709,211,64,55.843990929705214,57.65514739229025,32.0,32.0,166,2.0,147
710,211,81,55.843990929705214,58.096326530612245,32.0,26.0,162,2.0,130
711,211,239,55.843990929705214,57.67836734693878,32.0,30.0,84,2.0,28
712,211,242,55.843990929705214,58.258866213151926,32.0,25.0,109,2.0,31
713,211,608,55.843990929705214,56.86566893424036,32.0,24.0,399,1.0,397
714,211,609,55.843990929705214,57.283628117913835,32.0,19.0,403,1.0,398
715,211,599,55.843990929705214,58.096326530612245,32.0,22.0,400,2.0,388
716,211,661,55.843990929705214,57.7015873015873,32.0,18.0,457,2.0,450
717,211,684,55.843990929705214,58.096326530612245,32.0,23.0,483,2.0,473
718,242,81,56.81922902494331,58.096326530612245,28.0,26.0,170,1.0,161
719,242,237,56.81922902494331,59.44308390022676,28.0,36.0,113,3.0,5
720,242,599,56.81922902494331,58.096326530612245,28.0,22.0,361,1.0,357
721,242,416,56.81922902494331,59.32698412698413,28.0,14.0,205,3.0,174
722,242,684,56.81922902494331,58.096326530612245,28.0,23.0,445,1.0,442
723,242,660,56.81922902494331,59.350204081632654,28.0,13.0,432,3.0,418
724,239,65,57.67836734693878,59.93070294784581,30.0,33.0,199,2.0,174
725,239,237,57.67836734693878,59.44308390022676,30.0,36.0,76,2.0,2
726,239,416,57.67836734693878,59.32698412698413,30.0,14.0,191,2.0,177
727,239,660,57.67836734693878,59.350204081632654,30.0,13.0,427,2.0,421
728,242,65,58.258866213151926,59.93070294784581,25.0,33.0,191,2.0,177
729,242,237,58.258866213151926,59.44308390022676,25.0,36.0,51,1.0,5
730,242,416,58.258866213151926,59.32698412698413,25.0,14.0,180,1.0,174
731,242,660,58.258866213151926,59.350204081632654,25.0,13.0,421,1.0,418
732,417,89,1.5325170068027212,3.6687528344671203,14.0,19.0,341,2.0,328
733,417,248,1.5325170068027212,3.320453514739229,14.0,22.0,186,2.0,169
734,417,596,1.5325170068027212,3.3436734693877552,14.0,6.0,195,2.0,179
735,417,474,1.5325170068027212,4.4117913832199545,14.0,14.0,136,3.0,57
736,417,619,1.5325170068027212,3.2275736961451247,14.0,4.0,215,2.0,202
737,417,655,1.5325170068027212,4.388571428571429,14.0,14.0,268,3.0,238
738,417,836,1.5325170068027212,4.388571428571429,14.0,-4.0,437,3.0,419
739,600,261,2.345215419501134,4.85297052154195,23.0,21.0,356,3.0,339
740,600,247,2.345215419501134,5.294149659863946,23.0,31.0,375,3.0,353
741,600,474,2.345215419501134,4.4117913832199545,23.0,14.0,154,2.0,126
742,600,603,2.345215419501134,5.294149659863946,23.0,13.0,127,3.0,3
743,600,655,2.345215419501134,4.388571428571429,23.0,14.0,104,2.0,55
744,600,616,2.345215419501134,4.992290249433107,23.0,13.0,115,3.0,16
745,600,836,2.345215419501134,4.388571428571429,23.0,-4.0,252,2.0,236
746,596,261,3.3436734693877552,4.85297052154195,6.0,21.0,341,2.0,335
747,596,247,3.3436734693877552,5.294149659863946,6.0,31.0,359,2.0,349
748,596,474,3.3436734693877552,4.4117913832199545,6.0,14.0,130,1.0,122
749,596,603,3.3436734693877552,5.294149659863946,6.0,13.0,84,2.0,7
750,596,585,3.3436734693877552,6.315827664399093,6.0,10.0,128,3.0,11
751,596,655,3.3436734693877552,4.388571428571429,6.0,14.0,74,1.0,59
752,596,616,3.3436734693877552,4.992290249433107,6.0,13.0,74,2.0,20
753,596,621,3.3436734693877552,6.315827664399093,6.0,8.0,130,3.0,25
754,596,836,3.3436734693877552,4.388571428571429,6.0,-4.0,244,1.0,240
755,474,73,4.4117913832199545,5.944308390022676,14.0,33.0,406,2.0,401
756,474,73,4.4117913832199545,6.339047619047619,14.0,30.0,409,2.0,401
757,474,73,4.4117913832199545,7.337505668934241,14.0,32.0,420,3.0,401
758,474,278,4.4117913832199545,6.431927437641724,14.0,24.0,214,2.0,196
759,474,221,4.4117913832199545,7.291065759637188,14.0,21.0,282,3.0,253
760,474,585,4.4117913832199545,6.315827664399093,14.0,10.0,138,2.0,111
761,474,463,4.4117913832199545,7.267845804988662,14.0,3.0,123,3.0,11
762,474,621,4.4117913832199545,6.315827664399093,14.0,8.0,168,2.0,147
763,474,704,4.4117913832199545,7.291065759637188,14.0,-3.0,261,3.0,230
764,603,278,5.294149659863946,6.431927437641724,13.0,24.0,329,1.0,325
765,603,221,5.294149659863946,7.291065759637188,13.0,21.0,392,2.0,382
766,603,585,5.294149659863946,6.315827664399093,13.0,10.0,48,1.0,18
767,603,463,5.294149659863946,7.267845804988662,13.0,3.0,164,2.0,140
768,603,601,5.294149659863946,8.034104308390022,13.0,25.0,118,3.0,2
769,603,621,5.294149659863946,6.315827664399093,13.0,8.0,48,1.0,18
770,603,704,5.294149659863946,7.291065759637188,13.0,-3.0,133,2.0,101
771,603,677,5.294149659863946,8.010884353741497,13.0,26.0,138,3.0,74
772,603,866,5.294149659863946,8.010884353741497,13.0,11.0,288,3.0,263
773,585,246,6.315827664399093,8.452063492063493,10.0,32.0,351,2.0,339
774,585,601,6.315827664399093,8.034104308390022,10.0,25.0,76,2.0,16
775,585,677,6.315827664399093,8.010884353741497,10.0,26.0,117,2.0,92
776,585,866,6.315827664399093,8.010884353741497,10.0,11.0,290,2.0,281
777,463,65,7.267845804988662,8.916462585034013,3.0,38.0,404,2.0,398
778,463,64,7.267845804988662,9.404081632653062,3.0,39.0,409,2.0,399
779,463,246,7.267845804988662,8.452063492063493,3.0,32.0,223,1.0,217
780,463,230,7.267845804988662,9.7059410430839,3.0,21.0,256,2.0,233
781,463,609,7.267845804988662,9.636281179138322,3.0,27.0,178,2.0,146
782,463,615,7.267845804988662,9.636281179138322,3.0,27.0,183,2.0,152
783,463,833,7.267845804988662,9.58984126984127,3.0,16.0,383,2.0,370
784,601,163,8.034104308390022,10.983038548752834,25.0,37.0,456,3.0,438
785,601,230,8.034104308390022,9.7059410430839,25.0,21.0,378,2.0,371
786,601,260,8.034104308390022,10.936598639455783,25.0,37.0,363,3.0,341
787,601,609,8.034104308390022,9.636281179138322,25.0,27.0,69,2.0,8
788,601,487,8.034104308390022,10.936598639455783,25.0,19.0,169,3.0,114
789,601,615,8.034104308390022,9.636281179138322,25.0,27.0,70,2.0,14
790,601,618,8.034104308390022,10.95981859410431,25.0,15.0,127,3.0,17
791,601,618,8.034104308390022,11.00625850340136,25.0,21.0,129,3.0,17
792,601,833,8.034104308390022,9.58984126984127,25.0,16.0,241,2.0,232
793,601,843,8.034104308390022,10.936598639455783,25.0,14.0,272,3.0,242
794,609,163,9.636281179138322,10.983038548752834,27.0,37.0,450,1.0,446
795,609,162,9.636281179138322,12.213696145124716,27.0,35.0,461,3.0,447
796,609,260,9.636281179138322,10.936598639455783,27.0,37.0,353,1.0,349
797,609,213,9.636281179138322,11.609977324263038,27.0,36.0,405,2.0,396
798,609,268,9.636281179138322,12.60843537414966,27.0,21.0,364,3.0,341
799,609,487,9.636281179138322,10.936598639455783,27.0,19.0,134,1.0,122
800,609,600,9.636281179138322,12.445895691609978,27.0,22.0,121,3.0,9
801,609,618,9.636281179138322,10.95981859410431,27.0,15.0,58,1.0,9
802,609,618,9.636281179138322,11.00625850340136,27.0,21.0,60,1.0,9
803,609,621,9.636281179138322,12.213696145124716,27.0,21.0,112,3.0,12
804,609,843,9.636281179138322,10.936598639455783,27.0,14.0,241,1.0,234
805,609,830,9.636281179138322,11.377777777777778,27.0,8.0,233,2.0,221
806,609,820,9.636281179138322,12.399455782312925,27.0,3.0,242,3.0,211
807,487,162,10.936598639455783,12.213696145124716,19.0,35.0,330,1.0,325
808,487,62,10.936598639455783,13.374693877551021,19.0,29.0,438,2.0,425
809,487,268,10.936598639455783,12.60843537414966,19.0,21.0,231,2.0,219
810,487,265,10.936598639455783,13.119274376417234,19.0,20.0,241,2.0,222
811,487,600,10.936598639455783,12.445895691609978,19.0,22.0,130,2.0,113
812,487,546,10.936598639455783,13.421133786848072,19.0,3.0,122,2.0,59
813,487,621,10.936598639455783,12.213696145124716,19.0,21.0,145,1.0,134
814,487,672,10.936598639455783,13.119274376417234,19.0,11.0,208,2.0,185
815,487,820,10.936598639455783,12.399455782312925,19.0,3.0,339,1.0,333
816,609,268,11.377777777777778,12.60843537414966,17.0,21.0,345,1.0,341
817,609,265,11.377777777777778,13.119274376417234,17.0,20.0,352,2.0,344
818,609,600,11.377777777777778,12.445895691609978,17.0,22.0,47,1.0,9
819,609,546,11.377777777777778,13.421133786848072,17.0,3.0,108,2.0,63
820,609,672,11.377777777777778,13.119274376417234,17.0,11.0,98,2.0,63
821,609,820,11.377777777777778,12.399455782312925,17.0,3.0,216,1.0,211
822,600,204,12.445895691609978,14.930430839002268,22.0,29.0,410,2.0,396
823,600,162,12.445895691609978,15.39482993197279,22.0,33.0,456,3.0,438
824,600,213,12.445895691609978,14.97687074829932,22.0,40.0,402,3.0,387
825,600,213,12.445895691609978,15.000090702947846,22.0,35.0,402,3.0,387
826,600,597,12.445895691609978,14.930430839002268,22.0,17.0,107,2.0,3
827,600,670,12.445895691609978,14.907210884353741,22.0,19.0,127,2.0,70
828,600,618,12.445895691609978,15.371609977324264,22.0,13.0,127,3.0,18
829,600,914,12.445895691609978,14.907210884353741,22.0,8.0,331,2.0,314
830,600,859,12.445895691609978,15.371609977324264,22.0,3.0,288,3.0,259
831,546,204,13.421133786848072,14.930430839002268,3.0,29.0,348,2.0,342
832,546,162,13.421133786848072,15.39482993197279,3.0,33.0,393,2.0,384
833,546,213,13.421133786848072,14.97687074829932,3.0,40.0,340,2.0,333
834,546,213,13.421133786848072,15.000090702947846,3.0,35.0,340,2.0,333
835,546,597,13.421133786848072,14.930430839002268,3.0,17.0,83,2.0,51
836,546,604,13.421133786848072,15.696689342403628,3.0,15.0,114,2.0,58
837,546,670,13.421133786848072,14.907210884353741,3.0,19.0,140,1.0,124
838,546,618,13.421133786848072,15.371609977324264,3.0,13.0,111,2.0,72
839,546,914,13.421133786848072,14.907210884353741,3.0,8.0,374,1.0,368
840,546,859,13.421133786848072,15.371609977324264,3.0,3.0,324,2.0,313
841,597,162,14.930430839002268,16.950566893424035,17.0,30.0,444,2.0,435
842,597,183,14.930430839002268,17.60072562358277,17.0,36.0,430,3.0,414
843,597,240,14.930430839002268,16.50938775510204,17.0,29.0,363,2.0,357
844,597,614,14.930430839002268,16.46294784580499,17.0,23.0,68,2.0,17
845,597,604,14.930430839002268,17.716825396825396,17.0,18.0,120,3.0,7
846,597,615,14.930430839002268,16.46294784580499,17.0,24.0,68,2.0,18
847,597,622,14.930430839002268,17.020226757369613,17.0,17.0,93,2.0,25
848,597,848,14.930430839002268,16.439727891156462,17.0,9.0,259,2.0,251
849,597,838,14.930430839002268,17.020226757369613,17.0,4.0,257,2.0,241
850,604,162,15.696689342403628,16.950566893424035,15.0,30.0,445,1.0,442
851,604,183,15.696689342403628,17.60072562358277,15.0,36.0,429,2.0,421
852,604,255,15.696689342403628,17.949024943310658,15.0,31.0,362,2.0,349
853,604,257,15.696689342403628,17.99546485260771,15.0,28.0,361,2.0,347
854,604,611,15.696689342403628,17.99546485260771,15.0,13.0,99,2.0,7
855,604,622,15.696689342403628,17.020226757369613,15.0,17.0,60,1.0,18
856,604,676,15.696689342403628,17.99546485260771,15.0,11.0,122,2.0,72
857,604,838,15.696689342403628,17.020226757369613,15.0,4.0,241,1.0,234
858,604,902,15.696689342403628,17.99546485260771,15.0,1.0,314,2.0,298
859,614,183,16.46294784580499,17.60072562358277,23.0,36.0,434,1.0,431
860,614,164,16.46294784580499,19.272562358276645,23.0,20.0,466,3.0,450
861,614,255,16.46294784580499,17.949024943310658,23.0,31.0,365,1.0,359
862,614,257,16.46294784580499,17.99546485260771,23.0,28.0,363,2.0,357
863,614,264,16.46294784580499,19.29578231292517,23.0,19.0,371,3.0,350
864,614,604,16.46294784580499,17.716825396825396,23.0,18.0,55,1.0,10
865,614,611,16.46294784580499,17.99546485260771,23.0,13.0,66,2.0,3
866,614,440,16.46294784580499,19.272562358276645,23.0,10.0,212,3.0,174
867,614,676,16.46294784580499,17.99546485260771,23.0,11.0,91,2.0,62
868,614,902,16.46294784580499,17.99546485260771,23.0,1.0,295,2.0,288
869,604,164,17.716825396825396,19.272562358276645,18.0,20.0,445,2.0,440
870,604,264,17.716825396825396,19.29578231292517,18.0,19.0,347,2.0,340
871,604,232,17.716825396825396,20.572879818594103,18.0,34.0,392,3.0,372
872,604,440,17.716825396825396,19.272562358276645,18.0,10.0,177,2.0,164
873,611,164,17.99546485260771,19.272562358276645,13.0,20.0,450,1.0,447
874,611,183,17.99546485260771,20.805079365079365,13.0,29.0,445,3.0,428
875,611,264,17.99546485260771,19.29578231292517,13.0,19.0,351,1.0,347
876,611,232,17.99546485260771,20.572879818594103,13.0,34.0,395,3.0,379
877,611,440,17.99546485260771,19.272562358276645,13.0,10.0,180,1.0,171
878,611,550,17.99546485260771,20.805079365079365,13.0,11.0,136,3.0,61
879,611,683,17.99546485260771,20.82829931972789,13.0,15.0,142,3.0,72
880,611,839,17.99546485260771,20.805079365079365,13.0,10.0,258,3.0,228
881,440,183,19.272562358276645,20.805079365079365,10.0,29.0,265,2.0,257
882,440,81,19.272562358276645,21.61777777777778,10.0,35.0,373,2.0,359
883,440,232,19.272562358276645,20.572879818594103,10.0,34.0,215,1.0,208
884,440,291,19.272562358276645,21.89641723356009,10.0,13.0,187,3.0,149
885,440,550,19.272562358276645,20.805079365079365,10.0,11.0,128,2.0,110
886,440,605,19.272562358276645,21.106938775510205,10.0,21.0,183,2.0,165
887,440,683,19.272562358276645,20.82829931972789,10.0,15.0,252,2.0,243
888,440,674,19.272562358276645,21.08371882086168,10.0,25.0,247,2.0,234
889,440,839,19.272562358276645,20.805079365079365,10.0,10.0,404,2.0,399
890,440,862,19.272562358276645,21.08371882086168,10.0,14.0,429,2.0,422
891,550,64,20.805079365079365,23.289614512471655,11.0,36.0,498,2.0,486
892,550,291,20.805079365079365,21.89641723356009,11.0,13.0,263,1.0,259
893,550,228,20.805079365079365,22.871655328798187,11.0,28.0,334,2.0,322
894,550,255,20.805079365079365,23.26639455782313,11.0,34.0,313,2.0,295
895,550,461,20.805079365079365,22.80199546485261,11.0,26.0,124,2.0,89
896,550,421,20.805079365079365,23.26639455782313,11.0,8.0,167,2.0,129
897,550,615,20.805079365079365,22.80199546485261,11.0,20.0,108,2.0,65
898,550,622,20.805079365079365,23.312834467120183,11.0,11.0,130,3.0,72
899,550,858,20.805079365079365,22.80199546485261,11.0,12.0,320,2.0,308
900,550,917,20.805079365079365,23.73079365079365,11.0,0.0,388,3.0,367
901,605,228,21.106938775510205,22.871655328798187,21.0,28.0,385,2.0,377
902,605,255,21.106938775510205,23.26639455782313,21.0,34.0,362,2.0,350
903,605,242,21.106938775510205,23.986213151927437,21.0,28.0,384,3.0,363
904,605,461,21.106938775510205,22.80199546485261,21.0,26.0,161,2.0,144
905,605,421,21.106938775510205,23.26639455782313,21.0,8.0,206,2.0,184
906,605,615,21.106938775510205,22.80199546485261,21.0,20.0,74,2.0,10
907,605,622,21.106938775510205,23.312834467120183,21.0,11.0,97,2.0,17
908,605,858,21.106938775510205,22.80199546485261,21.0,12.0,263,2.0,253
909,605,917,21.106938775510205,23.73079365079365,21.0,0.0,332,3.0,312
910,461,64,22.80199546485261,24.68281179138322,26.0,32.0,405,2.0,397
911,461,64,22.80199546485261,25.054331065759637,26.0,33.0,409,2.0,397
912,461,242,22.80199546485261,23.986213151927437,26.0,28.0,225,1.0,219
913,461,228,22.80199546485261,25.58839002267574,26.0,24.0,262,3.0,233
914,461,613,22.80199546485261,24.86857142857143,26.0,5.0,176,2.0,152
915,461,609,22.80199546485261,25.054331065759637,26.0,9.0,177,2.0,148
916,461,682,22.80199546485261,24.79891156462585,26.0,8.0,237,2.0,221
917,461,674,22.80199546485261,25.21687074829932,26.0,17.0,237,2.0,213
918,461,835,22.80199546485261,24.729251700680273,26.0,-1.0,383,2.0,374
919,421,64,23.26639455782313,24.68281179138322,8.0,32.0,362,1.0,357
920,421,64,23.26639455782313,25.054331065759637,8.0,33.0,365,2.0,357
921,421,228,23.26639455782313,25.58839002267574,8.0,24.0,217,2.0,193
922,421,613,23.26639455782313,24.86857142857143,8.0,5.0,204,2.0,192
923,421,609,23.26639455782313,25.054331065759637,8.0,9.0,203,2.0,188
924,421,682,23.26639455782313,24.79891156462585,8.0,8.0,269,2.0,261
925,421,674,23.26639455782313,25.21687074829932,8.0,17.0,267,2.0,253
926,421,835,23.26639455782313,24.729251700680273,8.0,-1.0,419,1.0,414
927,613,244,24.86857142857143,26.377868480725624,5.0,19.0,375,2.0,369
928,613,236,24.86857142857143,27.16734693877551,5.0,32.0,390,2.0,377
929,613,490,24.86857142857143,26.911927437641722,5.0,-4.0,151,2.0,123
930,613,590,24.86857142857143,27.144126984126984,5.0,18.0,101,2.0,23
931,613,682,24.86857142857143,26.772607709750567,5.0,5.0,107,2.0,69
932,613,617,24.86857142857143,27.12090702947846,5.0,21.0,97,2.0,4
933,613,901,24.86857142857143,27.12090702947846,5.0,7.0,304,2.0,288
934,609,244,25.054331065759637,26.377868480725624,9.0,19.0,369,1.0,365
935,609,236,25.054331065759637,27.16734693877551,9.0,32.0,384,2.0,373
936,609,246,25.054331065759637,28.026485260770976,9.0,24.0,385,3.0,363
937,609,490,25.054331065759637,26.911927437641722,9.0,-4.0,143,2.0,119
938,609,590,25.054331065759637,27.144126984126984,9.0,18.0,92,2.0,19
939,609,682,25.054331065759637,26.772607709750567,9.0,5.0,104,2.0,73
940,609,617,25.054331065759637,27.12090702947846,9.0,21.0,89,2.0,8
941,609,901,25.054331065759637,27.12090702947846,9.0,7.0,305,2.0,292
942,490,102,26.911927437641722,28.699863945578233,-4.0,16.0,396,2.0,388
943,490,164,26.911927437641722,29.675102040816327,-4.0,15.0,347,3.0,326
944,490,246,26.911927437641722,28.026485260770976,-4.0,24.0,249,1.0,244
945,490,234,26.911927437641722,29.675102040816327,-4.0,6.0,282,3.0,256
946,490,609,26.911927437641722,28.76952380952381,-4.0,26.0,143,2.0,119
947,490,622,26.911927437641722,28.76952380952381,-4.0,28.0,154,2.0,132
948,490,835,26.911927437641722,28.76952380952381,-4.0,16.0,354,2.0,345
949,590,102,27.144126984126984,28.699863945578233,18.0,16.0,493,2.0,488
950,590,164,27.144126984126984,29.675102040816327,18.0,15.0,440,3.0,426
951,590,234,27.144126984126984,29.675102040816327,18.0,6.0,372,3.0,356
952,590,609,27.144126984126984,28.76952380952381,18.0,26.0,73,2.0,19
953,590,622,27.144126984126984,28.76952380952381,18.0,28.0,77,2.0,32
954,590,835,27.144126984126984,28.76952380952381,18.0,16.0,255,2.0,245
955,609,182,28.76952380952381,31.62557823129252,26.0,22.0,444,3.0,427
956,609,213,28.76952380952381,30.65034013605442,26.0,24.0,404,2.0,396
957,609,236,28.76952380952381,31.37015873015873,26.0,26.0,389,3.0,373
958,609,604,28.76952380952381,30.441360544217687,26.0,25.0,72,2.0,5
959,609,517,28.76952380952381,31.71845804988662,26.0,6.0,157,3.0,92
960,609,663,28.76952380952381,30.441360544217687,26.0,24.0,90,2.0,54
961,609,677,28.76952380952381,31.71845804988662,26.0,8.0,144,3.0,68
962,609,837,28.76952380952381,30.464580498866212,26.0,20.0,239,2.0,228
963,604,182,30.441360544217687,31.62557823129252,25.0,22.0,425,1.0,422
964,604,202,30.441360544217687,32.113197278911564,25.0,17.0,408,2.0,402
965,604,213,30.441360544217687,32.08997732426304,25.0,22.0,397,2.0,391
966,604,517,30.441360544217687,31.71845804988662,25.0,6.0,103,1.0,87
967,604,608,30.441360544217687,32.113197278911564,25.0,26.0,72,2.0,4
968,604,677,30.441360544217687,31.71845804988662,25.0,8.0,91,1.0,73
969,604,623,30.441360544217687,32.113197278911564,25.0,29.0,74,2.0,19
970,604,846,30.441360544217687,32.113197278911564,25.0,11.0,252,2.0,242
971,517,31,31.71845804988662,33.78503401360544,6.0,18.0,494,2.0,486
972,517,236,31.71845804988662,33.715374149659866,6.0,25.0,294,2.0,281
973,517,258,31.71845804988662,34.57451247165533,6.0,34.0,287,3.0,259
974,517,608,31.71845804988662,33.69215419501134,6.0,23.0,125,2.0,91
975,517,537,31.71845804988662,34.57451247165533,6.0,11.0,125,3.0,20
976,517,625,31.71845804988662,33.69215419501134,6.0,20.0,137,2.0,108
977,517,829,31.71845804988662,33.69215419501134,6.0,13.0,323,2.0,312
978,517,913,31.71845804988662,34.5512925170068,6.0,-1.0,414,3.0,396
979,608,195,32.113197278911564,34.80671201814059,26.0,30.0,429,3.0,413
980,608,236,32.113197278911564,33.715374149659866,26.0,25.0,378,2.0,372
981,608,258,32.113197278911564,34.57451247165533,26.0,34.0,366,2.0,350
982,608,208,32.113197278911564,35.03891156462585,26.0,32.0,419,3.0,400
983,608,537,32.113197278911564,34.57451247165533,26.0,11.0,128,2.0,71
984,608,625,32.113197278911564,33.69215419501134,26.0,20.0,70,2.0,17
985,608,669,32.113197278911564,34.76027210884354,26.0,8.0,129,3.0,61
986,608,829,32.113197278911564,33.69215419501134,26.0,13.0,231,2.0,221
987,608,913,32.113197278911564,34.5512925170068,26.0,-1.0,323,2.0,305
988,608,195,33.69215419501134,34.80671201814059,23.0,30.0,416,1.0,413
989,608,208,33.69215419501134,35.03891156462585,23.0,32.0,404,1.0,400
990,608,237,33.69215419501134,36.52498866213152,23.0,29.0,391,3.0,371
991,608,614,33.69215419501134,35.34077097505669,23.0,32.0,71,2.0,6
992,608,669,33.69215419501134,34.76027210884354,23.0,8.0,76,1.0,61
993,608,617,33.69215419501134,35.31755102040817,23.0,30.0,71,2.0,9
994,608,838,33.69215419501134,35.34077097505669,23.0,19.0,241,2.0,230
995,537,64,34.57451247165533,36.91972789115646,11.0,43.0,484,2.0,473
996,537,63,34.57451247165533,36.989387755102044,11.0,33.0,485,2.0,474
997,537,237,34.57451247165533,36.52498866213152,11.0,29.0,312,2.0,300
998,537,614,34.57451247165533,36.91972789115646,11.0,29.0,127,2.0,77
999,537,601,34.57451247165533,36.989387755102044,11.0,13.0,122,2.0,64
1000,537,616,34.57451247165533,36.91972789115646,11.0,29.0,128,2.0,79
1001,537,846,34.57451247165533,36.94294784580499,11.0,8.0,325,2.0,309
1002,614,237,35.34077097505669,36.52498866213152,32.0,29.0,380,1.0,377
1003,614,214,35.34077097505669,37.77886621315193,32.0,31.0,414,2.0,400
1004,614,271,35.34077097505669,37.987845804988666,32.0,18.0,361,3.0,343
1005,614,601,35.34077097505669,36.989387755102044,32.0,13.0,72,2.0,13
1006,614,616,35.34077097505669,36.91972789115646,32.0,29.0,68,2.0,2
1007,614,619,35.34077097505669,37.89496598639456,32.0,15.0,110,3.0,5
1008,614,846,35.34077097505669,36.94294784580499,32.0,8.0,242,2.0,232
1009,614,835,35.34077097505669,37.77886621315193,32.0,0.0,245,2.0,221
1010,614,164,36.91972789115646,39.450702947845805,29.0,12.0,463,3.0,450
1011,614,271,36.91972789115646,37.987845804988666,29.0,18.0,346,1.0,343
1012,614,233,36.91972789115646,39.42748299319728,29.0,12.0,396,3.0,381
1013,614,607,36.91972789115646,38.59156462585034,29.0,26.0,72,2.0,7
1014,614,467,36.91972789115646,39.404263038548756,29.0,-4.0,182,2.0,147
1015,614,626,36.91972789115646,38.568344671201814,29.0,30.0,72,2.0,12
1016,614,835,36.91972789115646,38.568344671201814,29.0,19.0,232,2.0,221
1017,601,164,36.989387755102044,39.450702947845805,13.0,12.0,450,2.0,437
1018,601,233,36.989387755102044,39.42748299319728,13.0,12.0,383,2.0,368
1019,601,607,36.989387755102044,38.59156462585034,13.0,26.0,69,2.0,6
1020,601,467,36.989387755102044,39.404263038548756,13.0,-4.0,170,2.0,134
1021,601,626,36.989387755102044,38.568344671201814,13.0,30.0,72,2.0,25
1022,601,835,36.989387755102044,38.568344671201814,13.0,19.0,244,2.0,234
1023,607,164,38.59156462585034,41.00643990929705,26.0,32.0,455,2.0,443
1024,607,237,38.59156462585034,40.170521541950116,26.0,13.0,376,2.0,370
1025,607,271,38.59156462585034,41.07609977324263,26.0,31.0,353,2.0,336
1026,607,613,38.59156462585034,40.170521541950116,26.0,31.0,68,2.0,6
1027,607,615,38.59156462585034,40.170521541950116,26.0,30.0,68,2.0,8
1028,607,830,38.59156462585034,40.170521541950116,26.0,13.0,233,2.0,223
1029,467,72,39.404263038548756,40.63492063492063,-4.0,21.0,399,1.0,395
1030,467,164,39.404263038548756,41.00643990929705,-4.0,32.0,311,2.0,303
1031,467,271,39.404263038548756,41.07609977324263,-4.0,31.0,209,2.0,196
1032,467,238,39.404263038548756,42.26031746031746,-4.0,32.0,260,3.0,229
1033,467,609,39.404263038548756,41.79591836734694,-4.0,27.0,175,2.0,142
1034,467,622,39.404263038548756,41.79591836734694,-4.0,28.0,186,2.0,155
1035,467,820,39.404263038548756,41.79591836734694,-4.0,21.0,368,2.0,353
1036,613,238,40.170521541950116,42.26031746031746,31.0,32.0,386,2.0,375
1037,613,255,40.170521541950116,43.049795918367344,31.0,24.0,379,3.0,358
1038,613,609,40.170521541950116,41.79591836734694,31.0,27.0,70,2.0,4
1039,613,609,40.170521541950116,42.63183673469388,31.0,16.0,106,2.0,4
1040,613,622,40.170521541950116,41.79591836734694,31.0,28.0,71,2.0,9
1041,613,616,40.170521541950116,42.6550566893424,31.0,14.0,107,2.0,3
1042,613,820,40.170521541950116,41.79591836734694,31.0,21.0,219,2.0,207
1043,613,843,40.170521541950116,42.678276643990934,31.0,2.0,254,3.0,230
1044,609,255,41.79591836734694,43.049795918367344,27.0,24.0,358,1.0,354
1045,609,229,41.79591836734694,44.23401360544218,27.0,19.0,394,2.0,380
1046,609,610,41.79591836734694,43.39809523809524,27.0,26.0,69,2.0,1
1047,609,602,41.79591836734694,44.0714739229025,27.0,23.0,98,2.0,7
1048,609,616,41.79591836734694,43.39809523809524,27.0,26.0,69,2.0,7
1049,609,616,41.79591836734694,44.04825396825397,27.0,25.0,97,2.0,7
1050,609,836,41.79591836734694,43.39809523809524,27.0,19.0,237,2.0,227
1051,609,837,41.79591836734694,44.0714739229025,27.0,11.0,248,2.0,228
1052,609,229,42.63183673469388,44.23401360544218,16.0,19.0,386,2.0,380
1053,609,324,42.63183673469388,45.04671201814059,16.0,15.0,303,2.0,285
1054,609,602,42.63183673469388,44.0714739229025,16.0,23.0,62,1.0,7
1055,609,614,42.63183673469388,45.00027210884354,16.0,29.0,102,2.0,5
1056,609,616,42.63183673469388,44.04825396825397,16.0,25.0,61,1.0,7
1057,609,623,42.63183673469388,45.00027210884354,16.0,29.0,103,2.0,14
1058,609,837,42.63183673469388,44.0714739229025,16.0,11.0,236,1.0,228
1059,609,820,42.63183673469388,45.023492063492064,16.0,16.0,235,2.0,211
1060,610,324,43.39809523809524,45.04671201814059,26.0,15.0,295,2.0,286
1061,610,614,43.39809523809524,45.00027210884354,26.0,29.0,69,2.0,4
1062,610,623,43.39809523809524,45.00027210884354,26.0,29.0,70,2.0,13
1063,610,820,43.39809523809524,45.023492063492064,26.0,16.0,221,2.0,210
1064,602,227,44.0714739229025,46.64888888888889,23.0,19.0,391,3.0,375
1065,602,591,44.0714739229025,46.625668934240366,23.0,21.0,111,3.0,11
1066,602,618,44.0714739229025,46.625668934240366,23.0,32.0,111,3.0,16
1067,602,822,44.0714739229025,46.625668934240366,23.0,19.0,246,3.0,220
1068,614,170,45.00027210884354,47.64734693877551,29.0,25.0,458,3.0,444
1069,614,227,45.00027210884354,46.64888888888889,29.0,19.0,393,2.0,387
1070,614,215,45.00027210884354,47.18294784580499,29.0,25.0,410,2.0,399
1071,614,591,45.00027210884354,46.625668934240366,29.0,21.0,74,2.0,23
1072,614,601,45.00027210884354,47.275827664399095,29.0,11.0,99,2.0,13
1073,614,618,45.00027210884354,46.625668934240366,29.0,32.0,70,2.0,4
1074,614,673,45.00027210884354,47.18294784580499,29.0,11.0,111,2.0,59
1075,614,822,45.00027210884354,46.625668934240366,29.0,19.0,219,2.0,208
1076,591,170,46.625668934240366,47.64734693877551,21.0,25.0,423,1.0,421
1077,591,237,46.625668934240366,48.27428571428572,21.0,29.0,361,2.0,354
1078,591,614,46.625668934240366,48.251065759637186,21.0,26.0,74,2.0,23
1079,591,623,46.625668934240366,48.251065759637186,21.0,29.0,77,2.0,32
1080,591,835,46.625668934240366,48.251065759637186,21.0,20.0,254,2.0,244
1081,601,183,47.275827664399095,49.83002267573696,11.0,35.0,432,3.0,418
1082,601,236,47.275827664399095,49.87646258503401,11.0,36.0,382,3.0,365
1083,601,610,47.275827664399095,49.85324263038549,11.0,26.0,111,3.0,9
1084,601,626,47.275827664399095,49.85324263038549,11.0,34.0,114,3.0,25
1085,601,822,47.275827664399095,49.85324263038549,11.0,19.0,247,3.0,221
1086,614,183,48.251065759637186,49.83002267573696,26.0,35.0,436,2.0,431
1087,614,236,48.251065759637186,49.87646258503401,26.0,36.0,384,2.0,378
1088,614,239,48.251065759637186,50.36408163265306,26.0,21.0,386,2.0,375
1089,614,610,48.251065759637186,49.85324263038549,26.0,26.0,69,2.0,4
1090,614,626,48.251065759637186,49.85324263038549,26.0,34.0,70,2.0,12
1091,614,664,48.251065759637186,50.78204081632653,26.0,-4.0,120,3.0,50
1092,614,822,48.251065759637186,49.85324263038549,26.0,19.0,219,2.0,208
1093,610,223,49.85324263038549,51.50185941043084,26.0,28.0,393,2.0,387
1094,610,238,49.85324263038549,52.22167800453515,26.0,22.0,386,2.0,372
1095,610,603,49.85324263038549,51.478639455782314,26.0,24.0,70,2.0,7
1096,610,605,49.85324263038549,52.244897959183675,26.0,29.0,103,2.0,5
1097,610,626,49.85324263038549,51.50185941043084,26.0,30.0,73,2.0,16
1098,610,619,49.85324263038549,52.244897959183675,26.0,28.0,103,2.0,9
1099,610,820,49.85324263038549,51.50185941043084,26.0,21.0,222,2.0,210
1100,610,820,49.85324263038549,52.244897959183675,26.0,14.0,234,2.0,210
1101,603,228,51.478639455782314,53.080816326530616,24.0,21.0,381,2.0,375
1102,603,612,51.478639455782314,53.011156462585035,24.0,29.0,67,2.0,9
1103,603,621,51.478639455782314,53.011156462585035,24.0,28.0,68,2.0,18
1104,603,830,51.478639455782314,53.011156462585035,24.0,16.0,236,2.0,227
1105,605,182,52.244897959183675,54.68299319727891,29.0,27.0,436,2.0,423
1106,605,253,52.244897959183675,54.91519274376417,29.0,25.0,370,3.0,352
1107,605,610,52.244897959183675,54.63655328798186,29.0,22.0,103,2.0,5
1108,605,603,52.244897959183675,55.147392290249435,29.0,24.0,125,3.0,2
1109,605,676,52.244897959183675,54.61333333333334,29.0,16.0,124,2.0,71
1110,605,622,52.244897959183675,55.147392290249435,29.0,26.0,126,3.0,17
1111,605,828,52.244897959183675,54.61333333333334,29.0,15.0,245,2.0,223
1112,605,829,52.244897959183675,55.12417233560091,29.0,7.0,256,3.0,224
1113,612,182,53.011156462585035,54.68299319727891,29.0,27.0,436,2.0,430
1114,612,253,53.011156462585035,54.91519274376417,29.0,25.0,368,2.0,359
1115,612,211,53.011156462585035,55.843990929705214,29.0,32.0,419,3.0,401
1116,612,610,53.011156462585035,54.63655328798186,29.0,22.0,70,2.0,2
1117,612,603,53.011156462585035,55.147392290249435,29.0,24.0,92,2.0,9
1118,612,676,53.011156462585035,54.61333333333334,29.0,16.0,94,2.0,64
1119,612,622,53.011156462585035,55.147392290249435,29.0,26.0,93,2.0,10
1120,612,828,53.011156462585035,54.61333333333334,29.0,15.0,227,2.0,216
1121,612,829,53.011156462585035,55.12417233560091,29.0,7.0,235,2.0,217
1122,610,161,54.63655328798186,56.79600907029479,22.0,35.0,459,2.0,449
1123,610,211,54.63655328798186,55.843990929705214,22.0,32.0,402,1.0,399
1124,610,242,54.63655328798186,56.81922902494331,22.0,28.0,380,2.0,368
1125,610,608,54.63655328798186,56.86566893424036,22.0,24.0,96,2.0,2
1126,610,609,54.63655328798186,57.283628117913835,22.0,19.0,114,3.0,1
1127,610,620,54.63655328798186,56.029750566893426,22.0,26.0,61,1.0,10
1128,610,830,54.63655328798186,56.86566893424036,22.0,19.0,240,2.0,220
1129,610,829,54.63655328798186,57.283628117913835,22.0,18.0,247,3.0,219
1130,603,161,55.147392290249435,56.79600907029479,24.0,35.0,448,2.0,442
1131,603,242,55.147392290249435,56.81922902494331,24.0,28.0,368,2.0,361
1132,603,239,55.147392290249435,57.67836734693878,24.0,30.0,380,3.0,364
1133,603,608,55.147392290249435,56.86566893424036,24.0,24.0,74,2.0,5
1134,603,609,55.147392290249435,57.283628117913835,24.0,19.0,92,2.0,6
1135,603,599,55.147392290249435,58.096326530612245,24.0,22.0,127,3.0,4
1136,603,661,55.147392290249435,57.7015873015873,24.0,18.0,124,3.0,58
1137,603,684,55.147392290249435,58.096326530612245,24.0,23.0,151,3.0,81
1138,603,830,55.147392290249435,56.86566893424036,24.0,19.0,239,2.0,227
1139,603,829,55.147392290249435,57.283628117913835,24.0,18.0,244,2.0,226
1140,603,829,55.147392290249435,58.096326530612245,24.0,19.0,259,3.0,226
1141,608,242,56.86566893424036,58.258866213151926,24.0,25.0,371,1.0,366
1142,608,237,56.86566893424036,59.44308390022676,24.0,36.0,387,3.0,371
1143,608,599,56.86566893424036,58.096326530612245,24.0,22.0,54,1.0,9
1144,608,416,56.86566893424036,59.32698412698413,24.0,14.0,219,2.0,192
1145,608,684,56.86566893424036,58.096326530612245,24.0,23.0,93,1.0,76
1146,608,660,56.86566893424036,59.350204081632654,24.0,13.0,119,2.0,52
1147,608,829,56.86566893424036,58.096326530612245,24.0,19.0,227,1.0,221
1148,608,829,56.86566893424036,59.32698412698413,24.0,21.0,245,2.0,221
1149,609,237,57.283628117913835,59.44308390022676,19.0,36.0,383,2.0,372
1150,609,416,57.283628117913835,59.32698412698413,19.0,14.0,212,2.0,193
1151,609,660,57.283628117913835,59.350204081632654,19.0,13.0,103,2.0,51
1152,609,829,57.283628117913835,59.32698412698413,19.0,21.0,237,2.0,220
1153,599,237,58.096326530612245,59.44308390022676,22.0,36.0,367,1.0,362
1154,599,416,58.096326530612245,59.32698412698413,22.0,14.0,191,1.0,183
1155,599,660,58.096326530612245,59.350204081632654,22.0,13.0,81,1.0,61
1156,599,829,58.096326530612245,59.32698412698413,22.0,21.0,236,1.0,230
1157,655,248,1.7647165532879818,3.320453514739229,8.0,22.0,412,2.0,407
1158,655,596,1.7647165532879818,3.3436734693877552,8.0,6.0,90,2.0,59
1159,655,474,1.7647165532879818,4.4117913832199545,8.0,14.0,214,3.0,181
1160,655,619,1.7647165532879818,3.2275736961451247,8.0,4.0,73,1.0,36
1161,655,836,1.7647165532879818,4.388571428571429,8.0,-4.0,213,3.0,181
1162,643,261,2.345215419501134,4.85297052154195,12.0,21.0,397,3.0,382
1163,643,247,2.345215419501134,5.294149659863946,12.0,31.0,416,3.0,396
1164,643,474,2.345215419501134,4.4117913832199545,12.0,14.0,191,2.0,169
1165,643,603,2.345215419501134,5.294149659863946,12.0,13.0,133,3.0,40
1166,643,655,2.345215419501134,4.388571428571429,12.0,14.0,89,2.0,12
1167,643,616,2.345215419501134,4.992290249433107,12.0,13.0,117,3.0,27
1168,643,836,2.345215419501134,4.388571428571429,12.0,-4.0,212,2.0,193
1169,619,261,3.2275736961451247,4.85297052154195,4.0,21.0,365,2.0,358
1170,619,247,3.2275736961451247,5.294149659863946,4.0,31.0,382,2.0,372
1171,619,474,3.2275736961451247,4.4117913832199545,4.0,14.0,154,1.0,145
1172,619,603,3.2275736961451247,5.294149659863946,4.0,13.0,90,2.0,16
1173,619,655,3.2275736961451247,4.388571428571429,4.0,14.0,62,1.0,36
1174,619,616,3.2275736961451247,4.992290249433107,4.0,13.0,76,2.0,3
1175,619,836,3.2275736961451247,4.388571428571429,4.0,-4.0,223,1.0,217
1176,655,278,4.388571428571429,6.431927437641724,14.0,24.0,387,2.0,377
1177,655,221,4.388571428571429,7.291065759637188,14.0,21.0,452,3.0,434
1178,655,585,4.388571428571429,6.315827664399093,14.0,10.0,109,2.0,70
1179,655,463,4.388571428571429,7.267845804988662,14.0,3.0,229,3.0,192
1180,655,621,4.388571428571429,6.315827664399093,14.0,8.0,90,2.0,34
1181,655,704,4.388571428571429,7.291065759637188,14.0,-3.0,134,3.0,49
1182,616,278,4.992290249433107,6.431927437641724,13.0,24.0,344,1.0,338
1183,616,221,4.992290249433107,7.291065759637188,13.0,21.0,407,2.0,395
1184,616,585,4.992290249433107,6.315827664399093,13.0,10.0,65,1.0,31
1185,616,463,4.992290249433107,7.267845804988662,13.0,3.0,182,2.0,153
1186,616,621,4.992290249433107,6.315827664399093,13.0,8.0,57,1.0,5
1187,616,704,4.992290249433107,7.291065759637188,13.0,-3.0,132,2.0,88
1188,621,246,6.315827664399093,8.452063492063493,8.0,32.0,386,2.0,375
1189,621,601,6.315827664399093,8.034104308390022,8.0,25.0,77,2.0,20
1190,621,677,6.315827664399093,8.010884353741497,8.0,26.0,92,2.0,56
1191,621,866,6.315827664399093,8.010884353741497,8.0,11.0,256,2.0,245
1192,704,246,7.291065759637188,8.452063492063493,-3.0,32.0,461,1.0,458
1193,704,230,7.291065759637188,9.7059410430839,-3.0,21.0,485,2.0,474
1194,704,609,7.291065759637188,9.636281179138322,-3.0,27.0,139,2.0,95
1195,704,615,7.291065759637188,9.636281179138322,-3.0,27.0,135,2.0,89
1196,704,833,7.291065759637188,9.58984126984127,-3.0,16.0,163,2.0,129
1197,677,230,8.010884353741497,9.7059410430839,26.0,21.0,453,2.0,447
1198,677,260,8.010884353741497,10.936598639455783,26.0,37.0,436,3.0,417
1199,677,609,8.010884353741497,9.636281179138322,26.0,27.0,98,2.0,68
1200,677,487,8.010884353741497,10.936598639455783,26.0,19.0,228,3.0,190
1201,677,615,8.010884353741497,9.636281179138322,26.0,27.0,94,2.0,62
1202,677,618,8.010884353741497,10.95981859410431,26.0,15.0,140,3.0,59
1203,677,833,8.010884353741497,9.58984126984127,26.0,16.0,170,2.0,156
1204,677,843,8.010884353741497,10.936598639455783,26.0,14.0,208,3.0,166
1205,615,163,9.636281179138322,10.983038548752834,27.0,37.0,456,1.0,452
1206,615,162,9.636281179138322,12.213696145124716,27.0,35.0,466,3.0,453
1207,615,260,9.636281179138322,10.936598639455783,27.0,37.0,359,1.0,355
1208,615,213,9.636281179138322,11.609977324263038,27.0,36.0,411,2.0,402
1209,615,268,9.636281179138322,12.60843537414966,27.0,21.0,370,3.0,347
1210,615,487,9.636281179138322,10.936598639455783,27.0,19.0,140,1.0,128
1211,615,609,9.636281179138322,11.377777777777778,27.0,17.0,75,2.0,6
1212,615,600,9.636281179138322,12.445895691609978,27.0,22.0,122,3.0,15
1213,615,618,9.636281179138322,10.95981859410431,27.0,15.0,57,1.0,3
1214,615,618,9.636281179138322,11.00625850340136,27.0,21.0,59,1.0,3
1215,615,621,9.636281179138322,12.213696145124716,27.0,21.0,111,3.0,6
1216,615,843,9.636281179138322,10.936598639455783,27.0,14.0,235,1.0,228
1217,615,830,9.636281179138322,11.377777777777778,27.0,8.0,228,2.0,215
1218,615,820,9.636281179138322,12.399455782312925,27.0,3.0,237,3.0,205
1219,618,162,10.95981859410431,12.213696145124716,15.0,35.0,459,1.0,456
1220,618,268,10.95981859410431,12.60843537414966,15.0,21.0,357,2.0,350
1221,618,265,10.95981859410431,13.119274376417234,15.0,20.0,365,2.0,353
1222,618,600,10.95981859410431,12.445895691609978,15.0,22.0,66,1.0,18
1223,618,546,10.95981859410431,13.421133786848072,15.0,3.0,128,2.0,72
1224,618,621,10.95981859410431,12.213696145124716,15.0,21.0,54,1.0,3
1225,618,672,10.95981859410431,13.119274376417234,15.0,11.0,108,2.0,54
1226,618,820,10.95981859410431,12.399455782312925,15.0,3.0,211,1.0,202
1227,618,162,11.00625850340136,12.213696145124716,21.0,35.0,459,1.0,456
1228,618,268,11.00625850340136,12.60843537414966,21.0,21.0,357,2.0,350
1229,618,265,11.00625850340136,13.119274376417234,21.0,20.0,365,2.0,353
1230,618,600,11.00625850340136,12.445895691609978,21.0,22.0,65,1.0,18
1231,618,546,11.00625850340136,13.421133786848072,21.0,3.0,126,2.0,72
1232,618,621,11.00625850340136,12.213696145124716,21.0,21.0,52,1.0,3
1233,618,672,11.00625850340136,13.119274376417234,21.0,11.0,106,2.0,54
1234,618,820,11.00625850340136,12.399455782312925,21.0,3.0,211,1.0,202
1235,621,204,12.213696145124716,14.930430839002268,21.0,29.0,433,3.0,417
1236,621,213,12.213696145124716,14.97687074829932,21.0,40.0,425,3.0,408
1237,621,213,12.213696145124716,15.000090702947846,21.0,35.0,425,3.0,408
1238,621,546,12.213696145124716,13.421133786848072,21.0,3.0,91,1.0,75
1239,621,597,12.213696145124716,14.930430839002268,21.0,17.0,119,3.0,24
1240,621,670,12.213696145124716,14.907210884353741,21.0,19.0,126,3.0,49
1241,621,914,12.213696145124716,14.907210884353741,21.0,8.0,315,3.0,293
1242,672,204,13.119274376417234,14.930430839002268,11.0,29.0,474,2.0,468
1243,672,213,13.119274376417234,14.97687074829932,11.0,40.0,466,2.0,459
1244,672,213,13.119274376417234,15.000090702947846,11.0,35.0,466,2.0,459
1245,672,597,13.119274376417234,14.930430839002268,11.0,17.0,108,2.0,75
1246,672,604,13.119274376417234,15.696689342403628,11.0,15.0,130,3.0,68
1247,672,670,13.119274376417234,14.907210884353741,11.0,19.0,77,2.0,2
1248,672,618,13.119274376417234,15.371609977324264,11.0,13.0,111,2.0,54
1249,672,914,13.119274376417234,14.907210884353741,11.0,8.0,254,2.0,242
1250,672,859,13.119274376417234,15.371609977324264,11.0,3.0,211,2.0,187
1251,670,183,14.907210884353741,17.60072562358277,19.0,36.0,501,3.0,487
1252,670,240,14.907210884353741,16.50938775510204,19.0,29.0,436,2.0,430
1253,670,614,14.907210884353741,16.46294784580499,19.0,23.0,87,2.0,56
1254,670,604,14.907210884353741,17.716825396825396,19.0,18.0,138,3.0,66
1255,670,615,14.907210884353741,16.46294784580499,19.0,24.0,87,2.0,55
1256,670,622,14.907210884353741,17.020226757369613,19.0,17.0,103,2.0,48
1257,670,848,14.907210884353741,16.439727891156462,19.0,9.0,190,2.0,178
1258,670,838,14.907210884353741,17.020226757369613,19.0,4.0,191,2.0,168
1259,618,162,15.371609977324264,16.950566893424035,13.0,30.0,461,2.0,456
1260,618,183,15.371609977324264,17.60072562358277,13.0,36.0,445,2.0,435
1261,618,240,15.371609977324264,16.50938775510204,13.0,29.0,381,1.0,378
1262,618,255,15.371609977324264,17.949024943310658,13.0,31.0,380,3.0,363
1263,618,257,15.371609977324264,17.99546485260771,13.0,28.0,378,3.0,361
1264,618,614,15.371609977324264,16.46294784580499,13.0,23.0,47,1.0,4
1265,618,604,15.371609977324264,17.716825396825396,13.0,18.0,102,2.0,14
1266,618,611,15.371609977324264,17.99546485260771,13.0,13.0,113,3.0,7
1267,618,615,15.371609977324264,16.46294784580499,13.0,24.0,47,1.0,3
1268,618,622,15.371609977324264,17.020226757369613,13.0,17.0,71,2.0,4
1269,618,676,15.371609977324264,17.99546485260771,13.0,11.0,127,3.0,58
1270,618,848,15.371609977324264,16.439727891156462,13.0,9.0,235,1.0,230
1271,618,838,15.371609977324264,17.020226757369613,13.0,4.0,231,2.0,220
1272,618,902,15.371609977324264,17.99546485260771,13.0,1.0,306,3.0,284
1273,615,183,16.46294784580499,17.60072562358277,24.0,36.0,435,1.0,432
1274,615,164,16.46294784580499,19.272562358276645,24.0,20.0,467,3.0,451
1275,615,255,16.46294784580499,17.949024943310658,24.0,31.0,366,1.0,360
1276,615,257,16.46294784580499,17.99546485260771,24.0,28.0,364,2.0,358
1277,615,264,16.46294784580499,19.29578231292517,24.0,19.0,372,3.0,351
1278,615,604,16.46294784580499,17.716825396825396,24.0,18.0,55,1.0,11
1279,615,611,16.46294784580499,17.99546485260771,24.0,13.0,66,2.0,4
1280,615,440,16.46294784580499,19.272562358276645,24.0,10.0,213,3.0,175
1281,615,676,16.46294784580499,17.99546485260771,24.0,11.0,90,2.0,61
1282,615,902,16.46294784580499,17.99546485260771,24.0,1.0,294,2.0,287
1283,622,164,17.020226757369613,19.272562358276645,17.0,20.0,468,2.0,458
1284,622,264,17.020226757369613,19.29578231292517,17.0,19.0,371,2.0,358
1285,622,440,17.020226757369613,19.272562358276645,17.0,10.0,206,2.0,182
1286,676,183,17.99546485260771,20.805079365079365,11.0,29.0,508,3.0,493
1287,676,264,17.99546485260771,19.29578231292517,11.0,19.0,416,1.0,412
1288,676,232,17.99546485260771,20.572879818594103,11.0,34.0,458,3.0,444
1289,676,440,17.99546485260771,19.272562358276645,11.0,10.0,242,1.0,236
1290,676,550,17.99546485260771,20.805079365079365,11.0,11.0,175,3.0,126
1291,676,683,17.99546485260771,20.82829931972789,11.0,15.0,122,3.0,7
1292,676,839,17.99546485260771,20.805079365079365,11.0,10.0,203,3.0,163
1293,683,291,20.82829931972789,21.89641723356009,15.0,13.0,395,1.0,392
1294,683,228,20.82829931972789,22.871655328798187,15.0,28.0,463,2.0,455
1295,683,255,20.82829931972789,23.26639455782313,15.0,34.0,441,2.0,428
1296,683,461,20.82829931972789,22.80199546485261,15.0,26.0,238,2.0,222
1297,683,421,20.82829931972789,23.26639455782313,15.0,8.0,282,2.0,262
1298,683,615,20.82829931972789,22.80199546485261,15.0,20.0,109,2.0,68
1299,683,622,20.82829931972789,23.312834467120183,15.0,11.0,123,2.0,61
1300,683,858,20.82829931972789,22.80199546485261,15.0,12.0,195,2.0,175
1301,683,917,20.82829931972789,23.73079365079365,15.0,0.0,265,3.0,234
1302,674,228,21.08371882086168,22.871655328798187,25.0,28.0,453,2.0,446
1303,674,255,21.08371882086168,23.26639455782313,25.0,34.0,429,2.0,419
1304,674,242,21.08371882086168,23.986213151927437,25.0,28.0,450,3.0,432
1305,674,461,21.08371882086168,22.80199546485261,25.0,26.0,225,2.0,213
1306,674,421,21.08371882086168,23.26639455782313,25.0,8.0,270,2.0,253
1307,674,615,21.08371882086168,22.80199546485261,25.0,20.0,95,2.0,59
1308,674,622,21.08371882086168,23.312834467120183,25.0,11.0,109,2.0,52
1309,674,858,21.08371882086168,22.80199546485261,25.0,12.0,198,2.0,184
1310,674,917,21.08371882086168,23.73079365079365,25.0,0.0,268,3.0,243
1311,615,242,22.80199546485261,23.986213151927437,20.0,28.0,376,1.0,373
1312,615,228,22.80199546485261,25.58839002267574,20.0,24.0,405,3.0,387
1313,615,613,22.80199546485261,24.86857142857143,20.0,5.0,89,2.0,2
1314,615,609,22.80199546485261,25.054331065759637,20.0,9.0,97,2.0,6
1315,615,682,22.80199546485261,24.79891156462585,20.0,8.0,109,2.0,67
1316,615,674,22.80199546485261,25.21687074829932,20.0,17.0,120,2.0,59
1317,615,835,22.80199546485261,24.729251700680273,20.0,-1.0,235,2.0,220
1318,622,228,23.312834467120183,25.58839002267574,11.0,24.0,406,2.0,394
1319,622,613,23.312834467120183,24.86857142857143,11.0,5.0,68,2.0,9
1320,622,609,23.312834467120183,25.054331065759637,11.0,9.0,76,2.0,13
1321,622,682,23.312834467120183,24.79891156462585,11.0,8.0,88,1.0,60
1322,622,674,23.312834467120183,25.21687074829932,11.0,17.0,97,2.0,52
1323,622,835,23.312834467120183,24.729251700680273,11.0,-1.0,222,1.0,213
1324,682,244,24.79891156462585,26.377868480725624,8.0,19.0,443,2.0,438
1325,682,236,24.79891156462585,27.16734693877551,8.0,32.0,458,2.0,446
1326,682,490,24.79891156462585,26.911927437641722,8.0,-4.0,212,2.0,192
1327,682,590,24.79891156462585,27.144126984126984,8.0,18.0,137,2.0,92
1328,682,617,24.79891156462585,27.12090702947846,8.0,21.0,119,2.0,65
1329,682,901,24.79891156462585,27.12090702947846,8.0,7.0,241,2.0,219
1330,674,244,25.21687074829932,26.377868480725624,17.0,19.0,433,1.0,430
1331,674,236,25.21687074829932,27.16734693877551,17.0,32.0,446,2.0,438
1332,674,246,25.21687074829932,28.026485260770976,17.0,24.0,445,3.0,428
1333,674,490,25.21687074829932,26.911927437641722,17.0,-4.0,198,2.0,184
1334,674,590,25.21687074829932,27.144126984126984,17.0,18.0,118,2.0,84
1335,674,682,25.21687074829932,26.772607709750567,17.0,5.0,67,2.0,8
1336,674,617,25.21687074829932,27.12090702947846,17.0,21.0,100,2.0,57
1337,674,901,25.21687074829932,27.12090702947846,17.0,7.0,241,2.0,227
1338,682,246,26.772607709750567,28.026485260770976,5.0,24.0,439,1.0,436
1339,682,234,26.772607709750567,29.675102040816327,5.0,6.0,465,3.0,448
1340,682,609,26.772607709750567,28.76952380952381,5.0,26.0,113,2.0,73
1341,682,622,26.772607709750567,28.76952380952381,5.0,28.0,105,2.0,60
1342,682,835,26.772607709750567,28.76952380952381,5.0,16.0,176,2.0,153
1343,617,164,27.12090702947846,29.675102040816327,21.0,15.0,466,3.0,453
1344,617,234,27.12090702947846,29.675102040816327,21.0,6.0,398,3.0,383
1345,617,609,27.12090702947846,28.76952380952381,21.0,26.0,71,2.0,8
1346,617,622,27.12090702947846,28.76952380952381,21.0,28.0,71,2.0,5
1347,617,835,27.12090702947846,28.76952380952381,21.0,16.0,229,2.0,218
1348,622,182,28.76952380952381,31.62557823129252,28.0,22.0,457,3.0,440
1349,622,213,28.76952380952381,30.65034013605442,28.0,24.0,417,2.0,409
1350,622,236,28.76952380952381,31.37015873015873,28.0,26.0,402,3.0,386
1351,622,604,28.76952380952381,30.441360544217687,28.0,25.0,74,2.0,18
1352,622,517,28.76952380952381,31.71845804988662,28.0,6.0,165,3.0,105
1353,622,663,28.76952380952381,30.441360544217687,28.0,24.0,83,2.0,41
1354,622,677,28.76952380952381,31.71845804988662,28.0,8.0,138,3.0,55
1355,622,837,28.76952380952381,30.464580498866212,28.0,20.0,227,2.0,215
1356,663,182,30.441360544217687,31.62557823129252,24.0,22.0,484,1.0,481
1357,663,202,30.441360544217687,32.113197278911564,24.0,17.0,467,2.0,461
1358,663,213,30.441360544217687,32.08997732426304,24.0,22.0,456,2.0,450
1359,663,517,30.441360544217687,31.71845804988662,24.0,6.0,156,1.0,146
1360,663,608,30.441360544217687,32.113197278911564,24.0,26.0,91,2.0,55
1361,663,677,30.441360544217687,31.71845804988662,24.0,8.0,57,1.0,14
1362,663,623,30.441360544217687,32.113197278911564,24.0,29.0,82,2.0,40
1363,663,846,30.441360544217687,32.113197278911564,24.0,11.0,197,2.0,183
1364,677,236,31.71845804988662,33.715374149659866,8.0,25.0,449,2.0,441
1365,677,258,31.71845804988662,34.57451247165533,8.0,34.0,437,3.0,419
1366,677,608,31.71845804988662,33.69215419501134,8.0,23.0,109,2.0,69
1367,677,537,31.71845804988662,34.57451247165533,8.0,11.0,186,3.0,140
1368,677,625,31.71845804988662,33.69215419501134,8.0,20.0,100,2.0,52
1369,677,829,31.71845804988662,33.69215419501134,8.0,13.0,174,2.0,152
1370,677,913,31.71845804988662,34.5512925170068,8.0,-1.0,266,3.0,236
1371,623,195,32.113197278911564,34.80671201814059,29.0,30.0,443,3.0,428
1372,623,236,32.113197278911564,33.715374149659866,29.0,25.0,393,2.0,387
1373,623,258,32.113197278911564,34.57451247165533,29.0,34.0,380,2.0,365
1374,623,208,32.113197278911564,35.03891156462585,29.0,32.0,434,3.0,415
1375,623,608,32.113197278911564,33.69215419501134,29.0,23.0,70,2.0,15
1376,623,537,32.113197278911564,34.57451247165533,29.0,11.0,136,2.0,86
1377,623,625,32.113197278911564,33.69215419501134,29.0,20.0,68,2.0,2
1378,623,669,32.113197278911564,34.76027210884354,29.0,8.0,123,3.0,46
1379,623,829,32.113197278911564,33.69215419501134,29.0,13.0,217,2.0,206
1380,623,913,32.113197278911564,34.5512925170068,29.0,-1.0,308,2.0,290
1381,625,195,33.69215419501134,34.80671201814059,20.0,30.0,433,1.0,430
1382,625,208,33.69215419501134,35.03891156462585,20.0,32.0,421,1.0,417
1383,625,237,33.69215419501134,36.52498866213152,20.0,29.0,407,3.0,388
1384,625,614,33.69215419501134,35.34077097505669,20.0,32.0,72,2.0,11
1385,625,669,33.69215419501134,34.76027210884354,20.0,8.0,64,1.0,44
1386,625,617,33.69215419501134,35.31755102040817,20.0,30.0,70,2.0,8
1387,625,838,33.69215419501134,35.34077097505669,20.0,19.0,225,2.0,213
1388,669,237,34.76027210884354,36.52498866213152,8.0,29.0,439,2.0,432
1389,669,614,34.76027210884354,36.91972789115646,8.0,29.0,108,2.0,55
1390,669,601,34.76027210884354,36.989387755102044,8.0,13.0,118,2.0,68
1391,669,616,34.76027210884354,36.91972789115646,8.0,29.0,107,2.0,53
1392,669,846,34.76027210884354,36.94294784580499,8.0,8.0,200,2.0,177
1393,617,237,35.31755102040817,36.52498866213152,30.0,29.0,384,1.0,380
1394,617,214,35.31755102040817,37.77886621315193,30.0,31.0,417,2.0,403
1395,617,271,35.31755102040817,37.987845804988666,30.0,18.0,365,3.0,346
1396,617,614,35.31755102040817,36.91972789115646,30.0,29.0,69,2.0,3
1397,617,601,35.31755102040817,36.989387755102044,30.0,13.0,74,2.0,16
1398,617,616,35.31755102040817,36.91972789115646,30.0,29.0,69,2.0,1
1399,617,619,35.31755102040817,37.89496598639456,30.0,15.0,111,3.0,2
1400,617,846,35.31755102040817,36.94294784580499,30.0,8.0,239,2.0,229
1401,617,835,35.31755102040817,37.77886621315193,30.0,0.0,242,2.0,218
1402,616,164,36.91972789115646,39.450702947845805,29.0,12.0,465,3.0,452
1403,616,271,36.91972789115646,37.987845804988666,29.0,18.0,348,1.0,345
1404,616,233,36.91972789115646,39.42748299319728,29.0,12.0,398,3.0,383
1405,616,607,36.91972789115646,38.59156462585034,29.0,26.0,73,2.0,9
1406,616,467,36.91972789115646,39.404263038548756,29.0,-4.0,183,2.0,149
1407,616,626,36.91972789115646,38.568344671201814,29.0,30.0,72,2.0,10
1408,616,835,36.91972789115646,38.568344671201814,29.0,19.0,230,2.0,219
1409,619,164,37.89496598639456,39.450702947845805,15.0,12.0,460,2.0,455
1410,619,233,37.89496598639456,39.42748299319728,15.0,12.0,392,2.0,386
1411,619,237,37.89496598639456,40.170521541950116,15.0,13.0,394,2.0,382
1412,619,467,37.89496598639456,39.404263038548756,15.0,-4.0,165,2.0,152
1413,619,613,37.89496598639456,40.170521541950116,15.0,31.0,98,2.0,6
1414,619,615,37.89496598639456,40.170521541950116,15.0,30.0,98,2.0,4
1415,619,830,37.89496598639456,40.170521541950116,15.0,13.0,233,2.0,211
1416,626,164,38.568344671201814,41.00643990929705,30.0,32.0,474,2.0,462
1417,626,237,38.568344671201814,40.170521541950116,30.0,13.0,395,2.0,389
1418,626,271,38.568344671201814,41.07609977324263,30.0,31.0,371,3.0,355
1419,626,613,38.568344671201814,40.170521541950116,30.0,31.0,70,2.0,13
1420,626,615,38.568344671201814,40.170521541950116,30.0,30.0,70,2.0,11
1421,626,830,38.568344671201814,40.170521541950116,30.0,13.0,215,2.0,204
1422,615,238,40.170521541950116,42.26031746031746,30.0,32.0,388,2.0,377
1423,615,255,40.170521541950116,43.049795918367344,30.0,24.0,381,3.0,360
1424,615,609,40.170521541950116,41.79591836734694,30.0,27.0,70,2.0,6
1425,615,609,40.170521541950116,42.63183673469388,30.0,16.0,106,2.0,6
1426,615,622,40.170521541950116,41.79591836734694,30.0,28.0,70,2.0,7
1427,615,616,40.170521541950116,42.6550566893424,30.0,14.0,107,2.0,1
1428,615,820,40.170521541950116,41.79591836734694,30.0,21.0,217,2.0,205
1429,615,843,40.170521541950116,42.678276643990934,30.0,2.0,252,3.0,228
1430,622,255,41.79591836734694,43.049795918367344,28.0,24.0,371,1.0,367
1431,622,229,41.79591836734694,44.23401360544218,28.0,19.0,407,2.0,393
1432,622,610,41.79591836734694,43.39809523809524,28.0,26.0,70,2.0,12
1433,622,602,41.79591836734694,44.0714739229025,28.0,23.0,100,2.0,20
1434,622,616,41.79591836734694,43.39809523809524,28.0,26.0,69,2.0,6
1435,622,616,41.79591836734694,44.04825396825397,28.0,25.0,97,2.0,6
1436,622,836,41.79591836734694,43.39809523809524,28.0,19.0,225,2.0,214
1437,622,837,41.79591836734694,44.0714739229025,28.0,11.0,236,2.0,215
1438,616,229,42.6550566893424,44.23401360544218,14.0,19.0,393,2.0,387
1439,616,324,42.6550566893424,45.04671201814059,14.0,15.0,310,2.0,292
1440,616,602,42.6550566893424,44.0714739229025,14.0,23.0,63,1.0,14
1441,616,614,42.6550566893424,45.00027210884354,14.0,29.0,101,2.0,2
1442,616,623,42.6550566893424,45.00027210884354,14.0,29.0,101,2.0,7
1443,616,837,42.6550566893424,44.0714739229025,14.0,11.0,229,1.0,221
1444,616,820,42.6550566893424,45.023492063492064,14.0,16.0,228,2.0,204
1445,616,324,43.39809523809524,45.04671201814059,26.0,15.0,301,2.0,292
1446,616,614,43.39809523809524,45.00027210884354,26.0,29.0,69,2.0,2
1447,616,623,43.39809523809524,45.00027210884354,26.0,29.0,69,2.0,7
1448,616,820,43.39809523809524,45.023492063492064,26.0,16.0,216,2.0,204
1449,616,227,44.04825396825397,46.64888888888889,25.0,19.0,405,3.0,389
1450,616,591,44.04825396825397,46.625668934240366,25.0,21.0,114,3.0,25
1451,616,618,44.04825396825397,46.625668934240366,25.0,32.0,111,3.0,2
1452,616,822,44.04825396825397,46.625668934240366,25.0,19.0,234,3.0,206
1453,623,170,45.00027210884354,47.64734693877551,29.0,25.0,467,3.0,453
1454,623,227,45.00027210884354,46.64888888888889,29.0,19.0,402,2.0,396
1455,623,215,45.00027210884354,47.18294784580499,29.0,25.0,419,2.0,408
1456,623,591,45.00027210884354,46.625668934240366,29.0,21.0,77,2.0,32
1457,623,601,45.00027210884354,47.275827664399095,29.0,11.0,100,2.0,22
1458,623,618,45.00027210884354,46.625668934240366,29.0,32.0,70,2.0,5
1459,623,673,45.00027210884354,47.18294784580499,29.0,11.0,106,2.0,50
1460,623,822,45.00027210884354,46.625668934240366,29.0,19.0,211,2.0,199
1461,618,170,46.625668934240366,47.64734693877551,32.0,25.0,450,1.0,448
1462,618,237,46.625668934240366,48.27428571428572,32.0,29.0,388,2.0,381
1463,618,614,46.625668934240366,48.251065759637186,32.0,26.0,70,2.0,4
1464,618,623,46.625668934240366,48.251065759637186,32.0,29.0,70,2.0,5
1465,618,835,46.625668934240366,48.251065759637186,32.0,20.0,228,2.0,217
1466,673,183,47.18294784580499,49.83002267573696,11.0,35.0,503,3.0,490
1467,673,237,47.18294784580499,48.27428571428572,11.0,29.0,439,1.0,436
1468,673,236,47.18294784580499,49.87646258503401,11.0,36.0,452,3.0,437
1469,673,614,47.18294784580499,48.251065759637186,11.0,26.0,75,1.0,59
1470,673,610,47.18294784580499,49.85324263038549,11.0,26.0,131,3.0,63
1471,673,623,47.18294784580499,48.251065759637186,11.0,29.0,68,1.0,50
1472,673,626,47.18294784580499,49.85324263038549,11.0,34.0,124,3.0,47
1473,673,835,47.18294784580499,48.251065759637186,11.0,20.0,168,1.0,162
1474,673,822,47.18294784580499,49.85324263038549,11.0,19.0,188,3.0,149
1475,623,183,48.251065759637186,49.83002267573696,29.0,35.0,445,2.0,440
1476,623,236,48.251065759637186,49.87646258503401,29.0,36.0,393,2.0,387
1477,623,239,48.251065759637186,50.36408163265306,29.0,21.0,395,2.0,384
1478,623,610,48.251065759637186,49.85324263038549,29.0,26.0,70,2.0,13
1479,623,626,48.251065759637186,49.85324263038549,29.0,34.0,69,2.0,3
1480,623,664,48.251065759637186,50.78204081632653,29.0,-4.0,116,3.0,41
1481,623,822,48.251065759637186,49.85324263038549,29.0,19.0,211,2.0,199
1482,626,223,49.85324263038549,51.50185941043084,34.0,28.0,409,2.0,403
1483,626,238,49.85324263038549,52.22167800453515,34.0,22.0,401,2.0,388
1484,626,603,49.85324263038549,51.478639455782314,34.0,24.0,74,2.0,23
1485,626,605,49.85324263038549,52.244897959183675,34.0,29.0,105,2.0,21
1486,626,619,49.85324263038549,52.244897959183675,34.0,28.0,103,2.0,7
1487,626,820,49.85324263038549,51.50185941043084,34.0,21.0,207,2.0,194
1488,626,820,49.85324263038549,52.244897959183675,34.0,14.0,220,2.0,194
1489,664,238,50.78204081632653,52.22167800453515,-4.0,22.0,430,1.0,426
1490,664,228,50.78204081632653,53.080816326530616,-4.0,21.0,447,2.0,436
1491,664,605,50.78204081632653,52.244897959183675,-4.0,29.0,86,1.0,59
1492,664,612,50.78204081632653,53.011156462585035,-4.0,29.0,109,2.0,52
1493,664,619,50.78204081632653,52.244897959183675,-4.0,28.0,77,1.0,45
1494,664,621,50.78204081632653,53.011156462585035,-4.0,28.0,105,2.0,43
1495,664,820,50.78204081632653,52.244897959183675,-4.0,14.0,168,1.0,156
1496,664,830,50.78204081632653,53.011156462585035,-4.0,16.0,192,2.0,166
1497,626,228,51.50185941043084,53.080816326530616,30.0,21.0,404,2.0,398
1498,626,612,51.50185941043084,53.011156462585035,30.0,29.0,66,2.0,14
1499,626,621,51.50185941043084,53.011156462585035,30.0,28.0,65,2.0,5
1500,626,830,51.50185941043084,53.011156462585035,30.0,16.0,214,2.0,204
1501,619,182,52.244897959183675,54.68299319727891,28.0,27.0,449,2.0,437
1502,619,253,52.244897959183675,54.91519274376417,28.0,25.0,384,3.0,366
1503,619,610,52.244897959183675,54.63655328798186,28.0,22.0,103,2.0,9
1504,619,603,52.244897959183675,55.147392290249435,28.0,24.0,126,3.0,16
1505,619,676,52.244897959183675,54.61333333333334,28.0,16.0,117,2.0,57
1506,619,622,52.244897959183675,55.147392290249435,28.0,26.0,125,3.0,3
1507,619,828,52.244897959183675,54.61333333333334,28.0,15.0,233,2.0,209
1508,619,829,52.244897959183675,55.12417233560091,28.0,7.0,244,3.0,210
1509,621,182,53.011156462585035,54.68299319727891,28.0,27.0,445,2.0,439
1510,621,253,53.011156462585035,54.91519274376417,28.0,25.0,377,2.0,368
1511,621,211,53.011156462585035,55.843990929705214,28.0,32.0,428,3.0,410
1512,621,610,53.011156462585035,54.63655328798186,28.0,22.0,71,2.0,11
1513,621,603,53.011156462585035,55.147392290249435,28.0,24.0,94,2.0,18
1514,621,676,53.011156462585035,54.61333333333334,28.0,16.0,88,2.0,55
1515,621,622,53.011156462585035,55.147392290249435,28.0,26.0,92,2.0,1
1516,621,828,53.011156462585035,54.61333333333334,28.0,15.0,218,2.0,207
1517,621,829,53.011156462585035,55.12417233560091,28.0,7.0,227,2.0,208
1518,676,211,54.61333333333334,55.843990929705214,16.0,32.0,468,1.0,465
1519,676,242,54.61333333333334,56.81922902494331,16.0,28.0,444,2.0,434
1520,676,608,54.61333333333334,56.86566893424036,16.0,24.0,118,2.0,68
1521,676,609,54.61333333333334,57.283628117913835,16.0,19.0,133,3.0,67
1522,676,620,54.61333333333334,56.029750566893426,16.0,26.0,83,1.0,56
1523,676,830,54.61333333333334,56.86566893424036,16.0,19.0,182,2.0,154
1524,676,829,54.61333333333334,57.283628117913835,16.0,18.0,191,3.0,153
1525,622,161,55.147392290249435,56.79600907029479,26.0,35.0,466,2.0,461
1526,622,242,55.147392290249435,56.81922902494331,26.0,28.0,387,2.0,380
1527,622,239,55.147392290249435,57.67836734693878,26.0,30.0,398,3.0,383
1528,622,608,55.147392290249435,56.86566893424036,26.0,24.0,75,2.0,14
1529,622,609,55.147392290249435,57.283628117913835,26.0,19.0,93,2.0,13
1530,622,599,55.147392290249435,58.096326530612245,26.0,22.0,129,3.0,23
1531,622,661,55.147392290249435,57.7015873015873,26.0,18.0,117,3.0,39
1532,622,684,55.147392290249435,58.096326530612245,26.0,23.0,141,3.0,62
1533,622,830,55.147392290249435,56.86566893424036,26.0,19.0,221,2.0,208
1534,622,829,55.147392290249435,57.283628117913835,26.0,18.0,227,2.0,207
1535,622,829,55.147392290249435,58.096326530612245,26.0,19.0,243,3.0,207
1536,620,239,56.029750566893426,57.67836734693878,26.0,30.0,388,2.0,381
1537,620,242,56.029750566893426,58.258866213151926,26.0,25.0,390,2.0,378
1538,620,609,56.029750566893426,57.283628117913835,26.0,19.0,55,1.0,11
1539,620,599,56.029750566893426,58.096326530612245,26.0,22.0,91,2.0,21
1540,620,661,56.029750566893426,57.7015873015873,26.0,18.0,83,2.0,41
1541,620,684,56.029750566893426,58.096326530612245,26.0,23.0,110,2.0,64
1542,620,829,56.029750566893426,57.283628117913835,26.0,18.0,216,1.0,209
1543,620,829,56.029750566893426,58.096326530612245,26.0,19.0,227,2.0,209
1544,661,237,57.7015873015873,59.44308390022676,18.0,36.0,431,2.0,424
1545,661,416,57.7015873015873,59.32698412698413,18.0,14.0,255,2.0,245
1546,661,660,57.7015873015873,59.350204081632654,18.0,13.0,71,2.0,1
1547,661,829,57.7015873015873,59.32698412698413,18.0,21.0,182,2.0,168
1548,684,237,58.096326530612245,59.44308390022676,23.0,36.0,451,1.0,447
1549,684,416,58.096326530612245,59.32698412698413,23.0,14.0,273,1.0,268
1550,684,660,58.096326530612245,59.350204081632654,23.0,13.0,59,1.0,24
1551,684,829,58.096326530612245,59.32698412698413,23.0,21.0,154,1.0,145
1552,865,596,1.5557369614512473,3.3436734693877552,-2.0,6.0,280,2.0,269
1553,865,474,1.5557369614512473,4.4117913832199545,-2.0,14.0,410,3.0,391
1554,865,619,1.5557369614512473,3.2275736961451247,-2.0,4.0,256,2.0,246
1555,865,655,1.5557369614512473,4.388571428571429,-2.0,14.0,243,3.0,210
1556,865,836,1.5557369614512473,4.388571428571429,-2.0,-4.0,125,3.0,29
1557,865,474,2.345215419501134,4.4117913832199545,-0.0,14.0,401,2.0,391
1558,865,603,2.345215419501134,5.294149659863946,-0.0,13.0,291,3.0,262
1559,865,655,2.345215419501134,4.388571428571429,-0.0,14.0,228,2.0,210
1560,865,616,2.345215419501134,4.992290249433107,-0.0,13.0,274,3.0,249
1561,865,836,2.345215419501134,4.388571428571429,-0.0,-4.0,93,2.0,29
1562,836,585,4.388571428571429,6.315827664399093,-4.0,10.0,264,2.0,251
1563,836,463,4.388571428571429,7.267845804988662,-4.0,3.0,393,3.0,373
1564,836,621,4.388571428571429,6.315827664399093,-4.0,8.0,230,2.0,215
1565,836,704,4.388571428571429,7.291065759637188,-4.0,-3.0,182,3.0,132
1566,866,609,8.010884353741497,9.636281179138322,11.0,27.0,266,2.0,257
1567,866,487,8.010884353741497,10.936598639455783,11.0,19.0,399,3.0,379
1568,866,615,8.010884353741497,9.636281179138322,11.0,27.0,261,2.0,251
1569,866,618,8.010884353741497,10.95981859410431,11.0,15.0,279,3.0,248
1570,866,833,8.010884353741497,9.58984126984127,11.0,16.0,76,2.0,33
1571,866,843,8.010884353741497,10.936598639455783,11.0,14.0,128,3.0,23
1572,833,487,9.58984126984127,10.936598639455783,16.0,19.0,351,1.0,346
1573,833,609,9.58984126984127,11.377777777777778,16.0,17.0,237,2.0,224
1574,833,600,9.58984126984127,12.445895691609978,16.0,22.0,263,3.0,233
1575,833,618,9.58984126984127,10.95981859410431,16.0,15.0,223,1.0,215
1576,833,618,9.58984126984127,11.00625850340136,16.0,21.0,223,1.0,215
1577,833,621,9.58984126984127,12.213696145124716,16.0,21.0,240,3.0,212
1578,833,843,9.58984126984127,10.936598639455783,16.0,14.0,59,1.0,10
1579,833,830,9.58984126984127,11.377777777777778,16.0,8.0,77,2.0,3
1580,833,820,9.58984126984127,12.399455782312925,16.0,3.0,122,3.0,13
1581,843,600,10.936598639455783,12.445895691609978,14.0,22.0,252,2.0,243
1582,843,546,10.936598639455783,13.421133786848072,14.0,3.0,316,2.0,297
1583,843,621,10.936598639455783,12.213696145124716,14.0,21.0,229,1.0,222
1584,843,672,10.936598639455783,13.119274376417234,14.0,11.0,195,2.0,171
1585,843,820,10.936598639455783,12.399455782312925,14.0,3.0,67,1.0,23
1586,830,600,11.377777777777778,12.445895691609978,8.0,22.0,235,1.0,230
1587,830,546,11.377777777777778,13.421133786848072,8.0,3.0,297,2.0,284
1588,830,672,11.377777777777778,13.119274376417234,8.0,11.0,175,2.0,158
1589,830,820,11.377777777777778,12.399455782312925,8.0,3.0,45,1.0,10
1590,820,546,12.399455782312925,13.421133786848072,3.0,3.0,278,1.0,274
1591,820,597,12.399455782312925,14.930430839002268,3.0,17.0,248,3.0,223
1592,820,670,12.399455782312925,14.907210884353741,3.0,19.0,185,3.0,150
1593,820,618,12.399455782312925,15.371609977324264,3.0,13.0,239,3.0,202
1594,820,914,12.399455782312925,14.907210884353741,3.0,8.0,143,3.0,94
1595,820,859,12.399455782312925,15.371609977324264,3.0,3.0,134,3.0,39
1596,914,614,14.907210884353741,16.46294784580499,8.0,23.0,307,2.0,300
1597,914,604,14.907210884353741,17.716825396825396,8.0,18.0,333,3.0,310
1598,914,615,14.907210884353741,16.46294784580499,8.0,24.0,306,2.0,299
1599,914,622,14.907210884353741,17.020226757369613,8.0,17.0,306,2.0,292
1600,914,848,14.907210884353741,16.439727891156462,8.0,9.0,93,2.0,66
1601,914,838,14.907210884353741,17.020226757369613,8.0,4.0,119,2.0,76
1602,859,614,15.371609977324264,16.46294784580499,3.0,23.0,249,1.0,245
1603,859,604,15.371609977324264,17.716825396825396,3.0,18.0,274,2.0,255
1604,859,611,15.371609977324264,17.99546485260771,3.0,13.0,273,3.0,248
1605,859,615,15.371609977324264,16.46294784580499,3.0,24.0,248,1.0,244
1606,859,622,15.371609977324264,17.020226757369613,3.0,17.0,247,2.0,237
1607,859,676,15.371609977324264,17.99546485260771,3.0,11.0,215,3.0,183
1608,859,848,15.371609977324264,16.439727891156462,3.0,9.0,47,1.0,11
1609,859,838,15.371609977324264,17.020226757369613,3.0,4.0,74,2.0,21
1610,859,902,15.371609977324264,17.99546485260771,3.0,1.0,121,3.0,43
1611,848,604,16.439727891156462,17.716825396825396,9.0,18.0,250,1.0,244
1612,848,611,16.439727891156462,17.99546485260771,9.0,13.0,246,2.0,237
1613,848,440,16.439727891156462,19.272562358276645,9.0,10.0,426,3.0,408
1614,848,676,16.439727891156462,17.99546485260771,9.0,11.0,185,2.0,172
1615,848,902,16.439727891156462,17.99546485260771,9.0,1.0,86,2.0,54
1616,838,440,17.020226757369613,19.272562358276645,4.0,10.0,410,2.0,398
1617,902,440,17.99546485260771,19.272562358276645,1.0,10.0,465,1.0,462
1618,902,550,17.99546485260771,20.805079365079365,1.0,11.0,372,3.0,352
1619,902,683,17.99546485260771,20.82829931972789,1.0,15.0,251,3.0,219
1620,902,839,17.99546485260771,20.805079365079365,1.0,10.0,136,3.0,63
1621,839,461,20.805079365079365,22.80199546485261,10.0,26.0,388,2.0,378
1622,839,421,20.805079365079365,23.26639455782313,10.0,8.0,431,2.0,418
1623,839,615,20.805079365079365,22.80199546485261,10.0,20.0,240,2.0,224
1624,839,622,20.805079365079365,23.312834467120183,10.0,11.0,242,3.0,217
1625,839,858,20.805079365079365,22.80199546485261,10.0,12.0,88,2.0,19
1626,839,917,20.805079365079365,23.73079365079365,10.0,0.0,148,3.0,78
1627,862,461,21.08371882086168,22.80199546485261,14.0,26.0,408,2.0,401
1628,862,421,21.08371882086168,23.26639455782313,14.0,8.0,451,2.0,441
1629,862,615,21.08371882086168,22.80199546485261,14.0,20.0,258,2.0,247
1630,862,622,21.08371882086168,23.312834467120183,14.0,11.0,258,2.0,240
1631,862,858,21.08371882086168,22.80199546485261,14.0,12.0,74,2.0,4
1632,862,917,21.08371882086168,23.73079365079365,14.0,0.0,127,3.0,55
1633,858,613,22.80199546485261,24.86857142857143,12.0,5.0,261,2.0,245
1634,858,609,22.80199546485261,25.054331065759637,12.0,9.0,267,2.0,249
1635,858,682,22.80199546485261,24.79891156462585,12.0,8.0,196,2.0,176
1636,858,674,22.80199546485261,25.21687074829932,12.0,17.0,211,2.0,184
1637,858,835,22.80199546485261,24.729251700680273,12.0,-1.0,86,2.0,23
1638,917,613,23.73079365079365,24.86857142857143,0.0,5.0,308,1.0,304
1639,917,609,23.73079365079365,25.054331065759637,0.0,9.0,313,1.0,308
1640,917,682,23.73079365079365,24.79891156462585,0.0,8.0,239,1.0,235
1641,917,674,23.73079365079365,25.21687074829932,0.0,17.0,251,1.0,243
1642,835,490,24.729251700680273,26.911927437641722,-1.0,-4.0,358,2.0,345
1643,835,590,24.729251700680273,27.144126984126984,-1.0,18.0,266,2.0,245
1644,835,682,24.729251700680273,26.772607709750567,-1.0,5.0,177,2.0,153
1645,835,617,24.729251700680273,27.12090702947846,-1.0,21.0,241,2.0,218
1646,835,901,24.729251700680273,27.12090702947846,-1.0,7.0,122,2.0,66
1647,901,609,27.12090702947846,28.76952380952381,7.0,26.0,301,2.0,292
1648,901,622,27.12090702947846,28.76952380952381,7.0,28.0,288,2.0,279
1649,901,835,27.12090702947846,28.76952380952381,7.0,16.0,97,2.0,66
1650,835,604,28.76952380952381,30.441360544217687,16.0,25.0,242,2.0,231
1651,835,517,28.76952380952381,31.71845804988662,16.0,6.0,342,3.0,318
1652,835,663,28.76952380952381,30.441360544217687,16.0,24.0,186,2.0,172
1653,835,677,28.76952380952381,31.71845804988662,16.0,8.0,203,3.0,158
1654,835,837,28.76952380952381,30.464580498866212,16.0,20.0,73,2.0,2
1655,837,517,30.464580498866212,31.71845804988662,20.0,6.0,325,1.0,320
1656,837,608,30.464580498866212,32.113197278911564,20.0,26.0,240,2.0,229
1657,837,677,30.464580498866212,31.71845804988662,20.0,8.0,169,1.0,160
1658,837,623,30.464580498866212,32.113197278911564,20.0,29.0,225,2.0,214
1659,837,846,30.464580498866212,32.113197278911564,20.0,11.0,72,2.0,9
1660,846,608,32.113197278911564,33.69215419501134,11.0,23.0,248,2.0,238
1661,846,537,32.113197278911564,34.57451247165533,11.0,11.0,327,2.0,309
1662,846,625,32.113197278911564,33.69215419501134,11.0,20.0,231,2.0,221
1663,846,669,32.113197278911564,34.76027210884354,11.0,8.0,211,3.0,177
1664,846,829,32.113197278911564,33.69215419501134,11.0,13.0,70,2.0,17
1665,846,913,32.113197278911564,34.5512925170068,11.0,-1.0,125,2.0,67
1666,829,614,33.69215419501134,35.34077097505669,13.0,32.0,226,2.0,215
1667,829,669,33.69215419501134,34.76027210884354,13.0,8.0,166,1.0,160
1668,829,617,33.69215419501134,35.31755102040817,13.0,30.0,223,2.0,212
1669,829,838,33.69215419501134,35.34077097505669,13.0,19.0,72,2.0,9
1670,913,614,34.5512925170068,36.91972789115646,-1.0,29.0,316,2.0,299
1671,913,601,34.5512925170068,36.989387755102044,-1.0,13.0,329,2.0,312
1672,913,616,34.5512925170068,36.91972789115646,-1.0,29.0,314,2.0,297
1673,913,846,34.5512925170068,36.94294784580499,-1.0,8.0,123,2.0,67
1674,838,614,35.34077097505669,36.91972789115646,19.0,29.0,234,2.0,224
1675,838,601,35.34077097505669,36.989387755102044,19.0,13.0,247,2.0,237
1676,838,616,35.34077097505669,36.91972789115646,19.0,29.0,232,2.0,222
1677,838,619,35.34077097505669,37.89496598639456,19.0,15.0,245,3.0,219
1678,838,846,35.34077097505669,36.94294784580499,19.0,8.0,69,2.0,8
1679,838,835,35.34077097505669,37.77886621315193,19.0,0.0,105,2.0,3
1680,846,607,36.94294784580499,38.59156462585034,8.0,26.0,249,2.0,239
1681,846,467,36.94294784580499,39.404263038548756,8.0,-4.0,394,2.0,379
1682,846,626,36.94294784580499,38.568344671201814,8.0,30.0,231,2.0,220
1683,846,835,36.94294784580499,38.568344671201814,8.0,19.0,71,2.0,11
1684,835,467,37.77886621315193,39.404263038548756,0.0,-4.0,375,2.0,368
1685,835,613,37.77886621315193,40.170521541950116,0.0,31.0,245,2.0,222
1686,835,615,37.77886621315193,40.170521541950116,0.0,30.0,243,2.0,220
1687,835,830,37.77886621315193,40.170521541950116,0.0,13.0,103,2.0,5
1688,835,613,38.568344671201814,40.170521541950116,19.0,31.0,232,2.0,222
1689,835,615,38.568344671201814,40.170521541950116,19.0,30.0,231,2.0,220
1690,835,830,38.568344671201814,40.170521541950116,19.0,13.0,69,2.0,5
1691,830,609,40.170521541950116,41.79591836734694,13.0,27.0,232,2.0,221
1692,830,609,40.170521541950116,42.63183673469388,13.0,16.0,245,2.0,221
1693,830,622,40.170521541950116,41.79591836734694,13.0,28.0,219,2.0,208
1694,830,616,40.170521541950116,42.6550566893424,13.0,14.0,239,2.0,214
1695,830,820,40.170521541950116,41.79591836734694,13.0,21.0,71,2.0,10
1696,830,843,40.170521541950116,42.678276643990934,13.0,2.0,109,3.0,13
1697,820,610,41.79591836734694,43.39809523809524,21.0,26.0,221,2.0,210
1698,820,602,41.79591836734694,44.0714739229025,21.0,23.0,239,2.0,218
1699,820,616,41.79591836734694,43.39809523809524,21.0,26.0,215,2.0,204
1700,820,616,41.79591836734694,44.04825396825397,21.0,25.0,226,2.0,204
1701,820,836,41.79591836734694,43.39809523809524,21.0,19.0,71,2.0,16
1702,820,837,41.79591836734694,44.0714739229025,21.0,11.0,99,2.0,17
1703,843,602,42.678276643990934,44.0714739229025,2.0,23.0,248,1.0,241
1704,843,614,42.678276643990934,45.00027210884354,2.0,29.0,250,2.0,229
1705,843,616,42.678276643990934,44.04825396825397,2.0,25.0,235,1.0,227
1706,843,623,42.678276643990934,45.00027210884354,2.0,29.0,242,2.0,220
1707,843,837,42.678276643990934,44.0714739229025,2.0,11.0,60,1.0,6
1708,843,820,42.678276643990934,45.023492063492064,2.0,16.0,104,2.0,23
1709,836,614,43.39809523809524,45.00027210884354,19.0,29.0,232,2.0,222
1710,836,623,43.39809523809524,45.00027210884354,19.0,29.0,224,2.0,213
1711,836,820,43.39809523809524,45.023492063492064,19.0,16.0,72,2.0,16
1712,837,591,44.0714739229025,46.625668934240366,11.0,21.0,269,3.0,246
1713,837,618,44.0714739229025,46.625668934240366,11.0,32.0,245,3.0,219
1714,837,822,44.0714739229025,46.625668934240366,11.0,19.0,111,3.0,15
1715,820,591,45.023492063492064,46.625668934240366,16.0,21.0,239,2.0,229
1716,820,601,45.023492063492064,47.275827664399095,16.0,11.0,240,2.0,219
1717,820,618,45.023492063492064,46.625668934240366,16.0,32.0,213,2.0,202
1718,820,673,45.023492063492064,47.18294784580499,16.0,11.0,174,2.0,147
1719,820,822,45.023492063492064,46.625668934240366,16.0,19.0,69,2.0,2
1720,822,614,46.625668934240366,48.251065759637186,19.0,26.0,219,2.0,208
1721,822,623,46.625668934240366,48.251065759637186,19.0,29.0,211,2.0,199
1722,822,835,46.625668934240366,48.251065759637186,19.0,20.0,71,2.0,13
1723,835,610,48.251065759637186,49.85324263038549,20.0,26.0,235,2.0,225
1724,835,626,48.251065759637186,49.85324263038549,20.0,34.0,220,2.0,209
1725,835,664,48.251065759637186,50.78204081632653,20.0,-4.0,203,3.0,171
1726,835,822,48.251065759637186,49.85324263038549,20.0,19.0,70,2.0,13
1727,822,603,49.85324263038549,51.478639455782314,19.0,24.0,230,2.0,219
1728,822,605,49.85324263038549,52.244897959183675,19.0,29.0,240,2.0,217
1729,822,626,49.85324263038549,51.50185941043084,19.0,30.0,208,2.0,196
1730,822,619,49.85324263038549,52.244897959183675,19.0,28.0,228,2.0,203
1731,822,820,49.85324263038549,51.50185941043084,19.0,21.0,71,2.0,2
1732,822,820,49.85324263038549,52.244897959183675,19.0,14.0,103,2.0,2
1733,820,612,51.50185941043084,53.011156462585035,21.0,29.0,218,2.0,208
1734,820,621,51.50185941043084,53.011156462585035,21.0,28.0,209,2.0,199
1735,820,830,51.50185941043084,53.011156462585035,21.0,16.0,66,2.0,10
1736,820,610,52.244897959183675,54.63655328798186,14.0,22.0,234,2.0,210
1737,820,603,52.244897959183675,55.147392290249435,14.0,24.0,250,3.0,217
1738,820,676,52.244897959183675,54.61333333333334,14.0,16.0,176,2.0,144
1739,820,622,52.244897959183675,55.147392290249435,14.0,26.0,234,3.0,198
1740,820,828,52.244897959183675,54.61333333333334,14.0,15.0,102,2.0,8
1741,820,829,52.244897959183675,55.12417233560091,14.0,7.0,124,3.0,9
1742,830,610,53.011156462585035,54.63655328798186,16.0,22.0,231,2.0,220
1743,830,603,53.011156462585035,55.147392290249435,16.0,24.0,245,2.0,227
1744,830,676,53.011156462585035,54.61333333333334,16.0,16.0,169,2.0,154
1745,830,622,53.011156462585035,55.147392290249435,16.0,26.0,227,2.0,208
1746,830,828,53.011156462585035,54.61333333333334,16.0,15.0,69,2.0,2
1747,830,829,53.011156462585035,55.12417233560091,16.0,7.0,91,2.0,1
1748,828,608,54.61333333333334,56.86566893424036,15.0,24.0,240,2.0,220
1749,828,609,54.61333333333334,57.283628117913835,15.0,19.0,247,3.0,219
1750,828,620,54.61333333333334,56.029750566893426,15.0,26.0,217,1.0,208
1751,828,830,54.61333333333334,56.86566893424036,15.0,19.0,97,2.0,2
1752,828,829,54.61333333333334,57.283628117913835,15.0,18.0,115,3.0,1
1753,829,608,55.12417233560091,56.86566893424036,7.0,24.0,233,2.0,221
1754,829,609,55.12417233560091,57.283628117913835,7.0,19.0,239,2.0,220
1755,829,599,55.12417233560091,58.096326530612245,7.0,22.0,263,3.0,230
1756,829,661,55.12417233560091,57.7015873015873,7.0,18.0,201,3.0,168
1757,829,684,55.12417233560091,58.096326530612245,7.0,23.0,193,3.0,145
1758,829,830,55.12417233560091,56.86566893424036,7.0,19.0,75,2.0,1
1759,830,599,56.86566893424036,58.096326530612245,19.0,22.0,237,1.0,231
1760,830,416,56.86566893424036,59.32698412698413,19.0,14.0,427,2.0,414
1761,830,684,56.86566893424036,58.096326530612245,19.0,23.0,155,1.0,146
1762,830,660,56.86566893424036,59.350204081632654,19.0,13.0,201,2.0,170
1763,830,829,56.86566893424036,58.096326530612245,19.0,19.0,53,1.0,1
1764,830,829,56.86566893424036,59.32698412698413,19.0,21.0,106,2.0,1
1765,829,416,57.283628117913835,59.32698412698413,18.0,14.0,422,2.0,413
1766,829,660,57.283628117913835,59.350204081632654,18.0,13.0,191,2.0,169
1767,829,416,58.096326530612245,59.32698412698413,19.0,14.0,416,1.0,413
1768,829,660,58.096326530612245,59.350204081632654,19.0,13.0,177,1.0,169
