,f0,f1,t0,t1,dB0,dB1,dist,utime,ufreq
0,21,41,0.9752380952380952,2.159455782312925,19.0,24.0,55,1.0,20
1,21,55,0.9752380952380952,3.3668934240362813,19.0,24.0,108,2.0,34
2,21,274,0.9752380952380952,2.229115646258504,19.0,17.0,259,1.0,253
3,21,274,0.9752380952380952,3.0418140589569163,19.0,16.0,268,2.0,253
4,55,274,1.83437641723356,3.0418140589569163,21.0,16.0,225,1.0,219
5,41,55,2.159455782312925,3.3668934240362813,24.0,24.0,54,1.0,14
6,41,55,2.159455782312925,4.899410430839002,24.0,23.0,119,3.0,14
7,41,263,2.159455782312925,4.85297052154195,24.0,14.0,250,3.0,222
8,55,69,3.3668934240362813,5.6656689342403626,24.0,20.0,100,2.0,14
9,55,263,3.3668934240362813,4.85297052154195,24.0,14.0,218,1.0,208
10,55,206,3.3668934240362813,5.27092970521542,24.0,15.0,172,2.0,151
11,55,66,4.899410430839002,6.919546485260772,23.0,32.0,88,2.0,11
12,55,66,4.899410430839002,7.848344671201813,23.0,32.0,127,3.0,11
13,55,207,4.899410430839002,6.919546485260772,23.0,22.0,175,2.0,152
14,55,216,4.899410430839002,7.6393650793650805,23.0,28.0,200,3.0,161
15,55,485,4.899410430839002,7.662585034013605,23.0,27.0,446,3.0,430
16,69,66,5.6656689342403626,6.919546485260772,20.0,32.0,54,1.0,3
17,69,66,5.6656689342403626,7.848344671201813,20.0,32.0,94,2.0,3
18,69,67,5.6656689342403626,8.057324263038549,20.0,27.0,103,2.0,2
19,69,207,5.6656689342403626,6.919546485260772,20.0,22.0,148,1.0,138
20,69,216,5.6656689342403626,7.6393650793650805,20.0,28.0,170,2.0,147
21,69,236,5.6656689342403626,8.057324263038549,20.0,22.0,196,2.0,167
22,69,485,5.6656689342403626,7.662585034013605,20.0,27.0,425,2.0,416
23,69,433,5.6656689342403626,8.010884353741497,20.0,21.0,378,2.0,364
24,66,67,6.919546485260772,8.057324263038549,32.0,27.0,49,1.0,1
25,66,55,6.919546485260772,9.729160997732428,32.0,24.0,121,3.0,11
26,66,236,6.919546485260772,8.057324263038549,32.0,22.0,177,1.0,170
27,66,214,6.919546485260772,9.729160997732428,32.0,26.0,191,3.0,148
28,66,433,6.919546485260772,8.010884353741497,32.0,21.0,370,1.0,367
29,66,439,6.919546485260772,9.845260770975058,32.0,20.0,394,3.0,373
30,66,55,7.848344671201813,9.729160997732428,32.0,24.0,82,2.0,11
31,66,35,7.848344671201813,10.704399092970524,32.0,26.0,127,3.0,31
32,66,214,7.848344671201813,9.729160997732428,32.0,26.0,169,2.0,148
33,66,206,7.848344671201813,10.797278911564627,32.0,21.0,189,3.0,140
34,66,439,7.848344671201813,9.845260770975058,32.0,20.0,383,2.0,373
35,67,55,8.057324263038549,9.729160997732428,27.0,24.0,73,2.0,12
36,67,35,8.057324263038549,10.704399092970524,27.0,26.0,118,3.0,32
37,67,214,8.057324263038549,9.729160997732428,27.0,26.0,164,2.0,147
38,67,206,8.057324263038549,10.797278911564627,27.0,21.0,182,3.0,139
39,67,439,8.057324263038549,9.845260770975058,27.0,20.0,380,2.0,372
40,55,41,9.729160997732428,11.58675736961451,24.0,19.0,81,2.0,14
41,55,206,9.729160997732428,10.797278911564627,24.0,21.0,158,1.0,151
42,55,285,9.729160997732428,11.168798185941043,24.0,13.0,238,1.0,230
43,55,386,9.729160997732428,12.701315192743767,24.0,25.0,355,3.0,331
44,55,515,9.729160997732428,11.192018140589571,24.0,15.0,464,1.0,460
45,35,68,10.704399092970524,12.933514739229025,26.0,26.0,102,2.0,33
46,35,88,10.704399092970524,13.07283446712018,26.0,30.0,115,2.0,53
47,35,386,10.704399092970524,12.701315192743767,26.0,25.0,361,2.0,351
48,35,225,10.704399092970524,13.676553287981859,26.0,27.0,229,3.0,190
49,35,515,10.704399092970524,12.747755102040815,26.0,24.0,488,2.0,480
50,35,447,10.704399092970524,13.25859410430839,26.0,24.0,426,3.0,412
51,41,68,11.58675736961451,12.933514739229025,19.0,26.0,64,1.0,27
52,41,88,11.58675736961451,13.07283446712018,19.0,30.0,79,1.0,47
53,41,386,11.58675736961451,12.701315192743767,19.0,25.0,348,1.0,345
54,41,225,11.58675736961451,13.676553287981859,19.0,27.0,205,2.0,184
55,41,292,11.58675736961451,14.303492063492065,19.0,13.0,277,3.0,251
56,41,515,11.58675736961451,12.747755102040815,19.0,24.0,477,1.0,474
57,41,447,11.58675736961451,13.25859410430839,19.0,24.0,412,2.0,406
58,68,41,12.933514739229025,14.721451247165533,26.0,16.0,82,2.0,27
59,68,69,12.933514739229025,15.116190476190473,26.0,18.0,94,2.0,1
60,68,292,12.933514739229025,14.303492063492065,26.0,13.0,232,1.0,224
61,68,227,12.933514739229025,15.882448979591837,26.0,12.0,203,3.0,159
62,88,41,13.07283446712018,14.721451247165533,30.0,16.0,85,2.0,47
63,88,69,13.07283446712018,15.116190476190473,30.0,18.0,90,2.0,19
64,88,292,13.07283446712018,14.303492063492065,30.0,13.0,211,1.0,204
65,88,227,13.07283446712018,15.882448979591837,30.0,12.0,184,3.0,139
66,88,465,13.07283446712018,15.975328798185942,30.0,21.0,397,3.0,377
67,41,67,14.721451247165533,16.068208616780044,16.0,34.0,64,1.0,26
68,41,197,14.721451247165533,17.04344671201814,16.0,27.0,185,2.0,156
69,41,227,14.721451247165533,15.882448979591837,16.0,12.0,193,1.0,186
70,41,213,14.721451247165533,16.34684807256236,16.0,23.0,186,2.0,172
71,41,211,14.721451247165533,17.29886621315193,16.0,22.0,203,3.0,170
72,41,465,14.721451247165533,15.975328798185942,16.0,21.0,427,1.0,424
73,41,434,14.721451247165533,16.46294784580499,16.0,23.0,400,2.0,393
74,41,478,14.721451247165533,17.41496598639456,16.0,22.0,452,3.0,437
75,69,197,15.116190476190473,17.04344671201814,18.0,27.0,153,2.0,128
76,69,213,15.116190476190473,16.34684807256236,18.0,23.0,153,1.0,144
77,69,211,15.116190476190473,17.29886621315193,18.0,22.0,170,2.0,142
78,69,434,15.116190476190473,16.46294784580499,18.0,23.0,370,1.0,365
79,69,478,15.116190476190473,17.41496598639456,18.0,22.0,421,2.0,409
80,67,69,16.068208616780044,18.274104308390022,34.0,22.0,95,2.0,2
81,67,211,16.068208616780044,17.29886621315193,34.0,22.0,153,1.0,144
82,67,366,16.068208616780044,18.250884353741494,34.0,13.0,313,2.0,299
83,67,478,16.068208616780044,17.41496598639456,34.0,22.0,415,1.0,411
84,67,549,16.068208616780044,18.250884353741494,34.0,18.0,491,2.0,482
85,197,69,17.04344671201814,18.274104308390022,27.0,22.0,139,1.0,128
86,197,64,17.04344671201814,19.62086167800453,27.0,38.0,173,3.0,133
87,197,366,17.04344671201814,18.250884353741494,27.0,13.0,177,1.0,169
88,197,211,17.04344671201814,19.783401360544214,27.0,29.0,119,3.0,14
89,197,549,17.04344671201814,18.250884353741494,27.0,18.0,356,1.0,352
90,197,434,17.04344671201814,19.806621315192746,27.0,20.0,265,3.0,237
91,197,628,17.04344671201814,18.250884353741494,27.0,10.0,434,1.0,431
92,197,643,17.04344671201814,19.040362811791386,27.0,21.0,454,2.0,446
93,69,64,18.274104308390022,19.62086167800453,22.0,38.0,58,1.0,5
94,69,67,18.274104308390022,20.24780045351474,22.0,28.0,85,2.0,2
95,69,211,18.274104308390022,19.783401360544214,22.0,29.0,156,2.0,142
96,69,227,18.274104308390022,20.433560090702947,22.0,27.0,183,2.0,158
97,69,434,18.274104308390022,19.806621315192746,22.0,20.0,371,2.0,365
98,69,474,18.274104308390022,20.642539682539685,22.0,25.0,418,2.0,405
99,64,63,19.62086167800453,21.966077097505668,38.0,33.0,101,2.0,1
100,64,66,19.62086167800453,22.01251700680272,38.0,32.0,103,2.0,2
101,64,218,19.62086167800453,21.40879818594105,38.0,18.0,172,2.0,154
102,64,230,19.62086167800453,22.50013605442177,38.0,29.0,207,3.0,166
103,64,474,19.62086167800453,20.642539682539685,38.0,25.0,412,1.0,410
104,64,510,19.62086167800453,21.40879818594105,38.0,15.0,453,2.0,446
105,64,510,19.62086167800453,22.29115646258504,38.0,22.0,461,3.0,446
106,67,63,20.24780045351474,21.966077097505668,28.0,33.0,74,2.0,4
107,67,66,20.24780045351474,22.01251700680272,28.0,32.0,76,2.0,1
108,67,36,20.24780045351474,23.080634920634925,28.0,29.0,126,3.0,31
109,67,218,20.24780045351474,21.40879818594105,28.0,18.0,159,1.0,151
110,67,230,20.24780045351474,22.50013605442177,28.0,29.0,190,2.0,163
111,67,214,20.24780045351474,23.080634920634925,28.0,31.0,191,3.0,147
112,67,510,20.24780045351474,21.40879818594105,28.0,15.0,446,1.0,443
113,67,510,20.24780045351474,22.29115646258504,28.0,22.0,452,2.0,443
114,67,463,20.24780045351474,23.080634920634925,28.0,22.0,414,3.0,396
115,63,36,21.966077097505668,23.080634920634925,33.0,29.0,55,1.0,27
116,63,67,21.966077097505668,24.91501133786848,33.0,34.0,127,3.0,4
117,63,214,21.966077097505668,23.080634920634925,33.0,31.0,158,1.0,151
118,63,213,21.966077097505668,24.891791383219964,33.0,15.0,196,3.0,150
119,63,463,21.966077097505668,23.080634920634925,33.0,22.0,403,1.0,400
120,63,418,21.966077097505668,24.86857142857143,33.0,15.0,376,3.0,355
121,66,36,22.01251700680272,23.080634920634925,32.0,29.0,55,1.0,30
122,66,67,22.01251700680272,24.91501133786848,32.0,34.0,125,3.0,1
123,66,214,22.01251700680272,23.080634920634925,32.0,31.0,155,1.0,148
124,66,213,22.01251700680272,24.891791383219964,32.0,15.0,192,3.0,147
125,66,463,22.01251700680272,23.080634920634925,32.0,22.0,400,1.0,397
126,66,418,22.01251700680272,24.86857142857143,32.0,15.0,373,3.0,352
127,36,67,23.080634920634925,24.91501133786848,29.0,34.0,85,2.0,31
128,36,181,23.080634920634925,25.518730158730158,29.0,28.0,179,2.0,145
129,36,213,23.080634920634925,24.891791383219964,29.0,15.0,193,2.0,177
130,36,231,23.080634920634925,25.472290249433108,29.0,31.0,221,2.0,195
131,36,418,23.080634920634925,24.86857142857143,29.0,15.0,390,2.0,382
132,67,35,24.91501133786848,26.493968253968248,34.0,22.0,75,2.0,32
133,67,73,24.91501133786848,27.771065759637192,34.0,22.0,123,3.0,6
134,67,223,24.91501133786848,26.354648526077103,34.0,23.0,168,1.0,156
135,67,392,24.91501133786848,26.981587301587304,34.0,9.0,337,2.0,325
136,67,467,24.91501133786848,26.981587301587304,34.0,6.0,410,2.0,400
137,181,73,25.518730158730158,27.771065759637192,28.0,22.0,145,2.0,108
138,181,392,25.518730158730158,26.981587301587304,28.0,9.0,220,1.0,211
139,181,590,25.518730158730158,26.79582766439909,28.0,17.0,413,1.0,409
140,181,467,25.518730158730158,26.981587301587304,28.0,6.0,293,1.0,286
141,181,618,25.518730158730158,26.865487528344673,28.0,21.0,441,1.0,437
142,181,618,25.518730158730158,27.28344671201814,28.0,7.0,444,2.0,437
143,35,73,26.493968253968248,27.771065759637192,22.0,22.0,67,1.0,38
144,35,60,26.493968253968248,28.932063492063488,22.0,24.0,108,2.0,25
145,35,217,26.493968253968248,28.955283446712023,22.0,23.0,211,2.0,182
146,35,209,26.493968253968248,29.442902494331065,22.0,22.0,215,3.0,174
147,73,60,27.771065759637192,28.932063492063488,22.0,24.0,52,1.0,13
148,73,36,27.771065759637192,29.53578231292517,22.0,28.0,85,2.0,37
149,73,35,27.771065759637192,30.02340136054422,22.0,24.0,104,2.0,38
150,73,217,27.771065759637192,28.955283446712023,22.0,23.0,153,1.0,144
151,73,209,27.771065759637192,29.442902494331065,22.0,22.0,154,2.0,136
152,73,232,27.771065759637192,30.00018140589569,22.0,17.0,186,2.0,159
153,60,35,28.932063492063488,30.02340136054422,24.0,24.0,53,1.0,25
154,60,66,28.932063492063488,31.880997732426305,24.0,37.0,127,3.0,6
155,60,232,28.932063492063488,30.00018140589569,24.0,17.0,178,1.0,172
156,36,66,29.53578231292517,31.880997732426305,28.0,37.0,105,2.0,30
157,36,63,29.53578231292517,32.08997732426304,28.0,33.0,113,3.0,27
158,36,217,29.53578231292517,31.97387755102041,28.0,23.0,209,2.0,181
159,36,212,29.53578231292517,32.13641723356009,28.0,29.0,209,3.0,176
160,36,477,29.53578231292517,32.13641723356009,28.0,27.0,455,3.0,441
161,35,66,30.02340136054422,31.880997732426305,24.0,37.0,86,2.0,31
162,35,63,30.02340136054422,32.08997732426304,24.0,33.0,93,2.0,28
163,35,217,30.02340136054422,31.97387755102041,24.0,23.0,200,2.0,182
164,35,212,30.02340136054422,32.13641723356009,24.0,29.0,199,2.0,177
165,35,477,30.02340136054422,32.13641723356009,24.0,27.0,451,2.0,442
166,66,55,31.880997732426305,33.715374149659866,37.0,22.0,80,2.0,11
167,66,67,31.880997732426305,34.644172335600906,37.0,31.0,119,3.0,1
168,66,209,31.880997732426305,33.01877551020408,37.0,19.0,151,1.0,143
169,66,494,31.880997732426305,33.18131519274377,37.0,15.0,432,1.0,428
170,66,483,31.880997732426305,34.82993197278912,37.0,29.0,436,3.0,417
171,63,55,32.08997732426304,33.715374149659866,33.0,22.0,70,2.0,8
172,63,67,32.08997732426304,34.644172335600906,33.0,31.0,110,3.0,4
173,63,236,32.08997732426304,34.89959183673469,33.0,22.0,211,3.0,173
174,63,494,32.08997732426304,33.18131519274377,33.0,15.0,434,1.0,431
175,63,483,32.08997732426304,34.82993197278912,33.0,29.0,436,3.0,420
176,55,80,33.715374149659866,35.851609977324266,22.0,30.0,95,2.0,25
177,55,82,33.715374149659866,36.037369614512464,22.0,25.0,104,2.0,27
178,55,236,33.715374149659866,34.89959183673469,22.0,22.0,188,1.0,181
179,55,234,33.715374149659866,35.340770975056685,22.0,24.0,192,2.0,179
180,55,236,33.715374149659866,36.083809523809535,22.0,18.0,208,2.0,181
181,55,483,33.715374149659866,34.82993197278912,22.0,29.0,431,1.0,428
182,55,459,33.715374149659866,35.94448979591837,22.0,23.0,415,2.0,404
183,55,468,33.715374149659866,36.014149659863946,22.0,16.0,425,2.0,413
184,67,80,34.644172335600906,35.851609977324266,31.0,30.0,54,1.0,13
185,67,82,34.644172335600906,36.037369614512464,31.0,25.0,62,1.0,15
186,67,236,34.644172335600906,36.083809523809535,31.0,18.0,180,1.0,169
187,67,459,34.644172335600906,35.94448979591837,31.0,23.0,396,1.0,392
188,67,468,34.644172335600906,36.014149659863946,31.0,16.0,405,1.0,401
189,80,74,35.851609977324266,37.94140589569161,30.0,29.0,90,2.0,6
190,80,79,35.851609977324266,38.35936507936508,30.0,26.0,108,3.0,1
191,80,295,35.851609977324266,37.94140589569161,30.0,26.0,233,2.0,215
192,80,461,35.851609977324266,37.9181859410431,30.0,27.0,391,2.0,381
193,80,474,35.851609977324266,38.38258503401361,30.0,27.0,409,3.0,394
194,82,74,36.037369614512464,37.94140589569161,25.0,29.0,82,2.0,8
195,82,79,36.037369614512464,38.35936507936508,25.0,26.0,100,2.0,3
196,82,295,36.037369614512464,37.94140589569161,25.0,26.0,228,2.0,213
197,82,212,36.037369614512464,38.963083900226756,25.0,29.0,181,3.0,130
198,82,461,36.037369614512464,37.9181859410431,25.0,27.0,388,2.0,379
199,82,474,36.037369614512464,38.38258503401361,25.0,27.0,405,2.0,392
200,82,432,36.037369614512464,39.00952380952381,25.0,21.0,373,3.0,350
201,74,55,37.94140589569161,39.2649433106576,29.0,21.0,60,1.0,19
202,74,63,37.94140589569161,39.984761904761896,29.0,24.0,89,2.0,11
203,74,212,37.94140589569161,38.963083900226756,29.0,29.0,145,1.0,138
204,74,209,37.94140589569161,39.055963718820855,29.0,27.0,143,1.0,135
205,74,208,37.94140589569161,40.05442176870749,29.0,24.0,162,2.0,134
206,74,432,37.94140589569161,39.00952380952381,29.0,21.0,361,1.0,358
207,74,480,37.94140589569161,40.00798185941043,29.0,20.0,416,2.0,406
208,79,63,38.35936507936508,39.984761904761896,26.0,24.0,72,2.0,16
209,79,208,38.35936507936508,40.05442176870749,26.0,24.0,148,2.0,129
210,79,480,38.35936507936508,40.00798185941043,26.0,20.0,407,2.0,401
211,55,80,39.2649433106576,41.88879818594104,21.0,27.0,116,3.0,25
212,55,60,39.2649433106576,42.00489795918367,21.0,27.0,118,3.0,5
213,55,217,39.2649433106576,41.56371882086168,21.0,31.0,190,2.0,162
214,55,228,39.2649433106576,42.120997732426304,21.0,28.0,212,3.0,173
215,55,485,39.2649433106576,41.88879818594104,21.0,24.0,445,3.0,430
216,55,474,39.2649433106576,41.98167800453515,21.0,20.0,435,3.0,419
217,63,80,39.984761904761896,41.88879818594104,24.0,27.0,84,2.0,17
218,63,60,39.984761904761896,42.00489795918367,24.0,27.0,87,2.0,3
219,63,217,39.984761904761896,41.56371882086168,24.0,31.0,168,2.0,154
220,63,228,39.984761904761896,42.120997732426304,24.0,28.0,189,2.0,165
221,63,485,39.984761904761896,41.88879818594104,24.0,24.0,430,2.0,422
222,63,474,39.984761904761896,41.98167800453515,24.0,20.0,420,2.0,411
223,80,44,41.88879818594104,43.81605442176871,27.0,23.0,90,2.0,36
224,80,78,41.88879818594104,44.30367346938775,27.0,29.0,104,2.0,2
225,80,218,41.88879818594104,42.98013605442178,27.0,10.0,146,1.0,138
226,80,218,41.88879818594104,44.23401360544218,27.0,25.0,171,2.0,138
227,80,438,41.88879818594104,43.86249433106576,27.0,7.0,368,2.0,358
228,80,466,41.88879818594104,44.23401360544218,27.0,25.0,399,2.0,386
229,60,44,42.00489795918367,43.81605442176871,27.0,23.0,80,2.0,16
230,60,78,42.00489795918367,44.30367346938775,27.0,29.0,101,2.0,18
231,60,218,42.00489795918367,44.23401360544218,27.0,25.0,185,2.0,158
232,60,438,42.00489795918367,43.86249433106576,27.0,7.0,386,2.0,378
233,60,466,42.00489795918367,44.23401360544218,27.0,25.0,417,2.0,406
234,44,89,43.81605442176871,45.30213151927439,23.0,32.0,78,1.0,45
235,44,55,43.81605442176871,46.60244897959185,23.0,30.0,121,3.0,11
236,44,233,43.81605442176871,45.046712018140596,23.0,23.0,196,1.0,189
237,44,206,43.81605442176871,46.16126984126985,23.0,10.0,191,2.0,162
238,44,474,43.81605442176871,45.11637188208617,23.0,21.0,434,1.0,430
239,78,55,44.30367346938775,46.60244897959185,29.0,30.0,102,2.0,23
240,78,206,44.30367346938775,46.16126984126985,29.0,10.0,151,2.0,128
241,78,425,44.30367346938775,46.973968253968245,29.0,10.0,366,3.0,347
242,89,55,45.30213151927439,46.60244897959185,32.0,30.0,66,1.0,34
243,89,70,45.30213151927439,47.484807256235825,32.0,32.0,96,2.0,19
244,89,227,45.30213151927439,47.76344671201814,32.0,24.0,174,2.0,138
245,89,425,45.30213151927439,46.973968253968245,32.0,10.0,344,2.0,336
246,89,451,45.30213151927439,47.53124716553288,32.0,27.0,375,2.0,362
247,55,46,46.60244897959185,48.320725623582774,30.0,21.0,75,2.0,9
248,55,227,46.60244897959185,47.76344671201814,30.0,24.0,179,1.0,172
249,55,216,46.60244897959185,48.320725623582774,30.0,21.0,177,2.0,161
250,55,438,46.60244897959185,48.57614512471656,30.0,17.0,392,2.0,383
251,70,158,47.484807256235825,50.3873015873016,32.0,23.0,153,3.0,88
252,70,223,47.484807256235825,49.922902494331076,32.0,21.0,186,2.0,153
253,70,438,47.484807256235825,48.57614512471656,32.0,17.0,371,1.0,368
254,70,457,47.484807256235825,49.899682539682544,32.0,20.0,401,2.0,387
255,70,422,47.484807256235825,50.3873015873016,32.0,14.0,374,3.0,352
256,46,70,48.320725623582774,49.83002267573696,21.0,28.0,69,2.0,24
257,46,158,48.320725623582774,50.3873015873016,21.0,23.0,143,2.0,112
258,46,223,48.320725623582774,49.922902494331076,21.0,21.0,190,2.0,177
259,46,210,48.320725623582774,50.61950113378685,21.0,26.0,192,2.0,164
260,46,457,48.320725623582774,49.899682539682544,21.0,20.0,417,2.0,411
261,46,422,48.320725623582774,50.3873015873016,21.0,14.0,386,2.0,376
262,70,56,49.83002267573696,51.919818594104306,28.0,30.0,91,2.0,14
263,70,59,49.83002267573696,52.22167800453515,28.0,31.0,104,2.0,11
264,70,213,49.83002267573696,51.966258503401356,28.0,22.0,170,2.0,143
265,70,216,49.83002267573696,52.546757369614504,28.0,30.0,187,3.0,146
266,70,455,49.83002267573696,51.966258503401356,28.0,19.0,396,2.0,385
267,70,451,49.83002267573696,52.38421768707482,28.0,27.0,397,3.0,381
268,158,56,50.3873015873016,51.919818594104306,23.0,30.0,121,2.0,102
269,158,59,50.3873015873016,52.22167800453515,23.0,31.0,127,2.0,99
270,158,31,50.3873015873016,53.336235827664396,23.0,30.0,180,3.0,127
271,158,213,50.3873015873016,51.966258503401356,23.0,22.0,87,2.0,55
272,158,216,50.3873015873016,52.546757369614504,23.0,30.0,110,2.0,58
273,158,213,50.3873015873016,53.31301587301587,23.0,22.0,137,3.0,55
274,158,455,50.3873015873016,51.966258503401356,23.0,19.0,305,2.0,297
275,158,451,50.3873015873016,52.38421768707482,23.0,27.0,305,2.0,293
276,158,643,50.3873015873016,51.61795918367347,23.0,9.0,488,1.0,485
277,158,643,50.3873015873016,52.012698412698406,23.0,18.0,490,2.0,485
278,158,644,50.3873015873016,53.17369614512472,23.0,13.0,501,3.0,486
279,56,31,51.919818594104306,53.336235827664396,30.0,30.0,66,1.0,25
280,56,31,51.919818594104306,54.00961451247166,30.0,28.0,93,2.0,25
281,56,213,51.919818594104306,53.31301587301587,30.0,22.0,168,1.0,157
282,56,208,51.919818594104306,54.68299319727891,30.0,25.0,193,3.0,152
283,56,459,51.919818594104306,53.63809523809525,30.0,20.0,410,2.0,403
284,56,416,51.919818594104306,54.68299319727891,30.0,14.0,379,3.0,360
285,59,31,52.22167800453515,53.336235827664396,31.0,30.0,56,1.0,28
286,59,31,52.22167800453515,54.00961451247166,31.0,28.0,82,2.0,28
287,59,213,52.22167800453515,53.31301587301587,31.0,22.0,161,1.0,154
288,59,208,52.22167800453515,54.68299319727891,31.0,25.0,183,2.0,149
289,59,270,52.22167800453515,55.147392290249435,31.0,17.0,246,3.0,211
290,59,459,52.22167800453515,53.63809523809525,31.0,20.0,405,1.0,400
291,59,416,52.22167800453515,54.68299319727891,31.0,14.0,372,2.0,357
292,31,55,53.336235827664396,55.96009070294785,30.0,27.0,116,3.0,24
293,31,55,53.336235827664396,55.98331065759637,30.0,28.0,116,3.0,24
294,31,208,53.336235827664396,54.68299319727891,30.0,25.0,186,1.0,177
295,31,270,53.336235827664396,55.147392290249435,30.0,17.0,251,2.0,239
296,31,328,53.336235827664396,55.98331065759637,30.0,13.0,318,3.0,297
297,31,416,53.336235827664396,54.68299319727891,30.0,14.0,389,1.0,385
298,31,55,54.00961451247166,55.96009070294785,28.0,27.0,87,2.0,24
299,31,55,54.00961451247166,55.98331065759637,28.0,28.0,88,2.0,24
300,31,270,54.00961451247166,55.147392290249435,28.0,17.0,244,1.0,239
301,31,328,54.00961451247166,55.98331065759637,28.0,13.0,309,2.0,297
302,55,52,55.96009070294785,57.701587301587296,27.0,31.0,75,2.0,3
303,55,68,55.96009070294785,58.11954648526077,27.0,9.0,94,2.0,13
304,55,206,55.96009070294785,57.35328798185941,27.0,25.0,162,1.0,151
305,55,391,55.96009070294785,58.09632653061225,27.0,16.0,348,2.0,336
306,55,484,55.96009070294785,57.678367346938785,27.0,26.0,435,2.0,429
307,55,52,55.98331065759637,57.701587301587296,28.0,31.0,74,2.0,3
308,55,68,55.98331065759637,58.11954648526077,28.0,9.0,93,2.0,13
309,55,206,55.98331065759637,57.35328798185941,28.0,25.0,162,1.0,151
310,55,391,55.98331065759637,58.09632653061225,28.0,16.0,348,2.0,336
311,55,484,55.98331065759637,57.678367346938785,28.0,26.0,435,2.0,429
312,52,75,57.701587301587296,59.744943310657604,31.0,31.0,91,2.0,23
313,52,206,57.701587301587296,59.76816326530612,31.0,23.0,178,2.0,154
314,52,470,57.701587301587296,59.72172335600907,31.0,27.0,427,2.0,418
315,68,75,58.11954648526077,59.744943310657604,9.0,31.0,70,2.0,7
316,68,206,58.11954648526077,59.76816326530612,9.0,23.0,155,2.0,138
317,68,470,58.11954648526077,59.72172335600907,9.0,27.0,408,2.0,402
318,214,41,0.9287981859410432,2.159455782312925,12.0,24.0,181,1.0,173
319,214,55,0.9287981859410432,3.3668934240362813,12.0,24.0,191,2.0,159
320,214,274,0.9287981859410432,2.229115646258504,12.0,17.0,82,1.0,60
321,214,274,0.9287981859410432,3.0418140589569163,12.0,16.0,109,2.0,60
322,214,612,0.9287981859410432,2.9257142857142857,12.0,17.0,407,2.0,398
323,214,613,0.9287981859410432,3.2972335600907035,12.0,20.0,412,2.0,399
324,214,655,0.9287981859410432,2.972154195011338,12.0,22.0,450,2.0,441
325,214,656,0.9287981859410432,3.3436734693877552,12.0,21.0,454,2.0,442
326,274,55,1.811156462585034,3.3668934240362813,13.0,24.0,229,2.0,219
327,274,612,1.811156462585034,2.9257142857142857,13.0,17.0,341,1.0,338
328,274,613,1.811156462585034,3.2972335600907035,13.0,20.0,345,1.0,339
329,274,655,1.811156462585034,2.972154195011338,13.0,22.0,384,1.0,381
330,274,656,1.811156462585034,3.3436734693877552,13.0,21.0,388,2.0,382
331,274,55,2.229115646258504,3.3668934240362813,17.0,24.0,224,1.0,219
332,274,55,2.229115646258504,4.899410430839002,17.0,23.0,247,3.0,219
333,274,263,2.229115646258504,4.85297052154195,17.0,14.0,114,3.0,11
334,274,613,2.229115646258504,3.2972335600907035,17.0,20.0,342,1.0,339
335,274,613,2.229115646258504,4.85297052154195,17.0,22.0,357,3.0,339
336,274,656,2.229115646258504,3.3436734693877552,17.0,21.0,385,1.0,382
337,274,656,2.229115646258504,4.899410430839002,17.0,20.0,399,3.0,382
338,274,55,3.0418140589569163,4.899410430839002,16.0,23.0,233,2.0,219
339,274,69,3.0418140589569163,5.6656689342403626,16.0,20.0,234,3.0,205
340,274,263,3.0418140589569163,4.85297052154195,16.0,14.0,79,2.0,11
341,274,206,3.0418140589569163,5.27092970521542,16.0,15.0,118,2.0,68
342,274,613,3.0418140589569163,4.85297052154195,16.0,22.0,348,2.0,339
343,274,613,3.0418140589569163,5.27092970521542,16.0,20.0,352,2.0,339
344,274,656,3.0418140589569163,4.899410430839002,16.0,20.0,390,2.0,382
345,274,656,3.0418140589569163,5.317369614512471,16.0,16.0,394,2.0,382
346,263,66,4.85297052154195,6.919546485260772,14.0,32.0,216,2.0,197
347,263,207,4.85297052154195,6.919546485260772,14.0,22.0,105,2.0,56
348,263,216,4.85297052154195,7.6393650793650805,14.0,28.0,129,3.0,47
349,263,613,4.85297052154195,6.431927437641723,14.0,23.0,357,2.0,350
350,263,485,4.85297052154195,7.662585034013605,14.0,27.0,253,3.0,222
351,263,656,4.85297052154195,6.431927437641723,14.0,24.0,399,2.0,393
352,263,656,4.85297052154195,7.616145124716552,14.0,27.0,411,3.0,393
353,206,66,5.27092970521542,6.919546485260772,15.0,32.0,157,2.0,140
354,206,66,5.27092970521542,7.848344671201813,15.0,32.0,179,3.0,140
355,206,67,5.27092970521542,8.057324263038549,15.0,27.0,184,3.0,139
356,206,207,5.27092970521542,6.919546485260772,15.0,22.0,71,2.0,1
357,206,216,5.27092970521542,7.6393650793650805,15.0,28.0,102,2.0,10
358,206,236,5.27092970521542,8.057324263038549,15.0,22.0,124,3.0,30
359,206,613,5.27092970521542,6.431927437641723,15.0,23.0,410,1.0,407
360,206,485,5.27092970521542,7.662585034013605,15.0,27.0,297,2.0,279
361,206,433,5.27092970521542,8.010884353741497,15.0,21.0,256,3.0,227
362,206,656,5.27092970521542,6.431927437641723,15.0,24.0,453,1.0,450
363,206,656,5.27092970521542,7.616145124716552,15.0,27.0,461,2.0,450
364,207,67,6.919546485260772,8.057324263038549,22.0,27.0,148,1.0,140
365,207,55,6.919546485260772,9.729160997732428,22.0,24.0,194,3.0,152
366,207,236,6.919546485260772,8.057324263038549,22.0,22.0,57,1.0,29
367,207,214,6.919546485260772,9.729160997732428,22.0,26.0,121,3.0,7
368,207,433,6.919546485260772,8.010884353741497,22.0,21.0,231,1.0,226
369,207,439,6.919546485260772,9.845260770975058,22.0,20.0,264,3.0,232
370,207,656,6.919546485260772,8.40562358276644,22.0,11.0,454,1.0,449
371,207,656,6.919546485260772,9.613061224489797,22.0,19.0,464,3.0,449
372,216,55,7.6393650793650805,9.729160997732428,28.0,24.0,184,2.0,161
373,216,214,7.6393650793650805,9.729160997732428,28.0,26.0,90,2.0,2
374,216,439,7.6393650793650805,9.845260770975058,28.0,20.0,242,2.0,223
375,216,596,7.6393650793650805,10.356099773242633,28.0,19.0,398,3.0,380
376,216,656,7.6393650793650805,9.613061224489797,28.0,19.0,448,2.0,440
377,216,618,7.6393650793650805,10.402539682539684,28.0,19.0,419,3.0,402
378,236,55,8.057324263038549,9.729160997732428,22.0,24.0,195,2.0,181
379,236,35,8.057324263038549,10.704399092970524,22.0,26.0,231,3.0,201
380,236,214,8.057324263038549,9.729160997732428,22.0,26.0,75,2.0,22
381,236,206,8.057324263038549,10.797278911564627,22.0,21.0,122,3.0,30
382,236,439,8.057324263038549,9.845260770975058,22.0,20.0,217,2.0,203
383,236,596,8.057324263038549,10.356099773242633,22.0,19.0,373,2.0,360
384,236,656,8.057324263038549,9.613061224489797,22.0,19.0,425,2.0,420
385,236,618,8.057324263038549,10.402539682539684,22.0,19.0,395,2.0,382
386,214,41,9.729160997732428,11.58675736961451,26.0,19.0,191,2.0,173
387,214,206,9.729160997732428,10.797278911564627,26.0,21.0,47,1.0,8
388,214,285,9.729160997732428,11.168798185941043,26.0,13.0,94,1.0,71
389,214,386,9.729160997732428,12.701315192743767,26.0,25.0,214,3.0,172
390,214,515,9.729160997732428,11.192018140589571,26.0,15.0,308,1.0,301
391,214,618,9.729160997732428,11.192018140589571,26.0,20.0,409,1.0,404
392,206,68,10.797278911564627,12.933514739229025,21.0,26.0,166,2.0,138
393,206,88,10.797278911564627,13.07283446712018,21.0,30.0,153,2.0,118
394,206,386,10.797278911564627,12.701315192743767,21.0,25.0,198,2.0,180
395,206,225,10.797278911564627,13.676553287981859,21.0,27.0,125,3.0,19
396,206,515,10.797278911564627,12.747755102040815,21.0,24.0,320,2.0,309
397,206,447,10.797278911564627,13.25859410430839,21.0,24.0,263,2.0,241
398,206,618,10.797278911564627,12.770975056689347,21.0,25.0,421,2.0,412
399,206,655,10.797278911564627,13.537233560090703,21.0,15.0,464,3.0,449
400,285,68,11.168798185941043,12.933514739229025,13.0,26.0,230,2.0,217
401,285,88,11.168798185941043,13.07283446712018,13.0,30.0,213,2.0,197
402,285,386,11.168798185941043,12.701315192743767,13.0,25.0,121,2.0,101
403,285,225,11.168798185941043,13.676553287981859,13.0,27.0,124,3.0,60
404,285,515,11.168798185941043,12.747755102040815,13.0,24.0,240,2.0,230
405,285,447,11.168798185941043,13.25859410430839,13.0,24.0,185,2.0,162
406,285,618,11.168798185941043,12.770975056689347,13.0,25.0,340,2.0,333
407,285,655,11.168798185941043,13.537233560090703,13.0,15.0,384,2.0,370
408,386,41,12.701315192743767,14.721451247165533,25.0,16.0,356,2.0,345
409,386,69,12.701315192743767,15.116190476190473,25.0,18.0,334,2.0,317
410,386,292,12.701315192743767,14.303492063492065,25.0,13.0,117,2.0,94
411,386,613,12.701315192743767,14.303492063492065,25.0,20.0,237,2.0,227
412,386,656,12.701315192743767,14.32671201814059,25.0,17.0,279,2.0,270
413,225,41,13.676553287981859,14.721451247165533,27.0,16.0,189,1.0,184
414,225,69,13.676553287981859,15.116190476190473,27.0,18.0,168,1.0,156
415,225,67,13.676553287981859,16.068208616780044,27.0,34.0,189,2.0,158
416,225,227,13.676553287981859,15.882448979591837,27.0,12.0,95,2.0,2
417,225,213,13.676553287981859,16.34684807256236,27.0,23.0,116,3.0,12
418,225,465,13.676553287981859,15.975328798185942,27.0,21.0,260,2.0,240
419,225,434,13.676553287981859,16.46294784580499,27.0,23.0,241,3.0,209
420,225,656,13.676553287981859,15.928888888888887,27.0,16.0,442,2.0,431
421,225,627,13.676553287981859,16.207528344671204,27.0,7.0,417,3.0,402
422,292,67,14.303492063492065,16.068208616780044,13.0,34.0,237,2.0,225
423,292,197,14.303492063492065,17.04344671201814,13.0,27.0,151,3.0,95
424,292,227,14.303492063492065,15.882448979591837,13.0,12.0,94,2.0,65
425,292,213,14.303492063492065,16.34684807256236,13.0,23.0,118,2.0,79
426,292,465,14.303492063492065,15.975328798185942,13.0,21.0,187,2.0,173
427,292,434,14.303492063492065,16.46294784580499,13.0,23.0,170,2.0,142
428,292,656,14.303492063492065,15.928888888888887,13.0,16.0,371,2.0,364
429,292,627,14.303492063492065,16.207528344671204,13.0,7.0,345,2.0,335
430,292,673,14.303492063492065,17.136326530612244,13.0,20.0,400,3.0,381
431,227,197,15.882448979591837,17.04344671201814,12.0,27.0,58,1.0,30
432,227,69,15.882448979591837,18.274104308390022,12.0,22.0,189,2.0,158
433,227,211,15.882448979591837,17.29886621315193,12.0,22.0,63,1.0,16
434,227,366,15.882448979591837,18.250884353741494,12.0,13.0,172,2.0,139
435,227,478,15.882448979591837,17.41496598639456,12.0,22.0,260,2.0,251
436,227,549,15.882448979591837,18.250884353741494,12.0,18.0,338,2.0,322
437,227,673,15.882448979591837,17.136326530612244,12.0,20.0,449,1.0,446
438,227,628,15.882448979591837,18.250884353741494,12.0,10.0,414,2.0,401
439,213,69,16.34684807256236,18.274104308390022,23.0,22.0,166,2.0,144
440,213,366,16.34684807256236,18.250884353741494,23.0,13.0,174,2.0,153
441,213,478,16.34684807256236,17.41496598639456,23.0,22.0,269,1.0,265
442,213,549,16.34684807256236,18.250884353741494,23.0,18.0,346,2.0,336
443,213,628,16.34684807256236,18.250884353741494,23.0,10.0,423,2.0,415
444,213,643,16.34684807256236,19.040362811791386,23.0,21.0,445,3.0,430
445,211,64,17.29886621315193,19.62086167800453,22.0,38.0,178,2.0,147
446,211,67,17.29886621315193,20.24780045351474,22.0,28.0,192,3.0,144
447,211,434,17.29886621315193,19.806621315192746,22.0,20.0,248,3.0,223
448,211,643,17.29886621315193,19.040362811791386,22.0,21.0,438,2.0,432
449,211,617,17.29886621315193,20.038820861678005,22.0,16.0,423,3.0,406
450,366,64,18.250884353741494,19.62086167800453,13.0,38.0,308,1.0,302
451,366,67,18.250884353741494,20.24780045351474,13.0,28.0,311,2.0,299
452,366,211,18.250884353741494,19.783401360544214,13.0,29.0,168,2.0,155
453,366,227,18.250884353741494,20.433560090702947,13.0,27.0,168,2.0,139
454,366,434,18.250884353741494,19.806621315192746,13.0,20.0,95,2.0,68
455,366,474,18.250884353741494,20.642539682539685,13.0,25.0,149,2.0,108
456,366,617,18.250884353741494,20.038820861678005,13.0,16.0,263,2.0,251
457,211,63,19.783401360544214,21.966077097505668,29.0,33.0,175,2.0,148
458,211,66,19.783401360544214,22.01251700680272,29.0,32.0,174,2.0,145
459,211,218,19.783401360544214,21.40879818594105,29.0,18.0,70,2.0,7
460,211,230,19.783401360544214,22.50013605442177,29.0,29.0,119,3.0,19
461,211,510,19.783401360544214,21.40879818594105,29.0,15.0,307,2.0,299
462,211,510,19.783401360544214,22.29115646258504,29.0,22.0,318,3.0,299
463,211,675,19.783401360544214,21.362358276643988,29.0,2.0,469,2.0,464
464,211,617,19.783401360544214,22.29115646258504,29.0,25.0,420,3.0,406
465,227,63,20.433560090702947,21.966077097505668,27.0,33.0,177,2.0,164
466,227,66,20.433560090702947,22.01251700680272,27.0,32.0,175,2.0,161
467,227,36,20.433560090702947,23.080634920634925,27.0,29.0,222,3.0,191
468,227,230,20.433560090702947,22.50013605442177,27.0,29.0,89,2.0,3
469,227,214,20.433560090702947,23.080634920634925,27.0,31.0,115,3.0,13
470,227,510,20.433560090702947,22.29115646258504,27.0,22.0,294,2.0,283
471,227,463,20.433560090702947,23.080634920634925,27.0,22.0,262,3.0,236
472,227,617,20.433560090702947,22.29115646258504,27.0,25.0,398,2.0,390
473,227,675,20.433560090702947,23.19673469387755,27.0,13.0,464,3.0,448
474,218,36,21.40879818594105,23.080634920634925,18.0,29.0,196,2.0,182
475,218,230,21.40879818594105,22.50013605442177,18.0,29.0,49,1.0,12
476,218,214,21.40879818594105,23.080634920634925,18.0,31.0,72,2.0,4
477,218,463,21.40879818594105,23.080634920634925,18.0,22.0,255,2.0,245
478,218,675,21.40879818594105,23.19673469387755,18.0,13.0,463,2.0,457
479,230,67,22.50013605442177,24.91501133786848,29.0,34.0,193,2.0,163
480,230,213,22.50013605442177,24.891791383219964,29.0,15.0,104,2.0,17
481,230,231,22.50013605442177,25.472290249433108,29.0,31.0,128,3.0,1
482,230,418,22.50013605442177,24.86857142857143,29.0,15.0,214,2.0,188
483,230,582,22.50013605442177,25.147210884353747,29.0,25.0,370,3.0,352
484,230,655,22.50013605442177,24.938231292517013,29.0,0.0,438,2.0,425
485,230,641,22.50013605442177,25.17043083900227,29.0,26.0,427,3.0,411
486,214,67,23.080634920634925,24.91501133786848,31.0,34.0,167,2.0,147
487,214,181,23.080634920634925,25.518730158730158,31.0,28.0,110,2.0,33
488,214,213,23.080634920634925,24.891791383219964,31.0,15.0,78,2.0,1
489,214,231,23.080634920634925,25.472290249433108,31.0,31.0,104,2.0,17
490,214,418,23.080634920634925,24.86857142857143,31.0,15.0,218,2.0,204
491,214,582,23.080634920634925,25.147210884353747,31.0,25.0,379,2.0,368
492,214,655,23.080634920634925,24.938231292517013,31.0,0.0,448,2.0,441
493,214,641,23.080634920634925,25.17043083900227,31.0,26.0,436,2.0,427
494,213,35,24.891791383219964,26.493968253968248,15.0,22.0,191,2.0,178
495,213,73,24.891791383219964,27.771065759637192,15.0,22.0,187,3.0,140
496,213,223,24.891791383219964,26.354648526077103,15.0,23.0,64,1.0,10
497,213,392,24.891791383219964,26.981587301587304,15.0,9.0,200,2.0,179
498,213,590,24.891791383219964,26.79582766439909,15.0,17.0,386,2.0,377
499,213,467,24.891791383219964,26.981587301587304,15.0,6.0,269,2.0,254
500,213,618,24.891791383219964,26.865487528344673,15.0,21.0,414,2.0,405
501,213,618,24.891791383219964,27.28344671201814,15.0,7.0,418,2.0,405
502,231,35,25.472290249433108,26.493968253968248,31.0,22.0,201,1.0,196
503,231,73,25.472290249433108,27.771065759637192,31.0,22.0,186,2.0,158
504,231,392,25.472290249433108,26.981587301587304,31.0,9.0,174,2.0,161
505,231,590,25.472290249433108,26.79582766439909,31.0,17.0,363,1.0,359
506,231,467,25.472290249433108,26.981587301587304,31.0,6.0,245,2.0,236
507,231,618,25.472290249433108,26.865487528344673,31.0,21.0,392,1.0,387
508,231,618,25.472290249433108,27.28344671201814,31.0,7.0,395,2.0,387
509,223,73,26.354648526077103,27.771065759637192,23.0,22.0,162,1.0,150
510,223,60,26.354648526077103,28.932063492063488,23.0,24.0,197,3.0,163
511,223,217,26.354648526077103,28.955283446712023,23.0,23.0,112,3.0,6
512,223,595,26.354648526077103,28.699863945578237,23.0,26.0,385,2.0,372
513,223,596,26.354648526077103,29.23392290249433,23.0,30.0,393,3.0,373
514,223,617,26.354648526077103,28.72308390022676,23.0,20.0,407,2.0,394
515,223,626,26.354648526077103,29.23392290249433,23.0,26.0,422,3.0,403
516,392,60,26.981587301587304,28.932063492063488,9.0,24.0,342,2.0,332
517,392,36,26.981587301587304,29.53578231292517,9.0,28.0,373,3.0,356
518,392,217,26.981587301587304,28.955283446712023,9.0,23.0,195,2.0,175
519,392,209,26.981587301587304,29.442902494331065,9.0,22.0,211,2.0,183
520,392,595,26.981587301587304,28.699863945578237,9.0,26.0,216,2.0,203
521,392,596,26.981587301587304,29.23392290249433,9.0,30.0,226,2.0,204
522,392,617,26.981587301587304,28.72308390022676,9.0,20.0,237,2.0,225
523,392,626,26.981587301587304,29.23392290249433,9.0,26.0,253,2.0,234
524,392,833,26.981587301587304,28.699863945578237,9.0,4.0,447,2.0,441
525,392,870,26.981587301587304,29.257142857142853,9.0,9.0,488,2.0,478
526,217,35,28.955283446712023,30.02340136054422,23.0,24.0,188,1.0,182
527,217,66,28.955283446712023,31.880997732426305,23.0,37.0,197,3.0,151
528,217,232,28.955283446712023,30.00018140589569,23.0,17.0,47,1.0,15
529,217,614,28.955283446712023,30.78965986394558,23.0,20.0,405,2.0,397
530,217,613,28.955283446712023,31.579138321995462,23.0,23.0,412,3.0,396
531,217,656,28.955283446712023,30.81287981859411,23.0,18.0,446,2.0,439
532,217,656,28.955283446712023,31.579138321995462,23.0,20.0,453,3.0,439
533,209,66,29.442902494331065,31.880997732426305,22.0,37.0,177,2.0,143
534,209,63,29.442902494331065,32.08997732426304,22.0,33.0,185,3.0,146
535,209,217,29.442902494331065,31.97387755102041,22.0,23.0,109,3.0,8
536,209,212,29.442902494331065,32.13641723356009,22.0,29.0,116,3.0,3
537,209,614,29.442902494331065,30.78965986394558,22.0,20.0,409,1.0,405
538,209,613,29.442902494331065,31.579138321995462,22.0,23.0,414,2.0,404
539,209,477,29.442902494331065,32.13641723356009,22.0,27.0,292,3.0,268
540,209,656,29.442902494331065,30.81287981859411,22.0,18.0,451,1.0,447
541,209,656,29.442902494331065,31.579138321995462,22.0,20.0,456,2.0,447
542,232,66,30.00018140589569,31.880997732426305,17.0,37.0,185,2.0,166
543,232,63,30.00018140589569,32.08997732426304,17.0,33.0,191,2.0,169
544,232,217,30.00018140589569,31.97387755102041,17.0,23.0,86,2.0,15
545,232,212,30.00018140589569,32.13641723356009,17.0,29.0,94,2.0,20
546,232,613,30.00018140589569,31.579138321995462,17.0,23.0,387,2.0,381
547,232,477,30.00018140589569,32.13641723356009,17.0,27.0,262,2.0,245
548,232,656,30.00018140589569,31.579138321995462,17.0,20.0,429,2.0,424
549,232,615,30.00018140589569,32.554376417233556,17.0,9.0,398,3.0,383
550,217,55,31.97387755102041,33.715374149659866,23.0,22.0,179,2.0,162
551,217,67,31.97387755102041,34.644172335600906,23.0,31.0,189,3.0,150
552,217,209,31.97387755102041,33.01877551020408,23.0,19.0,46,1.0,8
553,217,236,31.97387755102041,34.89959183673469,23.0,22.0,127,3.0,19
554,217,494,31.97387755102041,33.18131519274377,23.0,15.0,282,1.0,277
555,217,483,31.97387755102041,34.82993197278912,23.0,29.0,293,3.0,266
556,217,656,31.97387755102041,33.18131519274377,23.0,17.0,442,1.0,439
557,217,619,31.97387755102041,34.365532879818595,23.0,15.0,415,2.0,402
558,212,55,32.13641723356009,33.715374149659866,29.0,22.0,171,2.0,157
559,212,67,32.13641723356009,34.644172335600906,29.0,31.0,181,3.0,145
560,212,236,32.13641723356009,34.89959183673469,29.0,22.0,121,3.0,24
561,212,494,32.13641723356009,33.18131519274377,29.0,15.0,286,1.0,282
562,212,483,32.13641723356009,34.82993197278912,29.0,29.0,295,3.0,271
563,212,656,32.13641723356009,33.18131519274377,29.0,17.0,446,1.0,444
564,212,619,32.13641723356009,34.365532879818595,29.0,15.0,418,2.0,407
565,209,67,33.01877551020408,34.644172335600906,19.0,31.0,158,2.0,142
566,209,80,33.01877551020408,35.851609977324266,19.0,30.0,178,3.0,129
567,209,236,33.01877551020408,34.89959183673469,19.0,22.0,85,2.0,27
568,209,234,33.01877551020408,35.340770975056685,19.0,24.0,103,2.0,25
569,209,483,33.01877551020408,34.82993197278912,19.0,29.0,285,2.0,274
570,209,459,33.01877551020408,35.94448979591837,19.0,23.0,280,3.0,250
571,209,619,33.01877551020408,34.365532879818595,19.0,15.0,414,1.0,410
572,209,622,33.01877551020408,35.5265306122449,19.0,17.0,427,3.0,413
573,236,82,34.89959183673469,36.037369614512464,22.0,25.0,162,1.0,154
574,236,459,34.89959183673469,35.94448979591837,22.0,23.0,227,1.0,223
575,236,468,34.89959183673469,36.014149659863946,22.0,16.0,237,1.0,232
576,236,656,34.89959183673469,36.75718820861678,22.0,11.0,428,2.0,420
577,236,617,34.89959183673469,37.8485260770975,22.0,14.0,402,3.0,381
578,234,74,35.340770975056685,37.94140589569161,24.0,29.0,195,3.0,160
579,234,295,35.340770975056685,37.94140589569161,24.0,26.0,128,3.0,61
580,234,461,35.340770975056685,37.9181859410431,24.0,27.0,253,3.0,227
581,234,656,35.340770975056685,36.75718820861678,24.0,11.0,426,1.0,422
582,234,617,35.340770975056685,37.8485260770975,24.0,14.0,398,3.0,383
583,234,624,35.340770975056685,38.150385487528354,24.0,19.0,408,3.0,390
584,236,74,36.083809523809535,37.94140589569161,18.0,29.0,181,2.0,162
585,236,79,36.083809523809535,38.35936507936508,18.0,26.0,185,2.0,157
586,236,295,36.083809523809535,37.94140589569161,18.0,26.0,99,2.0,59
587,236,212,36.083809523809535,38.963083900226756,18.0,29.0,126,3.0,24
588,236,209,36.083809523809535,39.055963718820855,18.0,27.0,131,3.0,27
589,236,461,36.083809523809535,37.9181859410431,18.0,27.0,238,2.0,225
590,236,474,36.083809523809535,38.38258503401361,18.0,27.0,258,2.0,238
591,236,432,36.083809523809535,39.00952380952381,18.0,21.0,233,3.0,196
592,236,617,36.083809523809535,37.8485260770975,18.0,14.0,389,2.0,381
593,236,624,36.083809523809535,38.150385487528354,18.0,19.0,398,2.0,388
594,295,55,37.94140589569161,39.2649433106576,26.0,21.0,247,1.0,240
595,295,63,37.94140589569161,39.984761904761896,26.0,24.0,248,2.0,232
596,295,212,37.94140589569161,38.963083900226756,26.0,29.0,94,1.0,83
597,295,209,37.94140589569161,39.055963718820855,26.0,27.0,98,1.0,86
598,295,208,37.94140589569161,40.05442176870749,26.0,24.0,126,2.0,87
599,295,432,37.94140589569161,39.00952380952381,26.0,21.0,145,1.0,137
600,295,480,37.94140589569161,40.00798185941043,26.0,20.0,205,2.0,185
601,295,653,37.94140589569161,39.28816326530613,26.0,14.0,363,1.0,358
602,295,628,37.94140589569161,40.07764172335601,26.0,6.0,345,2.0,333
603,212,63,38.963083900226756,39.984761904761896,29.0,24.0,155,1.0,149
604,212,80,38.963083900226756,41.88879818594104,29.0,27.0,182,3.0,132
605,212,208,38.963083900226756,40.05442176870749,29.0,24.0,47,1.0,4
606,212,217,38.963083900226756,41.56371882086168,29.0,31.0,112,3.0,5
607,212,480,38.963083900226756,40.00798185941043,29.0,20.0,272,1.0,268
608,212,485,38.963083900226756,41.88879818594104,29.0,24.0,301,3.0,273
609,212,628,38.963083900226756,40.07764172335601,29.0,6.0,419,1.0,416
610,212,656,38.963083900226756,41.84235827664399,29.0,11.0,461,3.0,444
611,209,80,39.055963718820855,41.88879818594104,27.0,27.0,178,3.0,129
612,209,60,39.055963718820855,42.00489795918367,27.0,27.0,196,3.0,149
613,209,217,39.055963718820855,41.56371882086168,27.0,31.0,108,3.0,8
614,209,485,39.055963718820855,41.88879818594104,27.0,24.0,302,3.0,276
615,209,474,39.055963718820855,41.98167800453515,27.0,20.0,293,3.0,265
616,209,628,39.055963718820855,40.07764172335601,27.0,6.0,421,1.0,419
617,209,656,39.055963718820855,41.84235827664399,27.0,11.0,463,3.0,447
618,208,80,40.05442176870749,41.88879818594104,24.0,27.0,150,2.0,128
619,208,60,40.05442176870749,42.00489795918367,24.0,27.0,170,2.0,148
620,208,217,40.05442176870749,41.56371882086168,24.0,31.0,66,2.0,9
621,208,228,40.05442176870749,42.120997732426304,24.0,28.0,91,2.0,20
622,208,218,40.05442176870749,42.98013605442178,24.0,10.0,126,3.0,10
623,208,485,40.05442176870749,41.88879818594104,24.0,24.0,288,2.0,277
624,208,474,40.05442176870749,41.98167800453515,24.0,20.0,279,2.0,266
625,208,656,40.05442176870749,41.84235827664399,24.0,11.0,455,2.0,448
626,208,615,40.05442176870749,42.515736961451246,24.0,13.0,421,2.0,407
627,208,656,40.05442176870749,42.98013605442178,24.0,1.0,465,3.0,448
628,217,44,41.56371882086168,43.81605442176871,31.0,23.0,198,2.0,173
629,217,78,41.56371882086168,44.30367346938775,31.0,29.0,182,3.0,139
630,217,218,41.56371882086168,42.98013605442178,31.0,10.0,61,1.0,1
631,217,218,41.56371882086168,44.23401360544218,31.0,25.0,115,3.0,1
632,217,438,41.56371882086168,43.86249433106576,31.0,7.0,242,2.0,221
633,217,466,41.56371882086168,44.23401360544218,31.0,25.0,274,3.0,249
634,217,656,41.56371882086168,42.98013605442178,31.0,1.0,443,1.0,439
635,217,656,41.56371882086168,44.187573696145115,31.0,19.0,453,3.0,439
636,228,44,42.120997732426304,43.81605442176871,28.0,23.0,198,2.0,184
637,228,78,42.120997732426304,44.30367346938775,28.0,29.0,177,2.0,150
638,228,218,42.120997732426304,44.23401360544218,28.0,25.0,92,2.0,10
639,228,233,42.120997732426304,45.046712018140596,28.0,23.0,126,3.0,5
640,228,438,42.120997732426304,43.86249433106576,28.0,7.0,223,2.0,210
641,228,466,42.120997732426304,44.23401360544218,28.0,25.0,255,2.0,238
642,228,656,42.120997732426304,44.187573696145115,28.0,19.0,437,2.0,428
643,218,78,42.98013605442178,44.30367346938775,10.0,29.0,151,1.0,140
644,218,89,42.98013605442178,45.30213151927439,10.0,32.0,163,2.0,129
645,218,233,42.98013605442178,45.046712018140596,10.0,23.0,90,2.0,15
646,218,466,42.98013605442178,44.23401360544218,10.0,25.0,254,1.0,248
647,218,474,42.98013605442178,45.11637188208617,10.0,21.0,272,2.0,256
648,218,656,42.98013605442178,44.187573696145115,10.0,19.0,441,1.0,438
649,218,656,42.98013605442178,45.7665306122449,10.0,19.0,454,3.0,438
650,218,89,44.23401360544218,45.30213151927439,25.0,32.0,137,1.0,129
651,218,55,44.23401360544218,46.60244897959185,25.0,30.0,192,2.0,163
652,218,206,44.23401360544218,46.16126984126985,25.0,10.0,84,2.0,12
653,218,425,44.23401360544218,46.973968253968245,25.0,10.0,238,3.0,207
654,218,656,44.23401360544218,45.7665306122449,25.0,19.0,443,2.0,438
655,218,616,44.23401360544218,46.55600907029479,25.0,3.0,410,2.0,398
656,218,624,44.23401360544218,47.182947845804996,25.0,26.0,425,3.0,406
657,233,55,45.046712018140596,46.60244897959185,23.0,30.0,190,2.0,178
658,233,70,45.046712018140596,47.484807256235825,23.0,32.0,194,2.0,163
659,233,206,45.046712018140596,46.16126984126985,23.0,10.0,55,1.0,27
660,233,227,45.046712018140596,47.76344671201814,23.0,24.0,117,3.0,6
661,233,425,45.046712018140596,46.973968253968245,23.0,10.0,209,2.0,192
662,233,451,45.046712018140596,47.53124716553288,23.0,27.0,243,2.0,218
663,233,616,45.046712018140596,46.55600907029479,23.0,3.0,388,2.0,383
664,233,624,45.046712018140596,47.182947845804996,23.0,26.0,402,2.0,391
665,206,70,46.16126984126985,47.484807256235825,10.0,32.0,147,1.0,136
666,206,46,46.16126984126985,48.320725623582774,10.0,21.0,185,2.0,160
667,206,227,46.16126984126985,47.76344671201814,10.0,24.0,72,2.0,21
668,206,216,46.16126984126985,48.320725623582774,10.0,21.0,94,2.0,10
669,206,451,46.16126984126985,47.53124716553288,10.0,27.0,252,1.0,245
670,206,438,46.16126984126985,48.57614512471656,10.0,17.0,254,2.0,232
671,206,624,46.16126984126985,47.182947845804996,10.0,26.0,420,1.0,418
672,206,643,46.16126984126985,48.90122448979592,10.0,13.0,453,3.0,437
673,227,70,47.76344671201814,49.83002267573696,24.0,28.0,180,2.0,157
674,227,158,47.76344671201814,50.3873015873016,24.0,23.0,132,3.0,69
675,227,223,47.76344671201814,49.922902494331076,24.0,21.0,93,2.0,4
676,227,210,47.76344671201814,50.61950113378685,24.0,26.0,124,3.0,17
677,227,457,47.76344671201814,49.899682539682544,24.0,20.0,248,2.0,230
678,227,422,47.76344671201814,50.3873015873016,24.0,14.0,225,3.0,195
679,227,643,47.76344671201814,48.90122448979592,24.0,13.0,419,1.0,416
680,227,615,47.76344671201814,49.96934240362812,24.0,5.0,399,2.0,388
681,227,618,47.76344671201814,50.48018140589569,24.0,17.0,408,3.0,391
682,216,70,48.320725623582774,49.83002267573696,21.0,28.0,160,2.0,146
683,216,158,48.320725623582774,50.3873015873016,21.0,23.0,106,2.0,58
684,216,223,48.320725623582774,49.922902494331076,21.0,21.0,69,2.0,7
685,216,210,48.320725623582774,50.61950113378685,21.0,26.0,99,2.0,6
686,216,457,48.320725623582774,49.899682539682544,21.0,20.0,250,2.0,241
687,216,422,48.320725623582774,50.3873015873016,21.0,14.0,224,2.0,206
688,216,615,48.320725623582774,49.96934240362812,21.0,5.0,405,2.0,399
689,216,618,48.320725623582774,50.48018140589569,21.0,17.0,413,2.0,402
690,223,56,49.922902494331076,51.919818594104306,21.0,30.0,188,2.0,167
691,223,59,49.922902494331076,52.22167800453515,21.0,31.0,192,2.0,164
692,223,213,49.922902494331076,51.966258503401356,21.0,22.0,89,2.0,10
693,223,216,49.922902494331076,52.546757369614504,21.0,30.0,113,3.0,7
694,223,455,49.922902494331076,51.966258503401356,21.0,19.0,248,2.0,232
695,223,451,49.922902494331076,52.38421768707482,21.0,27.0,251,2.0,228
696,223,643,49.922902494331076,51.61795918367347,21.0,9.0,426,2.0,420
697,223,643,49.922902494331076,52.012698412698406,21.0,18.0,430,2.0,420
698,210,56,50.61950113378685,51.919818594104306,26.0,30.0,164,1.0,154
699,210,59,50.61950113378685,52.22167800453515,26.0,31.0,166,2.0,151
700,210,31,50.61950113378685,53.336235827664396,26.0,30.0,214,3.0,179
701,210,213,50.61950113378685,51.966258503401356,26.0,22.0,58,1.0,3
702,210,216,50.61950113378685,52.546757369614504,26.0,30.0,83,2.0,6
703,210,213,50.61950113378685,53.31301587301587,26.0,22.0,116,3.0,3
704,210,455,50.61950113378685,51.966258503401356,26.0,19.0,252,1.0,245
705,210,451,50.61950113378685,52.38421768707482,26.0,27.0,253,2.0,241
706,210,643,50.61950113378685,52.012698412698406,26.0,18.0,437,1.0,433
707,210,644,50.61950113378685,53.17369614512472,26.0,13.0,448,3.0,434
708,213,31,51.966258503401356,53.336235827664396,22.0,30.0,191,1.0,182
709,213,31,51.966258503401356,54.00961451247166,22.0,28.0,202,2.0,182
710,213,208,51.966258503401356,54.68299319727891,22.0,25.0,117,3.0,5
711,213,459,51.966258503401356,53.63809523809525,22.0,20.0,256,2.0,246
712,213,416,51.966258503401356,54.68299319727891,22.0,14.0,234,3.0,203
713,213,644,51.966258503401356,53.17369614512472,22.0,13.0,434,1.0,431
714,213,644,51.966258503401356,54.00961451247166,22.0,6.0,440,2.0,431
715,216,31,52.546757369614504,54.00961451247166,30.0,28.0,195,1.0,185
716,216,208,52.546757369614504,54.68299319727891,30.0,25.0,92,2.0,8
717,216,270,52.546757369614504,55.147392290249435,30.0,17.0,124,3.0,54
718,216,459,52.546757369614504,53.63809523809525,30.0,20.0,248,1.0,243
719,216,416,52.546757369614504,54.68299319727891,30.0,14.0,220,2.0,200
720,216,613,52.546757369614504,55.147392290249435,30.0,19.0,412,3.0,397
721,216,644,52.546757369614504,54.00961451247166,30.0,6.0,433,1.0,428
722,216,656,52.546757369614504,55.17061224489796,30.0,14.0,454,3.0,440
723,213,55,53.31301587301587,55.96009070294785,22.0,27.0,195,3.0,158
724,213,55,53.31301587301587,55.98331065759637,22.0,28.0,195,3.0,158
725,213,208,53.31301587301587,54.68299319727891,22.0,25.0,59,1.0,5
726,213,270,53.31301587301587,55.147392290249435,22.0,17.0,97,2.0,57
727,213,328,53.31301587301587,55.98331065759637,22.0,13.0,163,3.0,115
728,213,416,53.31301587301587,54.68299319727891,22.0,14.0,211,1.0,203
729,213,613,53.31301587301587,55.147392290249435,22.0,19.0,408,2.0,400
730,213,656,53.31301587301587,55.17061224489796,22.0,14.0,450,2.0,443
731,208,55,54.68299319727891,55.96009070294785,25.0,27.0,163,1.0,153
732,208,55,54.68299319727891,55.98331065759637,25.0,28.0,163,1.0,153
733,208,328,54.68299319727891,55.98331065759637,25.0,13.0,132,1.0,120
734,208,206,54.68299319727891,57.35328798185941,25.0,25.0,115,3.0,2
735,208,614,54.68299319727891,56.749569160997744,25.0,11.0,416,2.0,406
736,208,615,54.68299319727891,56.749569160997744,25.0,5.0,417,2.0,407
737,270,52,55.147392290249435,57.701587301587296,17.0,31.0,244,3.0,218
738,270,68,55.147392290249435,58.11954648526077,17.0,9.0,239,3.0,202
739,270,206,55.147392290249435,57.35328798185941,17.0,25.0,115,2.0,64
740,270,391,55.147392290249435,58.09632653061225,17.0,16.0,175,3.0,121
741,270,614,55.147392290249435,56.749569160997744,17.0,11.0,351,2.0,344
742,270,484,55.147392290249435,57.678367346938785,17.0,26.0,240,3.0,214
743,270,611,55.147392290249435,58.07310657596371,17.0,21.0,364,3.0,341
744,270,615,55.147392290249435,56.749569160997744,17.0,5.0,352,2.0,345
745,270,620,55.147392290249435,57.701587301587296,17.0,16.0,367,3.0,350
746,270,617,55.147392290249435,58.07310657596371,17.0,22.0,369,3.0,347
747,328,52,55.98331065759637,57.701587301587296,13.0,31.0,286,2.0,276
748,328,68,55.98331065759637,58.11954648526077,13.0,9.0,276,2.0,260
749,328,206,55.98331065759637,57.35328798185941,13.0,25.0,136,1.0,122
750,328,391,55.98331065759637,58.09632653061225,13.0,16.0,111,2.0,63
751,328,484,55.98331065759637,57.678367346938785,13.0,26.0,172,2.0,156
752,328,611,55.98331065759637,58.07310657596371,13.0,21.0,297,2.0,283
753,328,620,55.98331065759637,57.701587301587296,13.0,16.0,301,2.0,292
754,328,617,55.98331065759637,58.07310657596371,13.0,22.0,303,2.0,289
755,206,75,57.35328798185941,59.744943310657604,25.0,31.0,167,2.0,131
756,206,470,57.35328798185941,59.72172335600907,25.0,27.0,283,2.0,264
757,206,627,57.35328798185941,59.67528344671203,25.0,16.0,433,2.0,421
758,391,75,58.09632653061225,59.744943310657604,16.0,31.0,324,2.0,316
759,391,206,58.09632653061225,59.76816326530612,16.0,23.0,199,2.0,185
760,391,470,58.09632653061225,59.72172335600907,16.0,27.0,106,2.0,79
761,391,627,58.09632653061225,59.67528344671203,16.0,16.0,246,2.0,236
762,492,41,0.9287981859410432,2.159455782312925,8.0,24.0,454,1.0,451
763,492,55,0.9287981859410432,3.3668934240362813,8.0,24.0,449,2.0,437
764,492,274,0.9287981859410432,2.229115646258504,8.0,17.0,225,1.0,218
765,492,274,0.9287981859410432,3.0418140589569163,8.0,16.0,236,2.0,218
766,492,612,0.9287981859410432,2.9257142857142857,8.0,17.0,148,2.0,120
767,492,613,0.9287981859410432,3.2972335600907035,8.0,20.0,158,2.0,121
768,492,655,0.9287981859410432,2.972154195011338,8.0,22.0,185,2.0,163
769,492,656,0.9287981859410432,3.3436734693877552,8.0,21.0,194,2.0,164
770,613,274,1.7647165532879818,3.0418140589569163,18.0,16.0,343,1.0,339
771,613,612,1.7647165532879818,2.9257142857142857,18.0,17.0,50,1.0,1
772,613,655,1.7647165532879818,2.972154195011338,18.0,22.0,67,1.0,42
773,613,656,1.7647165532879818,3.3436734693877552,18.0,21.0,80,2.0,43
774,612,263,2.9257142857142857,4.85297052154195,17.0,14.0,359,2.0,349
775,612,206,2.9257142857142857,5.27092970521542,17.0,15.0,418,2.0,406
776,612,613,2.9257142857142857,4.85297052154195,17.0,22.0,83,2.0,1
777,612,613,2.9257142857142857,5.27092970521542,17.0,20.0,101,2.0,1
778,612,656,2.9257142857142857,4.899410430839002,17.0,20.0,96,2.0,44
779,612,656,2.9257142857142857,5.317369614512471,17.0,16.0,112,2.0,44
780,613,263,3.2972335600907035,4.85297052154195,20.0,14.0,356,2.0,350
781,613,206,3.2972335600907035,5.27092970521542,20.0,15.0,416,2.0,407
782,613,656,3.2972335600907035,4.899410430839002,20.0,20.0,81,2.0,43
783,613,656,3.2972335600907035,5.317369614512471,20.0,16.0,97,2.0,43
784,613,207,4.85297052154195,6.919546485260772,22.0,22.0,416,2.0,406
785,613,216,4.85297052154195,7.6393650793650805,22.0,28.0,415,3.0,397
786,613,485,4.85297052154195,7.662585034013605,22.0,27.0,176,3.0,128
787,613,656,4.85297052154195,6.431927437641723,22.0,24.0,80,2.0,43
788,613,656,4.85297052154195,7.616145124716552,22.0,27.0,127,3.0,43
789,613,207,5.27092970521542,6.919546485260772,20.0,22.0,412,2.0,406
790,613,216,5.27092970521542,7.6393650793650805,20.0,28.0,410,2.0,397
791,613,236,5.27092970521542,8.057324263038549,20.0,22.0,396,3.0,377
792,613,485,5.27092970521542,7.662585034013605,20.0,27.0,164,2.0,128
793,613,433,5.27092970521542,8.010884353741497,20.0,21.0,215,3.0,180
794,613,656,5.27092970521542,6.431927437641723,20.0,24.0,66,1.0,43
795,613,656,5.27092970521542,7.616145124716552,20.0,27.0,110,2.0,43
796,613,216,6.431927437641723,7.6393650793650805,23.0,28.0,400,1.0,397
797,613,236,6.431927437641723,8.057324263038549,23.0,22.0,383,2.0,377
798,613,485,6.431927437641723,7.662585034013605,23.0,27.0,139,1.0,128
799,613,433,6.431927437641723,8.010884353741497,23.0,21.0,192,2.0,180
800,613,656,6.431927437641723,7.616145124716552,23.0,27.0,67,1.0,43
801,613,656,6.431927437641723,8.40562358276644,23.0,11.0,95,2.0,43
802,485,55,7.662585034013605,9.729160997732428,27.0,24.0,439,2.0,430
803,485,214,7.662585034013605,9.729160997732428,27.0,26.0,285,2.0,271
804,485,439,7.662585034013605,9.845260770975058,27.0,20.0,105,2.0,46
805,485,596,7.662585034013605,10.356099773242633,27.0,19.0,161,3.0,111
806,485,656,7.662585034013605,9.613061224489797,27.0,19.0,191,2.0,171
807,485,618,7.662585034013605,10.402539682539684,27.0,19.0,178,3.0,133
808,433,55,8.010884353741497,9.729160997732428,21.0,24.0,385,2.0,378
809,433,35,8.010884353741497,10.704399092970524,21.0,26.0,415,3.0,398
810,433,214,8.010884353741497,9.729160997732428,21.0,26.0,231,2.0,219
811,433,206,8.010884353741497,10.797278911564627,21.0,21.0,257,3.0,227
812,433,439,8.010884353741497,9.845260770975058,21.0,20.0,79,2.0,6
813,433,596,8.010884353741497,10.356099773242633,21.0,19.0,192,2.0,163
814,433,656,8.010884353741497,9.613061224489797,21.0,19.0,233,2.0,223
815,433,618,8.010884353741497,10.402539682539684,21.0,19.0,212,2.0,185
816,439,41,9.845260770975058,11.58675736961451,20.0,19.0,405,2.0,398
817,439,285,9.845260770975058,11.168798185941043,20.0,13.0,164,1.0,154
818,439,386,9.845260770975058,12.701315192743767,20.0,25.0,134,3.0,53
819,439,515,9.845260770975058,11.192018140589571,20.0,15.0,96,1.0,76
820,439,515,9.845260770975058,12.747755102040815,20.0,24.0,146,3.0,76
821,439,618,9.845260770975058,11.192018140589571,20.0,20.0,188,1.0,179
822,439,618,9.845260770975058,12.770975056689347,20.0,25.0,219,3.0,179
823,439,820,9.845260770975058,12.747755102040815,20.0,3.0,401,3.0,381
824,596,386,10.356099773242633,12.701315192743767,19.0,25.0,233,2.0,210
825,596,515,10.356099773242633,12.747755102040815,19.0,24.0,131,2.0,81
826,596,447,10.356099773242633,13.25859410430839,19.0,24.0,194,3.0,149
827,596,618,10.356099773242633,12.770975056689347,19.0,25.0,106,2.0,22
828,596,820,10.356099773242633,12.747755102040815,19.0,3.0,247,2.0,224
829,515,68,11.192018140589571,12.933514739229025,15.0,26.0,453,2.0,447
830,515,88,11.192018140589571,13.07283446712018,15.0,30.0,435,2.0,427
831,515,386,11.192018140589571,12.701315192743767,15.0,25.0,144,2.0,129
832,515,225,11.192018140589571,13.676553287981859,15.0,27.0,309,2.0,290
833,515,447,11.192018140589571,13.25859410430839,15.0,24.0,112,2.0,68
834,515,618,11.192018140589571,12.770975056689347,15.0,25.0,123,2.0,103
835,515,655,11.192018140589571,13.537233560090703,15.0,15.0,173,2.0,140
836,515,820,11.192018140589571,12.747755102040815,15.0,3.0,312,2.0,305
837,515,41,12.747755102040815,14.721451247165533,24.0,16.0,482,2.0,474
838,515,69,12.747755102040815,15.116190476190473,24.0,18.0,458,2.0,446
839,515,292,12.747755102040815,14.303492063492065,24.0,13.0,233,2.0,223
840,515,613,12.747755102040815,14.303492063492065,24.0,20.0,119,2.0,98
841,515,656,12.747755102040815,14.32671201814059,24.0,17.0,157,2.0,141
842,447,41,13.25859410430839,14.721451247165533,24.0,16.0,411,1.0,406
843,447,69,13.25859410430839,15.116190476190473,24.0,18.0,386,2.0,378
844,447,67,13.25859410430839,16.068208616780044,24.0,34.0,399,3.0,380
845,447,292,13.25859410430839,14.303492063492065,24.0,13.0,161,1.0,155
846,447,227,13.25859410430839,15.882448979591837,24.0,12.0,247,3.0,220
847,447,613,13.25859410430839,14.303492063492065,24.0,20.0,172,1.0,166
848,447,465,13.25859410430839,15.975328798185942,24.0,21.0,118,3.0,18
849,447,656,13.25859410430839,14.32671201814059,24.0,17.0,214,1.0,209
850,447,656,13.25859410430839,15.928888888888887,24.0,16.0,239,3.0,209
851,447,627,13.25859410430839,16.207528344671204,24.0,7.0,220,3.0,180
852,613,197,14.303492063492065,17.04344671201814,20.0,27.0,432,3.0,416
853,613,227,14.303492063492065,15.882448979591837,20.0,12.0,392,2.0,386
854,613,213,14.303492063492065,16.34684807256236,20.0,23.0,410,2.0,400
855,613,465,14.303492063492065,15.975328798185942,20.0,21.0,165,2.0,148
856,613,434,14.303492063492065,16.46294784580499,20.0,23.0,202,2.0,179
857,613,656,14.303492063492065,15.928888888888887,20.0,16.0,82,2.0,43
858,613,627,14.303492063492065,16.207528344671204,20.0,7.0,83,2.0,14
859,613,673,14.303492063492065,17.136326530612244,20.0,20.0,136,3.0,60
860,613,829,14.303492063492065,17.159546485260773,20.0,3.0,249,3.0,216
861,465,197,15.975328798185942,17.04344671201814,21.0,27.0,272,1.0,268
862,465,69,15.975328798185942,18.274104308390022,21.0,22.0,408,2.0,396
863,465,211,15.975328798185942,17.29886621315193,21.0,22.0,260,1.0,254
864,465,366,15.975328798185942,18.250884353741494,21.0,13.0,139,2.0,99
865,465,478,15.975328798185942,17.41496598639456,21.0,22.0,63,1.0,13
866,465,549,15.975328798185942,18.250884353741494,21.0,18.0,129,2.0,84
867,465,673,15.975328798185942,17.136326530612244,21.0,20.0,214,1.0,208
868,465,628,15.975328798185942,18.250884353741494,21.0,10.0,190,2.0,163
869,465,829,15.975328798185942,17.159546485260773,21.0,3.0,368,1.0,364
870,434,69,16.46294784580499,18.274104308390022,23.0,22.0,373,2.0,365
871,434,366,16.46294784580499,18.250884353741494,23.0,13.0,103,2.0,68
872,434,549,16.46294784580499,18.250884353741494,23.0,18.0,138,2.0,115
873,434,628,16.46294784580499,18.250884353741494,23.0,10.0,209,2.0,194
874,434,643,16.46294784580499,19.040362811791386,23.0,21.0,237,3.0,209
875,478,64,17.41496598639456,19.62086167800453,22.0,38.0,425,2.0,414
876,478,67,17.41496598639456,20.24780045351474,22.0,28.0,429,3.0,411
877,478,211,17.41496598639456,19.783401360544214,22.0,29.0,286,2.0,267
878,478,434,17.41496598639456,19.806621315192746,22.0,20.0,112,2.0,44
879,478,643,17.41496598639456,19.040362811791386,22.0,21.0,179,2.0,165
880,478,617,17.41496598639456,20.038820861678005,22.0,16.0,179,3.0,139
881,549,64,18.250884353741494,19.62086167800453,18.0,38.0,489,1.0,485
882,549,67,18.250884353741494,20.24780045351474,18.0,28.0,490,2.0,482
883,549,211,18.250884353741494,19.783401360544214,18.0,29.0,344,2.0,338
884,549,227,18.250884353741494,20.433560090702947,18.0,27.0,335,2.0,322
885,549,434,18.250884353741494,19.806621315192746,18.0,20.0,133,2.0,115
886,549,474,18.250884353741494,20.642539682539685,18.0,25.0,127,2.0,75
887,549,617,18.250884353741494,20.038820861678005,18.0,16.0,103,2.0,68
888,434,63,19.806621315192746,21.966077097505668,20.0,33.0,382,2.0,371
889,434,66,19.806621315192746,22.01251700680272,20.0,32.0,380,2.0,368
890,434,218,19.806621315192746,21.40879818594105,20.0,18.0,227,2.0,216
891,434,230,19.806621315192746,22.50013605442177,20.0,29.0,235,3.0,204
892,434,510,19.806621315192746,21.40879818594105,20.0,15.0,103,2.0,76
893,434,510,19.806621315192746,22.29115646258504,20.0,22.0,131,2.0,76
894,434,675,19.806621315192746,21.362358276643988,20.0,2.0,250,2.0,241
895,434,617,19.806621315192746,22.29115646258504,20.0,25.0,212,2.0,183
896,434,829,19.806621315192746,22.337596371882086,20.0,5.0,410,3.0,395
897,474,63,20.642539682539685,21.966077097505668,25.0,33.0,415,1.0,411
898,474,66,20.642539682539685,22.01251700680272,25.0,32.0,412,1.0,408
899,474,36,20.642539682539685,23.080634920634925,25.0,29.0,450,2.0,438
900,474,230,20.642539682539685,22.50013605442177,25.0,29.0,257,2.0,244
901,474,214,20.642539682539685,23.080634920634925,25.0,31.0,280,2.0,260
902,474,510,20.642539682539685,22.29115646258504,25.0,22.0,80,2.0,36
903,474,463,20.642539682539685,23.080634920634925,25.0,22.0,106,2.0,11
904,474,617,20.642539682539685,22.29115646258504,25.0,25.0,160,2.0,143
905,474,675,20.642539682539685,23.19673469387755,25.0,13.0,229,3.0,201
906,474,829,20.642539682539685,22.337596371882086,25.0,5.0,362,2.0,355
907,510,36,21.40879818594105,23.080634920634925,15.0,29.0,479,2.0,474
908,510,230,21.40879818594105,22.50013605442177,15.0,29.0,284,1.0,280
909,510,214,21.40879818594105,23.080634920634925,15.0,31.0,305,2.0,296
910,510,463,21.40879818594105,23.080634920634925,15.0,22.0,86,2.0,47
911,510,675,21.40879818594105,23.19673469387755,15.0,13.0,182,2.0,165
912,510,67,22.29115646258504,24.91501133786848,22.0,34.0,457,3.0,443
913,510,213,22.29115646258504,24.891791383219964,22.0,15.0,317,3.0,297
914,510,418,22.29115646258504,24.86857142857143,22.0,15.0,144,3.0,92
915,510,582,22.29115646258504,25.147210884353747,22.0,25.0,143,3.0,72
916,510,655,22.29115646258504,24.938231292517013,22.0,0.0,184,3.0,145
917,510,641,22.29115646258504,25.17043083900227,22.0,26.0,180,3.0,131
918,510,830,22.29115646258504,25.123990929705208,22.0,7.0,342,3.0,320
919,463,67,23.080634920634925,24.91501133786848,22.0,34.0,404,2.0,396
920,463,181,23.080634920634925,25.518730158730158,22.0,28.0,301,2.0,282
921,463,213,23.080634920634925,24.891791383219964,22.0,15.0,262,2.0,250
922,463,231,23.080634920634925,25.472290249433108,22.0,31.0,254,2.0,232
923,463,418,23.080634920634925,24.86857142857143,22.0,15.0,89,2.0,45
924,463,582,23.080634920634925,25.147210884353747,22.0,25.0,149,2.0,119
925,463,655,23.080634920634925,24.938231292517013,22.0,0.0,208,2.0,192
926,463,641,23.080634920634925,25.17043083900227,22.0,26.0,199,2.0,178
927,463,830,23.080634920634925,25.123990929705208,22.0,7.0,377,2.0,367
928,418,35,24.86857142857143,26.493968253968248,15.0,22.0,389,2.0,383
929,418,73,24.86857142857143,27.771065759637192,15.0,22.0,367,3.0,345
930,418,223,24.86857142857143,26.354648526077103,15.0,23.0,205,1.0,195
931,418,392,24.86857142857143,26.981587301587304,15.0,9.0,95,2.0,26
932,418,590,24.86857142857143,26.79582766439909,15.0,17.0,191,2.0,172
933,418,467,24.86857142857143,26.981587301587304,15.0,6.0,103,2.0,49
934,418,618,24.86857142857143,26.865487528344673,15.0,21.0,218,2.0,200
935,418,618,24.86857142857143,27.28344671201814,15.0,7.0,225,2.0,200
936,582,223,25.147210884353747,26.354648526077103,25.0,23.0,363,1.0,359
937,582,392,25.147210884353747,26.981587301587304,25.0,9.0,206,2.0,190
938,582,590,25.147210884353747,26.79582766439909,25.0,17.0,71,2.0,8
939,582,467,25.147210884353747,26.981587301587304,25.0,6.0,140,2.0,115
940,582,618,25.147210884353747,26.865487528344673,25.0,21.0,82,2.0,36
941,582,618,25.147210884353747,27.28344671201814,25.0,7.0,99,2.0,36
942,590,217,26.79582766439909,28.955283446712023,17.0,23.0,384,2.0,373
943,590,209,26.79582766439909,29.442902494331065,17.0,22.0,398,3.0,381
944,590,595,26.79582766439909,28.699863945578237,17.0,26.0,82,2.0,5
945,590,596,26.79582766439909,29.23392290249433,17.0,30.0,105,2.0,6
946,590,617,26.79582766439909,28.72308390022676,17.0,20.0,87,2.0,27
947,590,626,26.79582766439909,29.23392290249433,17.0,26.0,111,2.0,36
948,590,833,26.79582766439909,28.699863945578237,17.0,4.0,256,2.0,243
949,590,870,26.79582766439909,29.257142857142853,17.0,9.0,299,2.0,280
950,467,60,26.981587301587304,28.932063492063488,6.0,24.0,416,2.0,407
951,467,36,26.981587301587304,29.53578231292517,6.0,28.0,445,3.0,431
952,467,217,26.981587301587304,28.955283446712023,6.0,23.0,264,2.0,250
953,467,209,26.981587301587304,29.442902494331065,6.0,22.0,279,2.0,258
954,467,595,26.981587301587304,28.699863945578237,6.0,26.0,148,2.0,128
955,467,596,26.981587301587304,29.23392290249433,6.0,30.0,161,2.0,129
956,467,617,26.981587301587304,28.72308390022676,6.0,20.0,168,2.0,150
957,467,626,26.981587301587304,29.23392290249433,6.0,26.0,186,2.0,159
958,467,833,26.981587301587304,28.699863945578237,6.0,4.0,373,2.0,366
959,467,870,26.981587301587304,29.257142857142853,6.0,9.0,415,2.0,403
960,595,232,28.699863945578237,30.00018140589569,26.0,17.0,367,1.0,363
961,595,614,28.699863945578237,30.78965986394558,26.0,20.0,92,2.0,19
962,595,613,28.699863945578237,31.579138321995462,26.0,23.0,125,3.0,18
963,595,656,28.699863945578237,30.81287981859411,26.0,18.0,110,2.0,61
964,595,656,28.699863945578237,31.579138321995462,26.0,20.0,138,3.0,61
965,596,217,29.23392290249433,31.97387755102041,30.0,23.0,397,3.0,379
966,596,212,29.23392290249433,32.13641723356009,30.0,29.0,404,3.0,384
967,596,614,29.23392290249433,30.78965986394558,30.0,20.0,69,2.0,18
968,596,613,29.23392290249433,31.579138321995462,30.0,23.0,102,2.0,17
969,596,477,29.23392290249433,32.13641723356009,30.0,27.0,173,3.0,119
970,596,656,29.23392290249433,30.81287981859411,30.0,18.0,91,2.0,60
971,596,656,29.23392290249433,31.579138321995462,30.0,20.0,117,2.0,60
972,614,217,30.78965986394558,31.97387755102041,20.0,23.0,400,1.0,397
973,614,212,30.78965986394558,32.13641723356009,20.0,29.0,406,1.0,402
974,614,209,30.78965986394558,33.01877551020408,20.0,19.0,416,2.0,405
975,614,477,30.78965986394558,32.13641723356009,20.0,27.0,149,1.0,137
976,614,494,30.78965986394558,33.18131519274377,20.0,15.0,158,2.0,120
977,614,615,30.78965986394558,32.554376417233556,20.0,9.0,76,2.0,1
978,614,656,30.78965986394558,33.18131519274377,20.0,17.0,111,2.0,42
979,613,209,31.579138321995462,33.01877551020408,23.0,19.0,409,1.0,404
980,613,494,31.579138321995462,33.18131519274377,23.0,15.0,138,2.0,119
981,613,656,31.579138321995462,33.18131519274377,23.0,17.0,81,2.0,43
982,613,619,31.579138321995462,34.365532879818595,23.0,15.0,120,3.0,6
983,477,55,32.13641723356009,33.715374149659866,27.0,22.0,427,2.0,422
984,477,67,32.13641723356009,34.644172335600906,27.0,31.0,424,3.0,410
985,477,236,32.13641723356009,34.89959183673469,27.0,22.0,269,3.0,241
986,477,494,32.13641723356009,33.18131519274377,27.0,15.0,48,1.0,17
987,477,483,32.13641723356009,34.82993197278912,27.0,29.0,116,3.0,6
988,477,656,32.13641723356009,33.18131519274377,27.0,17.0,185,1.0,179
989,477,619,32.13641723356009,34.365532879818595,27.0,15.0,171,2.0,142
990,477,880,32.13641723356009,34.876371882086175,27.0,-0.0,420,3.0,403
991,494,67,33.18131519274377,34.644172335600906,15.0,31.0,432,1.0,427
992,494,80,33.18131519274377,35.851609977324266,15.0,30.0,430,3.0,414
993,494,82,33.18131519274377,36.037369614512464,15.0,25.0,430,3.0,412
994,494,236,33.18131519274377,34.89959183673469,15.0,22.0,268,2.0,258
995,494,234,33.18131519274377,35.340770975056685,15.0,24.0,276,2.0,260
996,494,236,33.18131519274377,36.083809523809535,15.0,18.0,287,3.0,258
997,494,483,33.18131519274377,34.82993197278912,15.0,29.0,72,2.0,11
998,494,459,33.18131519274377,35.94448979591837,15.0,23.0,124,3.0,35
999,494,468,33.18131519274377,36.014149659863946,15.0,16.0,125,3.0,26
1000,494,619,33.18131519274377,34.365532879818595,15.0,15.0,135,1.0,125
1001,494,622,33.18131519274377,35.5265306122449,15.0,17.0,163,2.0,128
1002,494,880,33.18131519274377,34.876371882086175,15.0,-0.0,393,2.0,386
1003,494,831,33.18131519274377,35.503310657596366,15.0,2.0,352,2.0,337
1004,483,80,34.82993197278912,35.851609977324266,29.0,30.0,405,1.0,403
1005,483,82,34.82993197278912,36.037369614512464,29.0,25.0,404,1.0,401
1006,483,236,34.82993197278912,36.083809523809535,29.0,18.0,253,1.0,247
1007,483,459,34.82993197278912,35.94448979591837,29.0,23.0,54,1.0,24
1008,483,468,34.82993197278912,36.014149659863946,29.0,16.0,53,1.0,15
1009,483,656,34.82993197278912,36.75718820861678,29.0,11.0,192,2.0,173
1010,459,74,35.94448979591837,37.94140589569161,23.0,29.0,394,2.0,385
1011,459,79,35.94448979591837,38.35936507936508,23.0,26.0,394,2.0,380
1012,459,295,35.94448979591837,37.94140589569161,23.0,26.0,185,2.0,164
1013,459,461,35.94448979591837,37.9181859410431,23.0,27.0,85,2.0,2
1014,459,474,35.94448979591837,38.38258503401361,23.0,27.0,106,2.0,15
1015,459,617,35.94448979591837,37.8485260770975,23.0,14.0,178,2.0,158
1016,459,624,35.94448979591837,38.150385487528354,23.0,19.0,190,2.0,165
1017,459,833,35.94448979591837,38.173605442176864,23.0,-0.0,386,2.0,374
1018,468,74,36.014149659863946,37.94140589569161,16.0,29.0,403,2.0,394
1019,468,79,36.014149659863946,38.35936507936508,16.0,26.0,402,2.0,389
1020,468,295,36.014149659863946,37.94140589569161,16.0,26.0,192,2.0,173
1021,468,212,36.014149659863946,38.963083900226756,16.0,29.0,286,3.0,256
1022,468,461,36.014149659863946,37.9181859410431,16.0,27.0,82,2.0,7
1023,468,474,36.014149659863946,38.38258503401361,16.0,27.0,102,2.0,6
1024,468,617,36.014149659863946,37.8485260770975,16.0,14.0,169,2.0,149
1025,468,624,36.014149659863946,38.150385487528354,16.0,19.0,181,2.0,156
1026,468,833,36.014149659863946,38.173605442176864,16.0,-0.0,377,2.0,365
1027,461,55,37.9181859410431,39.2649433106576,27.0,21.0,410,1.0,406
1028,461,63,37.9181859410431,39.984761904761896,27.0,24.0,408,2.0,398
1029,461,212,37.9181859410431,38.963083900226756,27.0,29.0,253,1.0,249
1030,461,209,37.9181859410431,39.055963718820855,27.0,27.0,257,1.0,252
1031,461,208,37.9181859410431,40.05442176870749,27.0,24.0,269,2.0,253
1032,461,432,37.9181859410431,39.00952380952381,27.0,21.0,55,1.0,29
1033,461,480,37.9181859410431,40.00798185941043,27.0,20.0,92,2.0,19
1034,461,653,37.9181859410431,39.28816326530613,27.0,14.0,201,1.0,192
1035,461,628,37.9181859410431,40.07764172335601,27.0,6.0,191,2.0,167
1036,474,63,38.38258503401361,39.984761904761896,27.0,24.0,417,2.0,411
1037,474,208,38.38258503401361,40.05442176870749,27.0,24.0,276,2.0,266
1038,474,480,38.38258503401361,40.00798185941043,27.0,20.0,70,2.0,6
1039,474,628,38.38258503401361,40.07764172335601,27.0,6.0,170,2.0,154
1040,432,80,39.00952380952381,41.88879818594104,21.0,27.0,373,3.0,352
1041,432,208,39.00952380952381,40.05442176870749,21.0,24.0,228,1.0,224
1042,432,217,39.00952380952381,41.56371882086168,21.0,31.0,242,3.0,215
1043,432,485,39.00952380952381,41.88879818594104,21.0,24.0,135,3.0,53
1044,432,474,39.00952380952381,41.98167800453515,21.0,20.0,135,3.0,42
1045,432,628,39.00952380952381,40.07764172335601,21.0,6.0,201,1.0,196
1046,432,656,39.00952380952381,41.84235827664399,21.0,11.0,255,3.0,224
1047,480,80,40.00798185941043,41.88879818594104,20.0,27.0,408,2.0,400
1048,480,60,40.00798185941043,42.00489795918367,20.0,27.0,429,2.0,420
1049,480,217,40.00798185941043,41.56371882086168,20.0,31.0,271,2.0,263
1050,480,228,40.00798185941043,42.120997732426304,20.0,28.0,268,2.0,252
1051,480,218,40.00798185941043,42.98013605442178,20.0,10.0,292,3.0,262
1052,480,485,40.00798185941043,41.88879818594104,20.0,24.0,81,2.0,5
1053,480,474,40.00798185941043,41.98167800453515,20.0,20.0,85,2.0,6
1054,480,656,40.00798185941043,41.84235827664399,20.0,11.0,193,2.0,176
1055,480,615,40.00798185941043,42.515736961451246,20.0,13.0,173,3.0,135
1056,480,656,40.00798185941043,42.98013605442178,20.0,1.0,218,3.0,176
1057,485,44,41.88879818594104,43.81605442176871,24.0,23.0,449,2.0,441
1058,485,78,41.88879818594104,44.30367346938775,24.0,29.0,420,2.0,407
1059,485,218,41.88879818594104,42.98013605442178,24.0,10.0,271,1.0,267
1060,485,218,41.88879818594104,44.23401360544218,24.0,25.0,285,2.0,267
1061,485,438,41.88879818594104,43.86249433106576,24.0,7.0,97,2.0,47
1062,485,466,41.88879818594104,44.23401360544218,24.0,25.0,103,2.0,19
1063,485,656,41.88879818594104,42.98013605442178,24.0,1.0,177,1.0,171
1064,485,656,41.88879818594104,44.187573696145115,24.0,19.0,198,2.0,171
1065,474,44,41.98167800453515,43.81605442176871,20.0,23.0,437,2.0,430
1066,474,78,41.98167800453515,44.30367346938775,20.0,29.0,408,2.0,396
1067,474,218,41.98167800453515,44.23401360544218,20.0,25.0,274,2.0,256
1068,474,438,41.98167800453515,43.86249433106576,20.0,7.0,89,2.0,36
1069,474,466,41.98167800453515,44.23401360544218,20.0,25.0,97,2.0,8
1070,474,656,41.98167800453515,44.187573696145115,20.0,19.0,205,2.0,182
1071,438,89,43.86249433106576,45.30213151927439,7.0,32.0,354,1.0,349
1072,438,55,43.86249433106576,46.60244897959185,7.0,30.0,401,3.0,383
1073,438,233,43.86249433106576,45.046712018140596,7.0,23.0,211,1.0,205
1074,438,206,43.86249433106576,46.16126984126985,7.0,10.0,252,2.0,232
1075,438,474,43.86249433106576,45.11637188208617,7.0,21.0,65,1.0,36
1076,438,656,43.86249433106576,45.7665306122449,7.0,19.0,233,2.0,218
1077,438,616,43.86249433106576,46.55600907029479,7.0,3.0,212,3.0,178
1078,466,89,44.23401360544218,45.30213151927439,25.0,32.0,380,1.0,377
1079,466,55,44.23401360544218,46.60244897959185,25.0,30.0,423,2.0,411
1080,466,206,44.23401360544218,46.16126984126985,25.0,10.0,273,2.0,260
1081,466,425,44.23401360544218,46.973968253968245,25.0,10.0,125,3.0,41
1082,466,656,44.23401360544218,45.7665306122449,25.0,19.0,201,2.0,190
1083,466,616,44.23401360544218,46.55600907029479,25.0,3.0,180,2.0,150
1084,466,624,44.23401360544218,47.182947845804996,25.0,26.0,203,3.0,158
1085,466,851,44.23401360544218,47.20616780045352,25.0,4.0,406,3.0,385
1086,474,55,45.11637188208617,46.60244897959185,21.0,30.0,424,1.0,419
1087,474,70,45.11637188208617,47.484807256235825,21.0,32.0,417,2.0,404
1088,474,206,45.11637188208617,46.16126984126985,21.0,10.0,272,1.0,268
1089,474,227,45.11637188208617,47.76344671201814,21.0,24.0,272,3.0,247
1090,474,425,45.11637188208617,46.973968253968245,21.0,10.0,94,2.0,49
1091,474,451,45.11637188208617,47.53124716553288,21.0,27.0,107,2.0,23
1092,474,616,45.11637188208617,46.55600907029479,21.0,3.0,155,1.0,142
1093,474,624,45.11637188208617,47.182947845804996,21.0,26.0,174,2.0,150
1094,474,851,45.11637188208617,47.20616780045352,21.0,4.0,388,2.0,377
1095,425,46,46.973968253968245,48.320725623582774,10.0,21.0,383,1.0,379
1096,425,70,46.973968253968245,49.83002267573696,10.0,28.0,376,3.0,355
1097,425,216,46.973968253968245,48.320725623582774,10.0,21.0,217,1.0,209
1098,425,223,46.973968253968245,49.922902494331076,10.0,21.0,239,3.0,202
1099,425,438,46.973968253968245,48.57614512471656,10.0,17.0,70,2.0,13
1100,425,457,46.973968253968245,49.899682539682544,10.0,20.0,130,3.0,32
1101,425,643,46.973968253968245,48.90122448979592,10.0,13.0,233,2.0,218
1102,451,70,47.53124716553288,49.83002267573696,27.0,28.0,394,2.0,381
1103,451,158,47.53124716553288,50.3873015873016,27.0,23.0,318,3.0,293
1104,451,223,47.53124716553288,49.922902494331076,27.0,21.0,250,2.0,228
1105,451,438,47.53124716553288,48.57614512471656,27.0,17.0,47,1.0,13
1106,451,457,47.53124716553288,49.899682539682544,27.0,20.0,102,2.0,6
1107,451,422,47.53124716553288,50.3873015873016,27.0,14.0,126,3.0,29
1108,451,643,47.53124716553288,48.90122448979592,27.0,13.0,201,1.0,192
1109,451,615,47.53124716553288,49.96934240362812,27.0,5.0,195,2.0,164
1110,451,618,47.53124716553288,50.48018140589569,27.0,17.0,210,3.0,167
1111,438,70,48.57614512471656,49.83002267573696,17.0,28.0,372,1.0,368
1112,438,158,48.57614512471656,50.3873015873016,17.0,23.0,291,2.0,280
1113,438,223,48.57614512471656,49.922902494331076,17.0,21.0,223,1.0,215
1114,438,210,48.57614512471656,50.61950113378685,17.0,26.0,244,2.0,228
1115,438,457,48.57614512471656,49.899682539682544,17.0,20.0,60,1.0,19
1116,438,422,48.57614512471656,50.3873015873016,17.0,14.0,80,2.0,16
1117,438,615,48.57614512471656,49.96934240362812,17.0,5.0,187,1.0,177
1118,438,618,48.57614512471656,50.48018140589569,17.0,17.0,198,2.0,180
1119,457,56,49.899682539682544,51.919818594104306,20.0,30.0,410,2.0,401
1120,457,59,49.899682539682544,52.22167800453515,20.0,31.0,410,2.0,398
1121,457,213,49.899682539682544,51.966258503401356,20.0,22.0,260,2.0,244
1122,457,216,49.899682539682544,52.546757369614504,20.0,30.0,267,3.0,241
1123,457,455,49.899682539682544,51.966258503401356,20.0,19.0,89,2.0,2
1124,457,451,49.899682539682544,52.38421768707482,20.0,27.0,107,2.0,6
1125,457,643,49.899682539682544,51.61795918367347,20.0,9.0,200,2.0,186
1126,457,643,49.899682539682544,52.012698412698406,20.0,18.0,207,2.0,186
1127,422,56,50.3873015873016,51.919818594104306,14.0,30.0,372,2.0,366
1128,422,59,50.3873015873016,52.22167800453515,14.0,31.0,371,2.0,363
1129,422,31,50.3873015873016,53.336235827664396,14.0,30.0,411,3.0,391
1130,422,213,50.3873015873016,51.966258503401356,14.0,22.0,220,2.0,209
1131,422,216,50.3873015873016,52.546757369614504,14.0,30.0,226,2.0,206
1132,422,213,50.3873015873016,53.31301587301587,14.0,22.0,244,3.0,209
1133,422,455,50.3873015873016,51.966258503401356,14.0,19.0,76,2.0,33
1134,422,451,50.3873015873016,52.38421768707482,14.0,27.0,91,2.0,29
1135,422,643,50.3873015873016,51.61795918367347,14.0,9.0,227,1.0,221
1136,422,643,50.3873015873016,52.012698412698406,14.0,18.0,232,2.0,221
1137,422,644,50.3873015873016,53.17369614512472,14.0,13.0,252,3.0,222
1138,455,31,51.966258503401356,53.336235827664396,19.0,30.0,428,1.0,424
1139,455,31,51.966258503401356,54.00961451247166,19.0,28.0,433,2.0,424
1140,455,213,51.966258503401356,53.31301587301587,19.0,22.0,249,1.0,242
1141,455,208,51.966258503401356,54.68299319727891,19.0,25.0,273,3.0,247
1142,455,459,51.966258503401356,53.63809523809525,19.0,20.0,72,2.0,4
1143,455,416,51.966258503401356,54.68299319727891,19.0,14.0,123,3.0,39
1144,455,644,51.966258503401356,53.17369614512472,19.0,13.0,196,1.0,189
1145,455,644,51.966258503401356,54.00961451247166,19.0,6.0,208,2.0,189
1146,451,31,52.38421768707482,54.00961451247166,27.0,28.0,426,2.0,420
1147,451,208,52.38421768707482,54.68299319727891,27.0,25.0,262,2.0,243
1148,451,270,52.38421768707482,55.147392290249435,27.0,17.0,217,3.0,181
1149,451,459,52.38421768707482,53.63809523809525,27.0,20.0,55,1.0,8
1150,451,416,52.38421768707482,54.68299319727891,27.0,14.0,105,2.0,35
1151,451,613,52.38421768707482,55.147392290249435,27.0,19.0,201,3.0,162
1152,451,644,52.38421768707482,54.00961451247166,27.0,6.0,205,2.0,193
1153,451,656,52.38421768707482,55.17061224489796,27.0,14.0,238,3.0,205
1154,459,55,53.63809523809525,55.96009070294785,20.0,27.0,416,2.0,404
1155,459,55,53.63809523809525,55.98331065759637,20.0,28.0,416,2.0,404
1156,459,208,53.63809523809525,54.68299319727891,20.0,25.0,255,1.0,251
1157,459,270,53.63809523809525,55.147392290249435,20.0,17.0,200,2.0,189
1158,459,328,53.63809523809525,55.98331065759637,20.0,13.0,165,2.0,131
1159,459,416,53.63809523809525,54.68299319727891,20.0,14.0,62,1.0,43
1160,459,613,53.63809523809525,55.147392290249435,20.0,19.0,167,2.0,154
1161,459,656,53.63809523809525,55.17061224489796,20.0,14.0,208,2.0,197
1162,416,55,54.68299319727891,55.96009070294785,14.0,27.0,365,1.0,361
1163,416,55,54.68299319727891,55.98331065759637,14.0,28.0,365,1.0,361
1164,416,328,54.68299319727891,55.98331065759637,14.0,13.0,104,1.0,88
1165,416,206,54.68299319727891,57.35328798185941,14.0,25.0,239,3.0,210
1166,416,614,54.68299319727891,56.749569160997744,14.0,11.0,217,2.0,198
1167,416,615,54.68299319727891,56.749569160997744,14.0,5.0,218,2.0,199
1168,613,206,55.147392290249435,57.35328798185941,19.0,25.0,418,2.0,407
1169,613,391,55.147392290249435,58.09632653061225,19.0,16.0,256,3.0,222
1170,613,614,55.147392290249435,56.749569160997744,19.0,11.0,69,2.0,1
1171,613,484,55.147392290249435,57.678367346938785,19.0,26.0,169,3.0,129
1172,613,611,55.147392290249435,58.07310657596371,19.0,21.0,126,3.0,2
1173,613,615,55.147392290249435,56.749569160997744,19.0,5.0,69,2.0,2
1174,613,620,55.147392290249435,57.701587301587296,19.0,16.0,110,3.0,7
1175,613,617,55.147392290249435,58.07310657596371,19.0,22.0,126,3.0,4
1176,613,843,55.147392290249435,57.701587301587296,19.0,0.0,255,3.0,230
1177,614,391,56.749569160997744,58.09632653061225,11.0,16.0,230,1.0,223
1178,614,611,56.749569160997744,58.07310657596371,11.0,21.0,57,1.0,3
1179,614,470,56.749569160997744,59.72172335600907,11.0,27.0,193,3.0,144
1180,614,617,56.749569160997744,58.07310657596371,11.0,22.0,57,1.0,3
1181,614,627,56.749569160997744,59.67528344671203,11.0,16.0,127,3.0,13
1182,484,75,57.678367346938785,59.744943310657604,26.0,31.0,419,2.0,409
1183,484,206,57.678367346938785,59.76816326530612,26.0,23.0,292,2.0,278
1184,484,470,57.678367346938785,59.72172335600907,26.0,27.0,89,2.0,14
1185,484,627,57.678367346938785,59.67528344671203,26.0,16.0,167,2.0,143
1186,611,206,58.07310657596371,59.76816326530612,21.0,23.0,412,2.0,405
1187,611,470,58.07310657596371,59.72172335600907,21.0,27.0,158,2.0,141
1188,611,627,58.07310657596371,59.67528344671203,21.0,16.0,71,2.0,16
1189,656,274,0.9520181405895692,2.229115646258504,8.0,17.0,386,1.0,382
1190,656,274,0.9520181405895692,3.0418140589569163,8.0,16.0,392,2.0,382
1191,656,612,0.9520181405895692,2.9257142857142857,8.0,17.0,96,2.0,44
1192,656,613,0.9520181405895692,3.2972335600907035,8.0,20.0,110,2.0,43
1193,656,655,0.9520181405895692,2.972154195011338,8.0,22.0,87,2.0,1
1194,656,274,1.7414965986394555,3.0418140589569163,21.0,16.0,386,1.0,382
1195,656,612,1.7414965986394555,2.9257142857142857,21.0,17.0,67,1.0,44
1196,656,613,1.7414965986394555,3.2972335600907035,21.0,20.0,80,2.0,43
1197,656,655,1.7414965986394555,2.972154195011338,21.0,22.0,53,1.0,1
1198,655,263,2.972154195011338,4.85297052154195,22.0,14.0,400,2.0,392
1199,655,206,2.972154195011338,5.27092970521542,22.0,15.0,460,2.0,449
1200,655,613,2.972154195011338,4.85297052154195,22.0,22.0,91,2.0,42
1201,655,613,2.972154195011338,5.27092970521542,22.0,20.0,108,2.0,42
1202,655,656,2.972154195011338,4.899410430839002,22.0,20.0,83,2.0,1
1203,655,656,2.972154195011338,5.317369614512471,22.0,16.0,101,2.0,1
1204,656,263,3.3436734693877552,4.85297052154195,21.0,14.0,398,2.0,393
1205,656,206,3.3436734693877552,5.27092970521542,21.0,15.0,458,2.0,450
1206,656,613,3.3436734693877552,4.85297052154195,21.0,22.0,78,2.0,43
1207,656,613,3.3436734693877552,5.27092970521542,21.0,20.0,93,2.0,43
1208,656,207,4.899410430839002,6.919546485260772,20.0,22.0,457,2.0,449
1209,656,216,4.899410430839002,7.6393650793650805,20.0,28.0,456,3.0,440
1210,656,613,4.899410430839002,6.431927437641723,20.0,23.0,79,2.0,43
1211,656,485,4.899410430839002,7.662585034013605,20.0,27.0,208,3.0,171
1212,656,207,5.317369614512471,6.919546485260772,16.0,22.0,454,2.0,449
1213,656,216,5.317369614512471,7.6393650793650805,16.0,28.0,451,2.0,440
1214,656,236,5.317369614512471,8.057324263038549,16.0,22.0,436,3.0,420
1215,656,613,5.317369614512471,6.431927437641723,16.0,23.0,64,1.0,43
1216,656,485,5.317369614512471,7.662585034013605,16.0,27.0,199,2.0,171
1217,656,433,5.317369614512471,8.010884353741497,16.0,21.0,251,3.0,223
1218,656,216,6.431927437641723,7.6393650793650805,24.0,28.0,443,1.0,440
1219,656,236,6.431927437641723,8.057324263038549,24.0,22.0,426,2.0,420
1220,656,485,6.431927437641723,7.662585034013605,24.0,27.0,179,1.0,171
1221,656,433,6.431927437641723,8.010884353741497,24.0,21.0,233,2.0,223
1222,656,214,7.616145124716552,9.729160997732428,27.0,26.0,451,2.0,442
1223,656,439,7.616145124716552,9.845260770975058,27.0,20.0,237,2.0,217
1224,656,596,7.616145124716552,10.356099773242633,27.0,19.0,132,3.0,60
1225,656,618,7.616145124716552,10.402539682539684,27.0,19.0,126,3.0,38
1226,656,214,8.40562358276644,9.729160997732428,11.0,26.0,446,1.0,442
1227,656,206,8.40562358276644,10.797278911564627,11.0,21.0,462,2.0,450
1228,656,285,8.40562358276644,11.168798185941043,11.0,13.0,390,3.0,371
1229,656,439,8.40562358276644,9.845260770975058,11.0,20.0,226,1.0,217
1230,656,596,8.40562358276644,10.356099773242633,11.0,19.0,103,2.0,60
1231,656,515,8.40562358276644,11.192018140589571,11.0,15.0,185,3.0,141
1232,656,618,8.40562358276644,10.402539682539684,11.0,19.0,94,2.0,38
1233,656,618,8.40562358276644,11.192018140589571,11.0,20.0,126,3.0,38
1234,656,206,9.613061224489797,10.797278911564627,19.0,21.0,453,1.0,450
1235,656,285,9.613061224489797,11.168798185941043,19.0,13.0,377,2.0,371
1236,656,515,9.613061224489797,11.192018140589571,19.0,15.0,157,2.0,141
1237,656,618,9.613061224489797,11.192018140589571,19.0,20.0,78,2.0,38
1238,618,386,10.402539682539684,12.701315192743767,19.0,25.0,252,2.0,232
1239,618,515,10.402539682539684,12.747755102040815,19.0,24.0,144,2.0,103
1240,618,447,10.402539682539684,13.25859410430839,19.0,24.0,211,3.0,171
1241,618,820,10.402539682539684,12.747755102040815,19.0,3.0,226,2.0,202
1242,618,386,11.192018140589571,12.701315192743767,20.0,25.0,241,2.0,232
1243,618,225,11.192018140589571,13.676553287981859,20.0,27.0,407,2.0,393
1244,618,515,11.192018140589571,12.747755102040815,20.0,24.0,123,2.0,103
1245,618,447,11.192018140589571,13.25859410430839,20.0,24.0,193,2.0,171
1246,618,655,11.192018140589571,13.537233560090703,20.0,15.0,108,2.0,37
1247,618,820,11.192018140589571,12.747755102040815,20.0,3.0,213,2.0,202
1248,618,292,12.770975056689347,14.303492063492065,25.0,13.0,333,2.0,326
1249,618,613,12.770975056689347,14.303492063492065,25.0,20.0,66,2.0,5
1250,618,656,12.770975056689347,14.32671201814059,25.0,17.0,77,2.0,38
1251,655,227,13.537233560090703,15.882448979591837,15.0,12.0,440,2.0,428
1252,655,213,13.537233560090703,16.34684807256236,15.0,23.0,458,3.0,442
1253,655,465,13.537233560090703,15.975328798185942,15.0,21.0,217,2.0,190
1254,655,434,13.537233560090703,16.46294784580499,15.0,23.0,254,3.0,221
1255,655,656,13.537233560090703,15.928888888888887,15.0,16.0,103,2.0,1
1256,655,627,13.537233560090703,16.207528344671204,15.0,7.0,118,3.0,28
1257,656,197,14.32671201814059,17.04344671201814,17.0,27.0,474,3.0,459
1258,656,227,14.32671201814059,15.882448979591837,17.0,12.0,434,2.0,429
1259,656,213,14.32671201814059,16.34684807256236,17.0,23.0,451,2.0,443
1260,656,211,14.32671201814059,17.29886621315193,17.0,22.0,463,3.0,445
1261,656,465,14.32671201814059,15.975328798185942,17.0,21.0,204,2.0,191
1262,656,434,14.32671201814059,16.46294784580499,17.0,23.0,240,2.0,222
1263,656,627,14.32671201814059,16.207528344671204,17.0,7.0,86,2.0,29
1264,656,673,14.32671201814059,17.136326530612244,17.0,20.0,122,3.0,17
1265,656,829,14.32671201814059,17.159546485260773,17.0,3.0,212,3.0,173
1266,656,197,15.928888888888887,17.04344671201814,16.0,27.0,462,1.0,459
1267,656,211,15.928888888888887,17.29886621315193,16.0,22.0,449,1.0,445
1268,656,366,15.928888888888887,18.250884353741494,16.0,13.0,307,2.0,290
1269,656,478,15.928888888888887,17.41496598639456,16.0,22.0,189,1.0,178
1270,656,549,15.928888888888887,18.250884353741494,16.0,18.0,146,2.0,107
1271,656,673,15.928888888888887,17.136326530612244,16.0,20.0,55,1.0,17
1272,656,628,15.928888888888887,18.250884353741494,16.0,10.0,104,2.0,28
1273,656,829,15.928888888888887,17.159546485260773,16.0,3.0,181,1.0,173
1274,627,211,16.207528344671204,17.29886621315193,7.0,22.0,419,1.0,416
1275,627,366,16.207528344671204,18.250884353741494,7.0,13.0,275,2.0,261
1276,627,478,16.207528344671204,17.41496598639456,7.0,22.0,158,1.0,149
1277,627,549,16.207528344671204,18.250884353741494,7.0,18.0,118,2.0,78
1278,627,628,16.207528344671204,18.250884353741494,7.0,10.0,88,2.0,1
1279,627,643,16.207528344671204,19.040362811791386,7.0,21.0,123,3.0,16
1280,673,366,17.136326530612244,18.250884353741494,20.0,13.0,311,1.0,307
1281,673,211,17.136326530612244,19.783401360544214,20.0,29.0,476,3.0,462
1282,673,549,17.136326530612244,18.250884353741494,20.0,18.0,133,1.0,124
1283,673,434,17.136326530612244,19.806621315192746,20.0,20.0,265,3.0,239
1284,673,628,17.136326530612244,18.250884353741494,20.0,10.0,66,1.0,45
1285,673,643,17.136326530612244,19.040362811791386,20.0,21.0,87,2.0,30
1286,673,617,17.136326530612244,20.038820861678005,20.0,16.0,137,3.0,56
1287,628,211,18.250884353741494,19.783401360544214,10.0,29.0,422,2.0,417
1288,628,227,18.250884353741494,20.433560090702947,10.0,27.0,412,2.0,401
1289,628,434,18.250884353741494,19.806621315192746,10.0,20.0,205,2.0,194
1290,628,474,18.250884353741494,20.642539682539685,10.0,25.0,185,2.0,154
1291,628,617,18.250884353741494,20.038820861678005,10.0,16.0,78,2.0,11
1292,643,227,19.040362811791386,20.433560090702947,21.0,27.0,420,1.0,416
1293,643,218,19.040362811791386,21.40879818594105,21.0,18.0,437,2.0,425
1294,643,474,19.040362811791386,20.642539682539685,21.0,25.0,183,2.0,169
1295,643,510,19.040362811791386,21.40879818594105,21.0,15.0,168,2.0,133
1296,643,675,19.040362811791386,21.362358276643988,21.0,2.0,105,2.0,32
1297,617,218,20.038820861678005,21.40879818594105,16.0,18.0,403,1.0,399
1298,617,230,20.038820861678005,22.50013605442177,16.0,29.0,401,2.0,387
1299,617,510,20.038820861678005,21.40879818594105,16.0,15.0,122,1.0,107
1300,617,510,20.038820861678005,22.29115646258504,16.0,22.0,144,2.0,107
1301,617,675,20.038820861678005,21.362358276643988,16.0,2.0,81,1.0,58
1302,617,829,20.038820861678005,22.337596371882086,16.0,5.0,234,2.0,212
1303,675,230,21.362358276643988,22.50013605442177,2.0,29.0,448,1.0,445
1304,675,214,21.362358276643988,23.080634920634925,2.0,31.0,467,2.0,461
1305,675,463,21.362358276643988,23.080634920634925,2.0,22.0,225,2.0,212
1306,617,213,22.29115646258504,24.891791383219964,25.0,15.0,419,3.0,404
1307,617,418,22.29115646258504,24.86857142857143,25.0,15.0,228,3.0,199
1308,617,582,22.29115646258504,25.147210884353747,25.0,25.0,128,3.0,35
1309,617,655,22.29115646258504,24.938231292517013,25.0,0.0,120,3.0,38
1310,617,641,22.29115646258504,25.17043083900227,25.0,26.0,126,3.0,24
1311,617,830,22.29115646258504,25.123990929705208,25.0,7.0,245,3.0,213
1312,675,181,23.19673469387755,25.518730158730158,13.0,28.0,504,2.0,494
1313,675,213,23.19673469387755,24.891791383219964,13.0,15.0,468,2.0,462
1314,675,231,23.19673469387755,25.472290249433108,13.0,31.0,455,2.0,444
1315,675,418,23.19673469387755,24.86857142857143,13.0,15.0,267,2.0,257
1316,675,582,23.19673469387755,25.147210884353747,13.0,25.0,125,2.0,93
1317,675,655,23.19673469387755,24.938231292517013,13.0,0.0,78,2.0,20
1318,675,641,23.19673469387755,25.17043083900227,13.0,26.0,92,2.0,34
1319,675,830,23.19673469387755,25.123990929705208,13.0,7.0,176,2.0,155
1320,655,223,24.938231292517013,26.354648526077103,0.0,23.0,436,1.0,432
1321,655,392,24.938231292517013,26.981587301587304,0.0,9.0,277,2.0,263
1322,655,590,24.938231292517013,26.79582766439909,0.0,17.0,103,2.0,65
1323,655,467,24.938231292517013,26.981587301587304,0.0,6.0,208,2.0,188
1324,655,618,24.938231292517013,26.865487528344673,0.0,21.0,91,2.0,37
1325,655,618,24.938231292517013,27.28344671201814,0.0,7.0,108,2.0,37
1326,641,223,25.17043083900227,26.354648526077103,26.0,23.0,421,1.0,418
1327,641,392,25.17043083900227,26.981587301587304,26.0,9.0,261,2.0,249
1328,641,590,25.17043083900227,26.79582766439909,26.0,17.0,87,2.0,51
1329,641,467,25.17043083900227,26.981587301587304,26.0,6.0,191,2.0,174
1330,641,618,25.17043083900227,26.865487528344673,26.0,21.0,77,2.0,23
1331,641,618,25.17043083900227,27.28344671201814,26.0,7.0,94,2.0,23
1332,618,217,26.865487528344673,28.955283446712023,21.0,23.0,411,2.0,401
1333,618,209,26.865487528344673,29.442902494331065,21.0,22.0,424,3.0,409
1334,618,595,26.865487528344673,28.699863945578237,21.0,26.0,82,2.0,23
1335,618,596,26.865487528344673,29.23392290249433,21.0,30.0,104,2.0,22
1336,618,617,26.865487528344673,28.72308390022676,21.0,20.0,80,2.0,1
1337,618,626,26.865487528344673,29.23392290249433,21.0,26.0,102,2.0,8
1338,618,833,26.865487528344673,28.699863945578237,21.0,4.0,229,2.0,215
1339,618,870,26.865487528344673,29.257142857142853,21.0,9.0,272,2.0,252
1340,618,217,27.28344671201814,28.955283446712023,7.0,23.0,407,2.0,401
1341,618,209,27.28344671201814,29.442902494331065,7.0,22.0,419,2.0,409
1342,618,232,27.28344671201814,30.00018140589569,7.0,17.0,403,3.0,386
1343,618,595,27.28344671201814,28.699863945578237,7.0,26.0,65,1.0,23
1344,618,596,27.28344671201814,29.23392290249433,7.0,30.0,87,2.0,22
1345,618,617,27.28344671201814,28.72308390022676,7.0,20.0,62,1.0,1
1346,618,626,27.28344671201814,29.23392290249433,7.0,26.0,84,2.0,8
1347,618,833,27.28344671201814,28.699863945578237,7.0,4.0,223,1.0,215
1348,618,870,27.28344671201814,29.257142857142853,7.0,9.0,266,2.0,252
1349,617,232,28.72308390022676,30.00018140589569,20.0,17.0,389,1.0,385
1350,617,614,28.72308390022676,30.78965986394558,20.0,20.0,89,2.0,3
1351,617,613,28.72308390022676,31.579138321995462,20.0,23.0,123,3.0,4
1352,617,656,28.72308390022676,30.81287981859411,20.0,18.0,98,2.0,39
1353,617,656,28.72308390022676,31.579138321995462,20.0,20.0,129,3.0,39
1354,626,217,29.23392290249433,31.97387755102041,26.0,23.0,426,3.0,409
1355,626,212,29.23392290249433,32.13641723356009,26.0,29.0,432,3.0,414
1356,626,614,29.23392290249433,30.78965986394558,26.0,20.0,68,2.0,12
1357,626,613,29.23392290249433,31.579138321995462,26.0,23.0,102,2.0,13
1358,626,477,29.23392290249433,32.13641723356009,26.0,27.0,194,3.0,149
1359,626,656,29.23392290249433,30.81287981859411,26.0,18.0,74,2.0,30
1360,626,656,29.23392290249433,31.579138321995462,26.0,20.0,105,2.0,30
1361,656,217,30.81287981859411,31.97387755102041,18.0,23.0,442,1.0,439
1362,656,212,30.81287981859411,32.13641723356009,18.0,29.0,448,1.0,444
1363,656,209,30.81287981859411,33.01877551020408,18.0,19.0,457,2.0,447
1364,656,477,30.81287981859411,32.13641723356009,18.0,27.0,188,1.0,179
1365,656,494,30.81287981859411,33.18131519274377,18.0,15.0,191,2.0,162
1366,656,615,30.81287981859411,32.554376417233556,18.0,9.0,85,2.0,41
1367,656,209,31.579138321995462,33.01877551020408,20.0,19.0,451,1.0,447
1368,656,494,31.579138321995462,33.18131519274377,20.0,15.0,176,2.0,162
1369,656,619,31.579138321995462,34.365532879818595,20.0,15.0,126,3.0,37
1370,615,236,32.554376417233556,34.89959183673469,9.0,22.0,392,2.0,379
1371,615,234,32.554376417233556,35.340770975056685,9.0,24.0,399,3.0,381
1372,615,483,32.554376417233556,34.82993197278912,9.0,29.0,164,2.0,132
1373,615,619,32.554376417233556,34.365532879818595,9.0,15.0,78,2.0,4
1374,615,622,32.554376417233556,35.5265306122449,9.0,17.0,128,3.0,7
1375,615,880,32.554376417233556,34.876371882086175,9.0,-0.0,283,2.0,265
1376,615,831,32.554376417233556,35.503310657596366,9.0,2.0,251,3.0,216
1377,656,236,33.18131519274377,34.89959183673469,17.0,22.0,426,2.0,420
1378,656,234,33.18131519274377,35.340770975056685,17.0,24.0,432,2.0,422
1379,656,236,33.18131519274377,36.083809523809535,17.0,18.0,438,3.0,420
1380,656,483,33.18131519274377,34.82993197278912,17.0,29.0,187,2.0,173
1381,656,459,33.18131519274377,35.94448979591837,17.0,23.0,230,3.0,197
1382,656,468,33.18131519274377,36.014149659863946,17.0,16.0,224,3.0,188
1383,656,619,33.18131519274377,34.365532879818595,17.0,15.0,63,1.0,37
1384,656,622,33.18131519274377,35.5265306122449,17.0,17.0,107,2.0,34
1385,656,880,33.18131519274377,34.876371882086175,17.0,-0.0,236,2.0,224
1386,656,831,33.18131519274377,35.503310657596366,17.0,2.0,202,2.0,175
1387,619,236,34.365532879818595,36.083809523809535,15.0,18.0,390,2.0,383
1388,619,459,34.365532879818595,35.94448979591837,15.0,23.0,174,2.0,160
1389,619,468,34.365532879818595,36.014149659863946,15.0,16.0,167,2.0,151
1390,619,622,34.365532879818595,35.5265306122449,15.0,17.0,50,1.0,3
1391,619,656,34.365532879818595,36.75718820861678,15.0,11.0,109,2.0,37
1392,619,831,34.365532879818595,35.503310657596366,15.0,2.0,218,1.0,212
1393,622,295,35.5265306122449,37.94140589569161,17.0,26.0,343,2.0,327
1394,622,461,35.5265306122449,37.9181859410431,17.0,27.0,191,2.0,161
1395,622,474,35.5265306122449,38.38258503401361,17.0,27.0,192,3.0,148
1396,622,656,35.5265306122449,36.75718820861678,17.0,11.0,63,1.0,34
1397,622,617,35.5265306122449,37.8485260770975,17.0,14.0,100,2.0,5
1398,622,624,35.5265306122449,38.150385487528354,17.0,19.0,113,3.0,2
1399,622,833,35.5265306122449,38.173605442176864,17.0,-0.0,240,3.0,211
1400,656,295,36.75718820861678,37.94140589569161,11.0,26.0,365,1.0,361
1401,656,212,36.75718820861678,38.963083900226756,11.0,29.0,454,2.0,444
1402,656,209,36.75718820861678,39.055963718820855,11.0,27.0,458,2.0,447
1403,656,461,36.75718820861678,37.9181859410431,11.0,27.0,201,1.0,195
1404,656,474,36.75718820861678,38.38258503401361,11.0,27.0,195,2.0,182
1405,656,432,36.75718820861678,39.00952380952381,11.0,21.0,244,2.0,224
1406,656,617,36.75718820861678,37.8485260770975,11.0,14.0,61,1.0,39
1407,656,624,36.75718820861678,38.150385487528354,11.0,19.0,68,1.0,32
1408,656,653,36.75718820861678,39.28816326530613,11.0,14.0,109,3.0,3
1409,656,833,36.75718820861678,38.173605442176864,11.0,-0.0,187,1.0,177
1410,617,212,37.8485260770975,38.963083900226756,14.0,29.0,408,1.0,405
1411,617,209,37.8485260770975,39.055963718820855,14.0,27.0,411,1.0,408
1412,617,208,37.8485260770975,40.05442176870749,14.0,24.0,420,2.0,409
1413,617,432,37.8485260770975,39.00952380952381,14.0,21.0,192,1.0,185
1414,617,480,37.8485260770975,40.00798185941043,14.0,20.0,166,2.0,137
1415,617,653,37.8485260770975,39.28816326530613,14.0,14.0,72,1.0,36
1416,617,628,37.8485260770975,40.07764172335601,14.0,6.0,97,2.0,11
1417,624,208,38.150385487528354,40.05442176870749,19.0,24.0,424,2.0,416
1418,624,480,38.150385487528354,40.00798185941043,19.0,20.0,165,2.0,144
1419,624,653,38.150385487528354,39.28816326530613,19.0,14.0,57,1.0,29
1420,624,628,38.150385487528354,40.07764172335601,19.0,6.0,83,2.0,4
1421,653,217,39.28816326530613,41.56371882086168,14.0,31.0,447,2.0,436
1422,653,228,39.28816326530613,42.120997732426304,14.0,28.0,442,3.0,425
1423,653,485,39.28816326530613,41.88879818594104,14.0,24.0,202,3.0,168
1424,653,474,39.28816326530613,41.98167800453515,14.0,20.0,213,3.0,179
1425,653,656,39.28816326530613,41.84235827664399,14.0,11.0,110,3.0,3
1426,628,217,40.07764172335601,41.56371882086168,6.0,31.0,416,1.0,411
1427,628,228,40.07764172335601,42.120997732426304,6.0,28.0,410,2.0,400
1428,628,218,40.07764172335601,42.98013605442178,6.0,10.0,429,3.0,410
1429,628,485,40.07764172335601,41.88879818594104,6.0,24.0,163,2.0,143
1430,628,474,40.07764172335601,41.98167800453515,6.0,20.0,174,2.0,154
1431,628,656,40.07764172335601,41.84235827664399,6.0,11.0,81,2.0,28
1432,628,615,40.07764172335601,42.515736961451246,6.0,13.0,106,2.0,13
1433,628,656,40.07764172335601,42.98013605442178,6.0,1.0,128,3.0,28
1434,656,218,41.84235827664399,42.98013605442178,11.0,10.0,441,1.0,438
1435,656,218,41.84235827664399,44.23401360544218,11.0,25.0,450,2.0,438
1436,656,438,41.84235827664399,43.86249433106576,11.0,7.0,235,2.0,218
1437,656,466,41.84235827664399,44.23401360544218,11.0,25.0,216,2.0,190
1438,615,218,42.515736961451246,44.23401360544218,13.0,25.0,404,2.0,397
1439,615,233,42.515736961451246,45.046712018140596,13.0,23.0,397,3.0,382
1440,615,438,42.515736961451246,43.86249433106576,13.0,7.0,186,1.0,177
1441,615,466,42.515736961451246,44.23401360544218,13.0,25.0,166,2.0,149
1442,615,474,42.515736961451246,45.11637188208617,13.0,21.0,180,3.0,141
1443,615,656,42.515736961451246,44.187573696145115,13.0,19.0,83,2.0,41
1444,656,218,42.98013605442178,44.23401360544218,1.0,25.0,441,1.0,438
1445,656,233,42.98013605442178,45.046712018140596,1.0,23.0,432,2.0,423
1446,656,466,42.98013605442178,44.23401360544218,1.0,25.0,198,1.0,190
1447,656,474,42.98013605442178,45.11637188208617,1.0,21.0,204,2.0,182
1448,656,206,44.187573696145115,46.16126984126985,19.0,10.0,458,2.0,450
1449,656,425,44.187573696145115,46.973968253968245,19.0,10.0,260,3.0,231
1450,656,616,44.187573696145115,46.55600907029479,19.0,3.0,110,2.0,40
1451,656,227,45.7665306122449,47.76344671201814,19.0,24.0,438,2.0,429
1452,656,216,45.7665306122449,48.320725623582774,19.0,21.0,454,3.0,440
1453,656,425,45.7665306122449,46.973968253968245,19.0,10.0,237,1.0,231
1454,656,451,45.7665306122449,47.53124716553288,19.0,27.0,219,2.0,205
1455,656,438,45.7665306122449,48.57614512471656,19.0,17.0,249,3.0,218
1456,656,624,45.7665306122449,47.182947845804996,19.0,26.0,69,1.0,32
1457,656,851,45.7665306122449,47.20616780045352,19.0,4.0,205,1.0,195
1458,616,227,46.55600907029479,47.76344671201814,3.0,24.0,392,1.0,389
1459,616,216,46.55600907029479,48.320725623582774,3.0,21.0,407,2.0,400
1460,616,438,46.55600907029479,48.57614512471656,3.0,17.0,198,2.0,178
1461,616,643,46.55600907029479,48.90122448979592,3.0,13.0,105,2.0,27
1462,624,216,47.182947845804996,48.320725623582774,26.0,21.0,411,1.0,408
1463,624,223,47.182947845804996,49.922902494331076,26.0,21.0,418,3.0,401
1464,624,438,47.182947845804996,48.57614512471656,26.0,17.0,195,1.0,186
1465,624,457,47.182947845804996,49.899682539682544,26.0,20.0,204,3.0,167
1466,624,643,47.182947845804996,48.90122448979592,26.0,13.0,76,2.0,19
1467,624,615,47.182947845804996,49.96934240362812,26.0,5.0,120,3.0,9
1468,643,158,48.90122448979592,50.3873015873016,13.0,23.0,489,1.0,485
1469,643,223,48.90122448979592,49.922902494331076,13.0,21.0,422,1.0,420
1470,643,210,48.90122448979592,50.61950113378685,13.0,26.0,439,2.0,433
1471,643,422,48.90122448979592,50.3873015873016,13.0,14.0,230,1.0,221
1472,643,615,48.90122448979592,49.96934240362812,13.0,5.0,54,1.0,28
1473,643,618,48.90122448979592,50.48018140589569,13.0,17.0,72,2.0,25
1474,615,213,49.96934240362812,51.966258503401356,5.0,22.0,411,2.0,402
1475,615,216,49.96934240362812,52.546757369614504,5.0,30.0,414,3.0,399
1476,615,455,49.96934240362812,51.966258503401356,5.0,19.0,182,2.0,160
1477,615,451,49.96934240362812,52.38421768707482,5.0,27.0,194,2.0,164
1478,615,643,49.96934240362812,51.61795918367347,5.0,9.0,76,2.0,28
1479,615,643,49.96934240362812,52.012698412698406,5.0,18.0,92,2.0,28
1480,618,213,50.48018140589569,51.966258503401356,17.0,22.0,410,1.0,405
1481,618,216,50.48018140589569,52.546757369614504,17.0,30.0,412,2.0,402
1482,618,213,50.48018140589569,53.31301587301587,17.0,22.0,423,3.0,405
1483,618,455,50.48018140589569,51.966258503401356,17.0,19.0,175,1.0,163
1484,618,451,50.48018140589569,52.38421768707482,17.0,27.0,186,2.0,167
1485,618,643,50.48018140589569,51.61795918367347,17.0,9.0,55,1.0,25
1486,618,643,50.48018140589569,52.012698412698406,17.0,18.0,71,2.0,25
1487,618,644,50.48018140589569,53.17369614512472,17.0,13.0,119,3.0,26
1488,643,213,51.61795918367347,53.31301587301587,9.0,22.0,436,2.0,430
1489,643,459,51.61795918367347,53.63809523809525,9.0,20.0,204,2.0,184
1490,643,644,51.61795918367347,53.17369614512472,9.0,13.0,67,2.0,1
1491,643,644,51.61795918367347,54.00961451247166,9.0,6.0,103,2.0,1
1492,643,213,52.012698412698406,53.31301587301587,18.0,22.0,434,1.0,430
1493,643,208,52.012698412698406,54.68299319727891,18.0,25.0,450,3.0,435
1494,643,459,52.012698412698406,53.63809523809525,18.0,20.0,197,2.0,184
1495,643,416,52.012698412698406,54.68299319727891,18.0,14.0,254,3.0,227
1496,643,644,52.012698412698406,53.17369614512472,18.0,13.0,50,1.0,1
1497,643,644,52.012698412698406,54.00961451247166,18.0,6.0,86,2.0,1
1498,644,208,53.17369614512472,54.68299319727891,13.0,25.0,441,2.0,436
1499,644,270,53.17369614512472,55.147392290249435,13.0,17.0,384,2.0,374
1500,644,328,53.17369614512472,55.98331065759637,13.0,13.0,338,3.0,316
1501,644,416,53.17369614512472,54.68299319727891,13.0,14.0,237,2.0,228
1502,644,613,53.17369614512472,55.147392290249435,13.0,19.0,90,2.0,31
1503,644,656,53.17369614512472,55.17061224489796,13.0,14.0,87,2.0,12
1504,644,270,54.00961451247166,55.147392290249435,6.0,17.0,377,1.0,374
1505,644,328,54.00961451247166,55.98331065759637,6.0,13.0,327,2.0,316
1506,644,613,54.00961451247166,55.147392290249435,6.0,19.0,58,1.0,31
1507,644,614,54.00961451247166,56.749569160997744,6.0,11.0,122,3.0,30
1508,644,656,54.00961451247166,55.17061224489796,6.0,14.0,51,1.0,12
1509,644,615,54.00961451247166,56.749569160997744,6.0,5.0,122,3.0,29
1510,656,206,55.17061224489796,57.35328798185941,14.0,25.0,460,2.0,450
1511,656,391,55.17061224489796,58.09632653061225,14.0,16.0,293,3.0,265
1512,656,614,55.17061224489796,56.749569160997744,14.0,11.0,80,2.0,42
1513,656,484,55.17061224489796,57.678367346938785,14.0,26.0,203,3.0,172
1514,656,611,55.17061224489796,58.07310657596371,14.0,21.0,133,3.0,45
1515,656,615,55.17061224489796,56.749569160997744,14.0,5.0,79,2.0,41
1516,656,620,55.17061224489796,57.701587301587296,14.0,16.0,115,3.0,36
1517,656,617,55.17061224489796,58.07310657596371,14.0,22.0,131,3.0,39
1518,656,843,55.17061224489796,57.701587301587296,14.0,0.0,216,3.0,187
1519,615,391,56.749569160997744,58.09632653061225,5.0,16.0,231,1.0,224
1520,615,611,56.749569160997744,58.07310657596371,5.0,21.0,57,1.0,4
1521,615,470,56.749569160997744,59.72172335600907,5.0,27.0,193,3.0,145
1522,615,617,56.749569160997744,58.07310657596371,5.0,22.0,57,1.0,2
1523,615,627,56.749569160997744,59.67528344671203,5.0,16.0,127,3.0,12
1524,620,206,57.701587301587296,59.76816326530612,16.0,23.0,423,2.0,414
1525,620,470,57.701587301587296,59.72172335600907,16.0,27.0,173,2.0,150
1526,620,627,57.701587301587296,59.67528344671203,16.0,16.0,85,2.0,7
1527,617,206,58.07310657596371,59.76816326530612,22.0,23.0,417,2.0,411
1528,617,470,58.07310657596371,59.72172335600907,22.0,27.0,163,2.0,147
1529,617,627,58.07310657596371,59.67528344671203,22.0,16.0,70,2.0,10
1530,820,613,12.747755102040815,14.303492063492065,3.0,20.0,218,2.0,207
1531,820,656,12.747755102040815,14.32671201814059,3.0,17.0,178,2.0,164
1532,829,366,17.159546485260773,18.250884353741494,3.0,13.0,465,1.0,463
1533,829,549,17.159546485260773,18.250884353741494,3.0,18.0,284,1.0,280
1534,829,434,17.159546485260773,19.806621315192746,3.0,20.0,411,3.0,395
1535,829,628,17.159546485260773,18.250884353741494,3.0,10.0,206,1.0,201
1536,829,643,17.159546485260773,19.040362811791386,3.0,21.0,203,2.0,186
1537,829,617,17.159546485260773,20.038820861678005,3.0,16.0,246,3.0,212
1538,829,418,22.337596371882086,24.86857142857143,5.0,15.0,425,3.0,411
1539,829,582,22.337596371882086,25.147210884353747,5.0,25.0,275,3.0,247
1540,829,655,22.337596371882086,24.938231292517013,5.0,0.0,207,3.0,174
1541,829,641,22.337596371882086,25.17043083900227,5.0,26.0,224,3.0,188
1542,829,830,22.337596371882086,25.123990929705208,5.0,7.0,120,3.0,1
1543,830,392,25.123990929705208,26.981587301587304,7.0,9.0,445,2.0,438
1544,830,590,25.123990929705208,26.79582766439909,7.0,17.0,251,2.0,240
1545,830,467,25.123990929705208,26.981587301587304,7.0,6.0,372,2.0,363
1546,830,618,25.123990929705208,26.865487528344673,7.0,21.0,225,2.0,212
1547,830,618,25.123990929705208,27.28344671201814,7.0,7.0,232,2.0,212
1548,833,614,28.699863945578237,30.78965986394558,4.0,20.0,237,2.0,219
1549,833,613,28.699863945578237,31.579138321995462,4.0,23.0,253,3.0,220
1550,833,656,28.699863945578237,30.81287981859411,4.0,18.0,199,2.0,177
1551,833,656,28.699863945578237,31.579138321995462,4.0,20.0,216,3.0,177
1552,870,614,29.257142857142853,30.78965986394558,9.0,20.0,264,2.0,256
1553,870,613,29.257142857142853,31.579138321995462,9.0,23.0,276,2.0,257
1554,870,477,29.257142857142853,32.13641723356009,9.0,27.0,412,3.0,393
1555,870,656,29.257142857142853,30.81287981859411,9.0,18.0,224,2.0,214
1556,870,656,29.257142857142853,31.579138321995462,9.0,20.0,236,2.0,214
1557,880,459,34.876371882086175,35.94448979591837,-0.0,23.0,424,1.0,421
1558,880,468,34.876371882086175,36.014149659863946,-0.0,16.0,415,1.0,412
1559,880,656,34.876371882086175,36.75718820861678,-0.0,11.0,238,2.0,224
1560,880,617,34.876371882086175,37.8485260770975,-0.0,14.0,292,3.0,263
1561,831,461,35.503310657596366,37.9181859410431,2.0,27.0,384,2.0,370
1562,831,474,35.503310657596366,38.38258503401361,2.0,27.0,378,3.0,357
1563,831,656,35.503310657596366,36.75718820861678,2.0,11.0,183,1.0,175
1564,831,617,35.503310657596366,37.8485260770975,2.0,14.0,237,2.0,214
1565,831,624,35.503310657596366,38.150385487528354,2.0,19.0,236,3.0,207
1566,831,833,35.503310657596366,38.173605442176864,2.0,-0.0,115,3.0,2
1567,833,480,38.173605442176864,40.00798185941043,-0.0,20.0,362,2.0,353
1568,833,653,38.173605442176864,39.28816326530613,-0.0,14.0,186,1.0,180
1569,833,628,38.173605442176864,40.07764172335601,-0.0,6.0,221,2.0,205
1570,851,438,47.20616780045352,48.57614512471656,4.0,17.0,417,1.0,413
1571,851,457,47.20616780045352,49.899682539682544,4.0,20.0,411,3.0,394
1572,851,643,47.20616780045352,48.90122448979592,4.0,13.0,220,2.0,208
1573,851,615,47.20616780045352,49.96934240362812,4.0,5.0,264,3.0,236
1574,843,470,57.701587301587296,59.72172335600907,0.0,27.0,383,2.0,373
1575,843,627,57.701587301587296,59.67528344671203,0.0,16.0,232,2.0,216
