,f0,f1,t0,t1,dB0,dB1,dist,utime,ufreq
0,193,174,1.9736961451247168,3.43655328798186,24.0,28.0,66,1.0,19
1,193,259,1.9736961451247168,3.2043537414965986,24.0,27.0,85,1.0,66
2,193,256,1.9736961451247168,4.435011337868481,24.0,41.0,123,2.0,63
3,193,450,1.9736961451247168,3.3668934240362813,24.0,14.0,264,1.0,257
4,193,410,1.9736961451247168,4.435011337868481,24.0,17.0,242,2.0,217
5,193,615,1.9736961451247168,4.435011337868481,24.0,7.0,435,2.0,422
6,174,145,2.391655328798186,4.96907029478458,25.0,33.0,115,3.0,29
7,174,146,2.391655328798186,4.992290249433106,25.0,32.0,115,3.0,28
8,174,256,2.391655328798186,4.435011337868481,25.0,41.0,120,2.0,82
9,174,242,2.391655328798186,4.992290249433106,25.0,16.0,131,3.0,68
10,174,410,2.391655328798186,4.435011337868481,25.0,17.0,252,2.0,236
11,174,532,2.391655328798186,4.992290249433106,25.0,2.0,375,3.0,358
12,174,615,2.391655328798186,4.435011337868481,25.0,7.0,450,2.0,441
13,174,145,3.43655328798186,4.96907029478458,28.0,33.0,72,2.0,29
14,174,146,3.43655328798186,4.992290249433106,28.0,32.0,73,2.0,28
15,174,242,3.43655328798186,4.992290249433106,28.0,16.0,95,2.0,68
16,174,532,3.43655328798186,4.992290249433106,28.0,2.0,364,2.0,358
17,145,194,4.96907029478458,6.524807256235827,33.0,25.0,83,2.0,49
18,145,146,4.96907029478458,7.058866213151928,33.0,28.0,90,2.0,1
19,145,242,4.96907029478458,6.524807256235827,33.0,37.0,118,2.0,97
20,145,255,4.96907029478458,6.9892063492063485,33.0,13.0,140,2.0,110
21,145,485,4.96907029478458,6.5015873015873025,33.0,18.0,346,2.0,340
22,146,194,4.992290249433106,6.524807256235827,32.0,25.0,82,2.0,48
23,146,242,4.992290249433106,6.524807256235827,32.0,37.0,116,2.0,96
24,146,255,4.992290249433106,6.9892063492063485,32.0,13.0,139,2.0,109
25,146,485,4.992290249433106,6.5015873015873025,32.0,18.0,345,2.0,339
26,194,49,6.524807256235827,8.544943310657597,25.0,24.0,169,2.0,145
27,194,146,6.524807256235827,9.102222222222222,25.0,29.0,121,3.0,48
28,194,242,6.524807256235827,8.568163265306122,25.0,37.0,100,2.0,48
29,194,485,6.524807256235827,8.568163265306122,25.0,18.0,304,2.0,291
30,146,49,7.058866213151928,8.544943310657597,28.0,24.0,116,1.0,97
31,146,242,7.058866213151928,8.568163265306122,28.0,37.0,116,2.0,96
32,146,239,7.058866213151928,9.729160997732428,28.0,16.0,148,3.0,93
33,146,485,7.058866213151928,8.568163265306122,28.0,18.0,345,2.0,339
34,146,519,7.058866213151928,9.636281179138322,28.0,6.0,389,3.0,373
35,49,194,8.544943310657597,10.611519274376418,24.0,30.0,170,2.0,145
36,49,146,8.544943310657597,11.168798185941043,24.0,30.0,149,3.0,97
37,49,239,8.544943310657597,9.729160997732428,24.0,16.0,197,1.0,190
38,49,242,8.544943310657597,10.611519274376418,24.0,40.0,213,2.0,193
39,49,261,8.544943310657597,11.099138321995463,24.0,22.0,239,3.0,212
40,49,519,8.544943310657597,9.636281179138322,24.0,6.0,472,1.0,470
41,49,485,8.544943310657597,10.611519274376418,24.0,23.0,445,2.0,436
42,146,194,9.102222222222222,10.611519274376418,29.0,30.0,81,2.0,48
43,146,242,9.102222222222222,10.611519274376418,29.0,40.0,116,2.0,96
44,146,261,9.102222222222222,11.099138321995463,29.0,22.0,144,2.0,115
45,146,485,9.102222222222222,10.611519274376418,29.0,23.0,345,2.0,339
46,146,453,9.102222222222222,11.58675736961451,29.0,10.0,325,2.0,307
47,194,86,10.611519274376418,13.188934240362814,30.0,32.0,155,3.0,108
48,194,242,10.611519274376418,12.67809523809524,30.0,38.0,101,2.0,48
49,194,485,10.611519274376418,12.67809523809524,30.0,19.0,304,2.0,291
50,194,456,10.611519274376418,13.212154195011339,30.0,4.0,285,3.0,262
51,146,194,11.168798185941043,12.67809523809524,30.0,25.0,81,2.0,48
52,146,86,11.168798185941043,13.188934240362814,30.0,32.0,106,2.0,60
53,146,242,11.168798185941043,12.67809523809524,30.0,38.0,116,2.0,96
54,146,355,11.168798185941043,13.839092970521545,30.0,13.0,239,3.0,209
55,146,485,11.168798185941043,12.67809523809524,30.0,19.0,345,2.0,339
56,146,456,11.168798185941043,13.212154195011339,30.0,4.0,322,2.0,310
57,194,87,12.67809523809524,14.466031746031744,25.0,22.0,132,2.0,107
58,194,146,12.67809523809524,15.278730158730161,25.0,28.0,122,3.0,48
59,194,355,12.67809523809524,13.839092970521545,25.0,13.0,169,1.0,161
60,194,242,12.67809523809524,14.721451247165533,25.0,35.0,100,2.0,48
61,194,231,12.67809523809524,15.278730158730161,25.0,12.0,118,3.0,37
62,194,485,12.67809523809524,14.721451247165533,25.0,18.0,304,2.0,291
63,86,87,13.188934240362814,14.466031746031744,32.0,22.0,55,1.0,1
64,86,146,13.188934240362814,15.278730158730161,32.0,28.0,108,2.0,60
65,86,242,13.188934240362814,14.721451247165533,32.0,35.0,169,2.0,156
66,86,231,13.188934240362814,15.278730158730161,32.0,12.0,171,2.0,145
67,86,485,13.188934240362814,14.721451247165533,32.0,18.0,404,2.0,399
68,87,151,14.466031746031744,16.76480725623583,22.0,35.0,118,2.0,64
69,87,256,14.466031746031744,16.76480725623583,22.0,33.0,196,2.0,169
70,87,542,14.466031746031744,16.741587301587302,22.0,13.0,465,2.0,455
71,87,562,14.466031746031744,17.22920634920635,22.0,26.0,490,3.0,475
72,146,151,15.278730158730161,16.76480725623583,28.0,35.0,64,1.0,5
73,146,66,15.278730158730161,17.740045351473924,28.0,31.0,133,2.0,80
74,146,256,15.278730158730161,16.76480725623583,28.0,33.0,127,1.0,110
75,146,239,15.278730158730161,17.76326530612245,28.0,27.0,142,2.0,93
76,146,542,15.278730158730161,16.741587301587302,28.0,13.0,401,1.0,396
77,146,562,15.278730158730161,17.22920634920635,28.0,26.0,424,2.0,416
78,146,445,15.278730158730161,18.250884353741494,28.0,23.0,325,3.0,299
79,146,616,15.278730158730161,16.904126984126986,28.0,10.0,475,2.0,470
80,146,616,15.278730158730161,17.22920634920635,28.0,17.0,477,2.0,470
81,146,615,15.278730158730161,18.22766439909297,28.0,18.0,486,3.0,469
82,151,65,16.76480725623583,18.29732426303855,35.0,32.0,108,2.0,86
83,151,68,16.76480725623583,19.295782312925173,35.0,30.0,137,3.0,83
84,151,237,16.76480725623583,18.29732426303855,35.0,29.0,108,2.0,86
85,151,231,16.76480725623583,19.040362811791386,35.0,29.0,127,2.0,80
86,151,445,16.76480725623583,18.250884353741494,35.0,23.0,301,1.0,294
87,151,615,16.76480725623583,18.22766439909297,35.0,18.0,468,1.0,464
88,151,616,16.76480725623583,19.527981859410428,35.0,19.0,480,3.0,465
89,66,68,17.740045351473924,19.295782312925173,31.0,30.0,67,2.0,2
90,66,65,17.740045351473924,20.387120181405894,31.0,33.0,114,3.0,1
91,66,231,17.740045351473924,19.040362811791386,31.0,29.0,174,1.0,165
92,66,241,17.740045351473924,20.31746031746032,31.0,31.0,207,3.0,175
93,66,530,17.740045351473924,19.87628117913832,31.0,21.0,473,2.0,464
94,66,480,17.740045351473924,20.31746031746032,31.0,22.0,429,3.0,414
95,65,241,18.29732426303855,20.31746031746032,32.0,31.0,196,2.0,176
96,65,530,18.29732426303855,19.87628117913832,32.0,21.0,470,2.0,465
97,65,480,18.29732426303855,20.31746031746032,32.0,22.0,424,2.0,415
98,65,561,18.29732426303855,21.08371882086168,32.0,20.0,510,3.0,496
99,68,65,19.295782312925173,20.387120181405894,30.0,33.0,47,1.0,3
100,68,201,19.295782312925173,21.84997732426304,30.0,30.0,173,3.0,133
101,68,241,19.295782312925173,20.31746031746032,30.0,31.0,179,1.0,173
102,68,231,19.295782312925173,21.89641723356009,30.0,34.0,198,3.0,163
103,68,480,19.295782312925173,20.31746031746032,30.0,22.0,414,1.0,412
104,68,561,19.295782312925173,21.08371882086168,30.0,20.0,499,2.0,493
105,65,201,20.387120181405894,21.84997732426304,33.0,30.0,150,1.0,136
106,65,77,20.387120181405894,22.430476190476192,33.0,28.0,89,2.0,12
107,65,231,20.387120181405894,21.89641723356009,33.0,34.0,178,2.0,166
108,65,242,20.387120181405894,22.360816326530614,33.0,30.0,196,2.0,177
109,65,480,20.387120181405894,22.360816326530614,33.0,23.0,424,2.0,415
110,65,561,20.387120181405894,23.12707482993197,33.0,20.0,510,3.0,496
111,201,195,21.84997732426304,23.40571428571429,30.0,36.0,67,2.0,6
112,201,77,21.84997732426304,23.986213151927444,30.0,24.0,154,2.0,124
113,201,218,21.84997732426304,23.45215419501134,30.0,37.0,71,2.0,17
114,201,561,21.84997732426304,23.12707482993197,30.0,20.0,364,1.0,360
115,201,480,21.84997732426304,24.427392290249433,30.0,21.0,300,3.0,279
116,201,616,21.84997732426304,23.12707482993197,30.0,19.0,419,1.0,415
117,77,218,22.430476190476192,23.45215419501134,28.0,37.0,148,1.0,141
118,77,256,22.430476190476192,24.96145124716553,28.0,35.0,210,3.0,179
119,77,256,22.430476190476192,24.98467120181406,28.0,30.0,210,3.0,179
120,77,480,22.430476190476192,24.427392290249433,28.0,21.0,412,2.0,403
121,195,76,23.40571428571429,25.58839002267574,36.0,33.0,152,2.0,119
122,195,180,23.40571428571429,26.23854875283447,36.0,36.0,123,3.0,15
123,195,256,23.40571428571429,24.96145124716553,36.0,35.0,91,2.0,61
124,195,256,23.40571428571429,24.98467120181406,36.0,30.0,91,2.0,61
125,195,480,23.40571428571429,24.427392290249433,36.0,21.0,288,1.0,285
126,195,562,23.40571428571429,25.44907029478458,36.0,30.0,377,2.0,367
127,195,616,23.40571428571429,24.91501133786848,36.0,20.0,426,2.0,421
128,195,616,23.40571428571429,25.17043083900227,36.0,21.0,428,2.0,421
129,195,616,23.40571428571429,26.19210884353741,36.0,21.0,438,3.0,421
130,77,76,23.986213151927444,25.58839002267574,24.0,33.0,69,2.0,1
131,77,180,23.986213151927444,26.23854875283447,24.0,36.0,141,2.0,103
132,77,218,23.986213151927444,26.563628117913836,24.0,33.0,179,3.0,141
133,77,562,23.986213151927444,25.44907029478458,24.0,30.0,489,1.0,485
134,77,480,23.986213151927444,26.47074829931973,24.0,22.0,417,2.0,403
135,76,204,25.58839002267574,27.53886621315193,33.0,36.0,153,2.0,128
136,76,197,25.58839002267574,28.51410430839002,33.0,29.0,175,3.0,121
137,76,231,25.58839002267574,27.771065759637192,33.0,40.0,181,2.0,155
138,76,256,25.58839002267574,28.11936507936508,33.0,37.0,210,3.0,180
139,76,562,25.58839002267574,26.981587301587304,33.0,20.0,490,1.0,486
140,76,550,25.58839002267574,28.51410430839002,33.0,21.0,490,3.0,474
141,180,204,26.23854875283447,27.53886621315193,36.0,36.0,61,1.0,24
142,180,197,26.23854875283447,28.51410430839002,36.0,29.0,99,2.0,17
143,180,231,26.23854875283447,27.771065759637192,36.0,40.0,83,2.0,51
144,180,256,26.23854875283447,28.11936507936508,36.0,37.0,111,2.0,76
145,180,255,26.23854875283447,29.071383219954647,36.0,33.0,143,3.0,75
146,180,550,26.23854875283447,28.51410430839002,36.0,21.0,383,2.0,370
147,180,561,26.23854875283447,29.0249433106576,36.0,20.0,399,3.0,381
148,180,616,26.23854875283447,28.328344671201812,36.0,17.0,445,2.0,436
149,204,77,27.53886621315193,29.69832199546485,36.0,31.0,157,2.0,127
150,204,255,27.53886621315193,29.071383219954647,36.0,33.0,83,2.0,51
151,204,561,27.53886621315193,29.0249433106576,36.0,20.0,363,1.0,357
152,204,616,27.53886621315193,29.280362811791388,36.0,21.0,419,2.0,412
153,204,616,27.53886621315193,30.04662131519275,36.0,19.0,426,3.0,412
154,197,77,28.51410430839002,29.69832199546485,29.0,31.0,130,1.0,120
155,197,195,28.51410430839002,30.83609977324263,29.0,27.0,100,2.0,2
156,197,219,28.51410430839002,30.557460317460322,29.0,36.0,91,2.0,22
157,197,550,28.51410430839002,30.557460317460322,29.0,23.0,364,2.0,353
158,197,616,28.51410430839002,30.04662131519275,29.0,19.0,424,2.0,419
159,197,616,28.51410430839002,31.32371882086168,29.0,19.0,436,3.0,419
160,77,195,29.69832199546485,30.83609977324263,31.0,27.0,128,1.0,118
161,77,204,29.69832199546485,31.579138321995462,31.0,29.0,151,2.0,127
162,77,200,29.69832199546485,32.624036281179144,31.0,22.0,176,3.0,123
163,77,232,29.69832199546485,31.74167800453515,31.0,36.0,178,2.0,155
164,77,244,29.69832199546485,32.48471655328798,31.0,37.0,206,3.0,167
165,77,411,29.69832199546485,31.579138321995462,31.0,23.0,344,2.0,334
166,77,411,29.69832199546485,32.04353741496599,31.0,25.0,349,2.0,334
167,195,200,30.83609977324263,32.624036281179144,27.0,22.0,77,2.0,5
168,195,151,30.83609977324263,33.715374149659866,27.0,32.0,132,3.0,44
169,195,244,30.83609977324263,32.48471655328798,27.0,37.0,86,2.0,49
170,195,255,30.83609977324263,33.158095238095235,27.0,35.0,117,2.0,60
171,195,411,30.83609977324263,32.04353741496599,27.0,25.0,222,1.0,216
172,195,489,30.83609977324263,33.2974149659864,27.0,27.0,313,2.0,294
173,195,616,30.83609977324263,32.43827664399093,27.0,17.0,427,2.0,421
174,195,616,30.83609977324263,33.111655328798186,27.0,20.0,432,2.0,421
175,204,200,31.579138321995462,32.624036281179144,29.0,22.0,45,1.0,4
176,204,151,31.579138321995462,33.715374149659866,29.0,32.0,106,2.0,53
177,204,195,31.579138321995462,34.22621315192744,29.0,40.0,114,3.0,9
178,204,255,31.579138321995462,33.158095238095235,29.0,35.0,85,2.0,51
179,204,215,31.579138321995462,34.29587301587301,29.0,32.0,118,3.0,11
180,204,489,31.579138321995462,33.2974149659864,29.0,27.0,294,2.0,285
181,204,616,31.579138321995462,33.111655328798186,29.0,20.0,417,2.0,412
182,204,616,31.579138321995462,34.411972789115644,29.0,18.0,430,3.0,412
183,200,151,32.624036281179144,33.715374149659866,22.0,32.0,68,1.0,49
184,200,195,32.624036281179144,34.22621315192744,22.0,40.0,69,2.0,5
185,200,65,32.624036281179144,35.085351473922906,22.0,33.0,172,2.0,135
186,200,215,32.624036281179144,34.29587301587301,22.0,32.0,74,2.0,15
187,200,550,32.624036281179144,34.66739229024943,22.0,20.0,361,2.0,350
188,200,616,32.624036281179144,34.411972789115644,22.0,18.0,423,2.0,416
189,151,65,33.715374149659866,35.085351473922906,32.0,33.0,104,1.0,86
190,151,188,33.715374149659866,36.269569160997726,32.0,33.0,116,3.0,37
191,151,235,33.715374149659866,35.71229024943311,32.0,29.0,120,2.0,84
192,151,561,33.715374149659866,35.94448979591837,32.0,19.0,421,2.0,410
193,151,616,33.715374149659866,35.94448979591837,32.0,20.0,475,2.0,465
194,195,188,34.22621315192744,36.269569160997726,40.0,33.0,88,2.0,7
195,195,235,34.22621315192744,35.71229024943311,40.0,29.0,75,1.0,40
196,195,224,34.22621315192744,36.73396825396826,40.0,28.0,112,3.0,29
197,195,561,34.22621315192744,35.94448979591837,40.0,19.0,373,2.0,366
198,195,480,34.22621315192744,36.73396825396826,40.0,22.0,305,3.0,285
199,195,426,34.22621315192744,37.198367346938774,40.0,24.0,264,3.0,231
200,195,616,34.22621315192744,35.94448979591837,40.0,20.0,427,2.0,421
201,195,616,34.22621315192744,36.966167800453526,40.0,20.0,437,3.0,421
202,65,188,35.085351473922906,36.269569160997726,33.0,33.0,133,1.0,123
203,65,66,35.085351473922906,37.29124716553289,33.0,31.0,95,2.0,1
204,65,224,35.085351473922906,36.73396825396826,33.0,28.0,174,2.0,159
205,65,256,35.085351473922906,37.26802721088436,33.0,29.0,213,2.0,191
206,65,480,35.085351473922906,36.73396825396826,33.0,22.0,421,2.0,415
207,65,426,35.085351473922906,37.198367346938774,33.0,24.0,372,2.0,361
208,188,66,36.269569160997726,37.29124716553289,33.0,31.0,130,1.0,122
209,188,194,36.269569160997726,38.35936507936508,33.0,39.0,90,2.0,6
210,188,237,36.269569160997726,38.38258503401361,33.0,31.0,103,2.0,49
211,188,480,36.269569160997726,38.777324263038544,33.0,23.0,311,3.0,292
212,188,616,36.269569160997726,37.47700680272109,33.0,20.0,431,1.0,428
213,188,616,36.269569160997726,38.24326530612245,33.0,20.0,436,2.0,428
214,66,194,37.29124716553289,38.35936507936508,31.0,39.0,136,1.0,128
215,66,65,37.29124716553289,39.68290249433107,31.0,26.0,103,2.0,1
216,66,237,37.29124716553289,38.38258503401361,31.0,31.0,177,1.0,171
217,66,239,37.29124716553289,39.845442176870755,31.0,27.0,205,3.0,173
218,66,480,37.29124716553289,38.777324263038544,31.0,23.0,419,1.0,414
219,194,65,38.35936507936508,39.68290249433107,39.0,26.0,141,1.0,129
220,194,178,38.35936507936508,40.61170068027211,39.0,31.0,98,2.0,16
221,194,239,38.35936507936508,39.845442176870755,39.0,27.0,78,1.0,45
222,194,256,38.35936507936508,40.82068027210885,39.0,28.0,123,2.0,62
223,194,612,38.35936507936508,39.77578231292517,39.0,20.0,422,1.0,418
224,194,444,38.35936507936508,40.82068027210885,39.0,21.0,272,2.0,250
225,194,616,38.35936507936508,39.77578231292517,39.0,21.0,426,1.0,422
226,194,616,38.35936507936508,40.03120181405896,39.0,20.0,428,2.0,422
227,194,616,38.35936507936508,41.33151927437642,39.0,21.0,441,3.0,422
228,65,86,39.68290249433107,41.37795918367347,26.0,34.0,76,2.0,21
229,65,151,39.68290249433107,42.42285714285715,26.0,35.0,146,3.0,86
230,65,256,39.68290249433107,40.82068027210885,26.0,28.0,197,1.0,191
231,65,256,39.68290249433107,41.37795918367347,26.0,32.0,204,2.0,191
232,65,216,39.68290249433107,42.399637188208615,26.0,31.0,191,3.0,151
233,65,444,39.68290249433107,40.82068027210885,26.0,21.0,382,1.0,379
234,65,528,39.68290249433107,41.865578231292524,26.0,22.0,472,2.0,463
235,178,151,40.61170068027211,42.42285714285715,31.0,35.0,83,2.0,27
236,178,73,40.61170068027211,43.37487528344671,31.0,30.0,159,3.0,105
237,178,216,40.61170068027211,42.399637188208615,31.0,31.0,86,2.0,38
238,178,218,40.61170068027211,43.42131519274376,31.0,25.0,127,3.0,40
239,178,528,40.61170068027211,41.865578231292524,31.0,22.0,354,1.0,350
240,178,550,40.61170068027211,42.86403628117914,31.0,22.0,384,2.0,372
241,178,475,40.61170068027211,43.37487528344671,31.0,19.0,320,3.0,297
242,178,616,40.61170068027211,42.60861678004535,31.0,19.0,446,2.0,438
243,86,151,41.37795918367347,42.42285714285715,34.0,35.0,79,1.0,65
244,86,73,41.37795918367347,43.37487528344671,34.0,30.0,87,2.0,13
245,86,216,41.37795918367347,42.399637188208615,34.0,31.0,137,1.0,130
246,86,218,41.37795918367347,43.42131519274376,34.0,25.0,159,2.0,132
247,86,550,41.37795918367347,42.86403628117914,34.0,22.0,468,1.0,464
248,86,475,41.37795918367347,43.37487528344671,34.0,19.0,398,2.0,389
249,151,193,42.42285714285715,44.74485260770975,35.0,36.0,108,2.0,42
250,151,256,42.42285714285715,44.93061224489796,35.0,29.0,151,3.0,105
251,151,444,42.42285714285715,44.93061224489796,35.0,22.0,312,3.0,293
252,151,616,42.42285714285715,43.88571428571429,35.0,20.0,469,1.0,465
253,151,616,42.42285714285715,44.141133786848066,35.0,20.0,471,2.0,465
254,73,193,43.37487528344671,44.74485260770975,30.0,36.0,134,1.0,120
255,73,174,43.37487528344671,45.441451247165524,30.0,36.0,135,2.0,101
256,73,192,43.37487528344671,46.25414965986395,30.0,34.0,172,3.0,119
257,73,256,43.37487528344671,44.93061224489796,30.0,29.0,195,2.0,183
258,73,256,43.37487528344671,45.46467120181406,30.0,31.0,204,2.0,183
259,73,214,43.37487528344671,46.18448979591837,30.0,33.0,186,3.0,141
260,73,444,43.37487528344671,44.93061224489796,30.0,22.0,377,2.0,371
261,193,192,44.74485260770975,46.25414965986395,36.0,34.0,65,2.0,1
262,193,65,44.74485260770975,47.043628117913826,36.0,30.0,162,2.0,128
263,193,214,44.74485260770975,46.18448979591837,36.0,33.0,65,1.0,21
264,193,256,44.74485260770975,46.997188208616784,36.0,27.0,116,2.0,63
265,193,444,44.74485260770975,46.973968253968245,36.0,22.0,269,2.0,251
266,193,420,44.74485260770975,46.997188208616784,36.0,22.0,247,2.0,227
267,193,616,44.74485260770975,46.20770975056689,36.0,18.0,428,1.0,423
268,174,65,45.441451247165524,47.043628117913826,36.0,30.0,129,2.0,109
269,174,256,45.441451247165524,46.997188208616784,36.0,27.0,106,2.0,82
270,174,444,45.441451247165524,46.973968253968245,36.0,22.0,278,2.0,270
271,174,420,45.441451247165524,46.997188208616784,36.0,22.0,255,2.0,246
272,174,504,45.441451247165524,47.9956462585034,36.0,20.0,348,3.0,330
273,174,616,45.441451247165524,47.74022675736961,36.0,20.0,453,2.0,442
274,174,616,45.441451247165524,48.251065759637186,36.0,21.0,458,3.0,442
275,192,65,46.25414965986395,48.76190476190477,34.0,28.0,167,3.0,127
276,192,211,46.25414965986395,48.76190476190477,34.0,29.0,110,3.0,19
277,192,504,46.25414965986395,47.9956462585034,34.0,20.0,321,2.0,312
278,192,480,46.25414965986395,49.040544217687085,34.0,21.0,312,3.0,288
279,192,616,46.25414965986395,47.74022675736961,34.0,20.0,429,1.0,424
280,192,616,46.25414965986395,48.251065759637186,34.0,21.0,433,2.0,424
281,65,174,47.043628117913826,49.574603174603176,30.0,33.0,154,3.0,109
282,65,211,47.043628117913826,48.76190476190477,30.0,29.0,164,2.0,146
283,65,255,47.043628117913826,49.574603174603176,30.0,29.0,219,3.0,190
284,65,480,47.043628117913826,49.040544217687085,30.0,21.0,424,2.0,415
285,65,175,48.76190476190477,50.596281179138316,28.0,34.0,135,2.0,110
286,65,203,48.76190476190477,51.641179138322,28.0,37.0,186,3.0,138
287,65,231,48.76190476190477,50.642721088435366,28.0,32.0,185,2.0,166
288,65,562,48.76190476190477,50.10866213151928,28.0,24.0,500,1.0,497
289,65,475,48.76190476190477,51.083900226757365,28.0,23.0,422,2.0,410
290,174,175,49.574603174603176,50.596281179138316,33.0,34.0,44,1.0,1
291,174,203,49.574603174603176,51.641179138322,33.0,37.0,94,2.0,29
292,174,146,49.574603174603176,52.22167800453515,33.0,28.0,117,3.0,28
293,174,231,49.574603174603176,50.642721088435366,33.0,32.0,73,1.0,57
294,174,231,49.574603174603176,51.85015873015873,33.0,34.0,113,2.0,57
295,174,243,49.574603174603176,52.19845804988664,33.0,33.0,132,3.0,69
296,174,475,49.574603174603176,51.083900226757365,33.0,23.0,308,2.0,301
297,174,616,49.574603174603176,51.06068027210885,33.0,18.0,447,1.0,442
298,174,616,49.574603174603176,52.36099773242631,33.0,19.0,458,3.0,442
299,175,203,50.596281179138316,51.641179138322,34.0,37.0,53,1.0,28
300,175,146,50.596281179138316,52.22167800453515,34.0,28.0,76,2.0,29
301,175,151,50.596281179138316,53.52199546485261,34.0,32.0,128,3.0,24
302,175,231,50.596281179138316,51.85015873015873,34.0,34.0,78,1.0,56
303,175,243,50.596281179138316,52.19845804988664,34.0,33.0,97,2.0,68
304,175,487,50.596281179138316,52.96471655328799,34.0,20.0,328,2.0,312
305,175,446,50.596281179138316,53.12725623582767,34.0,22.0,292,3.0,271
306,175,616,50.596281179138316,52.36099773242631,34.0,19.0,448,2.0,441
307,203,151,51.641179138322,53.52199546485261,37.0,32.0,96,2.0,52
308,203,216,51.641179138322,53.916734693877544,37.0,32.0,99,2.0,13
309,203,233,51.641179138322,54.00961451247166,37.0,29.0,106,2.0,30
310,203,487,51.641179138322,52.96471655328799,37.0,20.0,290,1.0,284
311,203,446,51.641179138322,53.12725623582767,37.0,22.0,251,1.0,243
312,203,616,51.641179138322,53.89351473922903,37.0,20.0,424,2.0,413
313,146,151,52.22167800453515,53.52199546485261,28.0,32.0,56,1.0,5
314,146,66,52.22167800453515,54.706213151927436,28.0,35.0,134,2.0,80
315,146,216,52.22167800453515,53.916734693877544,28.0,32.0,101,2.0,70
316,146,233,52.22167800453515,54.00961451247166,28.0,29.0,116,2.0,87
317,146,476,52.22167800453515,54.659773242630386,28.0,19.0,346,2.0,330
318,146,550,52.22167800453515,55.17061224489796,28.0,23.0,423,3.0,404
319,146,616,52.22167800453515,53.89351473922903,28.0,20.0,475,2.0,470
320,146,616,52.22167800453515,54.91519274376417,28.0,21.0,484,3.0,470
321,151,66,53.52199546485261,54.706213151927436,32.0,35.0,99,1.0,85
322,151,155,53.52199546485261,55.727891156462576,32.0,29.0,95,2.0,4
323,151,80,53.52199546485261,56.28517006802721,32.0,32.0,139,3.0,71
324,151,242,53.52199546485261,55.751111111111115,32.0,30.0,132,2.0,91
325,151,246,53.52199546485261,56.21551020408163,32.0,25.0,150,3.0,95
326,151,476,53.52199546485261,54.659773242630386,32.0,19.0,329,1.0,325
327,151,550,53.52199546485261,55.17061224489796,32.0,23.0,405,2.0,399
328,151,616,53.52199546485261,54.91519274376417,32.0,21.0,469,1.0,465
329,151,616,53.52199546485261,55.93687074829932,32.0,20.0,476,2.0,465
330,151,616,53.52199546485261,56.4477097505669,32.0,24.0,482,3.0,465
331,66,155,54.706213151927436,55.727891156462576,35.0,29.0,99,1.0,89
332,66,80,54.706213151927436,56.28517006802721,35.0,32.0,69,2.0,14
333,66,242,54.706213151927436,55.751111111111115,35.0,30.0,182,1.0,176
334,66,246,54.706213151927436,56.21551020408163,35.0,25.0,191,2.0,180
335,66,444,54.706213151927436,57.23718820861678,35.0,22.0,393,3.0,378
336,155,185,55.727891156462576,57.74802721088435,29.0,27.0,92,2.0,30
337,155,242,55.727891156462576,57.771247165532884,29.0,30.0,124,2.0,87
338,155,243,55.727891156462576,58.53750566893424,29.0,29.0,150,3.0,88
339,155,581,55.727891156462576,56.796009070294794,29.0,20.0,428,1.0,426
340,155,444,55.727891156462576,57.23718820861678,29.0,22.0,296,2.0,289
341,155,562,55.727891156462576,58.35174603174603,29.0,23.0,422,3.0,407
342,155,616,55.727891156462576,57.72480725623583,29.0,20.0,469,2.0,461
343,155,616,55.727891156462576,58.00344671201814,29.0,18.0,471,2.0,461
344,80,185,56.28517006802721,57.74802721088435,32.0,27.0,122,1.0,105
345,80,81,56.28517006802721,58.79292517006804,32.0,34.0,108,3.0,1
346,80,242,56.28517006802721,57.771247165532884,32.0,30.0,174,1.0,162
347,80,243,56.28517006802721,58.53750566893424,32.0,29.0,190,2.0,163
348,80,562,56.28517006802721,58.35174603174603,32.0,23.0,490,2.0,482
349,185,81,57.74802721088435,58.79292517006804,27.0,34.0,113,1.0,104
350,185,77,57.74802721088435,59.41986394557824,27.0,28.0,130,2.0,108
351,185,242,57.74802721088435,59.86104308390022,27.0,36.0,107,2.0,57
352,185,480,57.74802721088435,59.28054421768707,27.0,22.0,302,2.0,295
353,185,616,57.74802721088435,59.025124716553286,27.0,20.0,434,1.0,431
354,81,242,58.79292517006804,59.86104308390022,34.0,36.0,167,1.0,161
355,257,174,1.9504761904761905,3.43655328798186,25.0,28.0,105,1.0,83
356,257,259,1.9504761904761905,3.2043537414965986,25.0,27.0,54,1.0,2
357,257,256,1.9504761904761905,4.435011337868481,25.0,41.0,107,2.0,1
358,257,450,1.9504761904761905,3.3668934240362813,25.0,14.0,202,1.0,193
359,257,410,1.9504761904761905,4.435011337868481,25.0,17.0,187,2.0,153
360,257,615,1.9504761904761905,4.435011337868481,25.0,7.0,374,2.0,358
361,261,145,2.786394557823129,4.96907029478458,28.0,33.0,149,2.0,116
362,261,146,2.786394557823129,4.992290249433106,28.0,32.0,149,2.0,115
363,261,256,2.786394557823129,4.435011337868481,28.0,41.0,71,2.0,5
364,261,242,2.786394557823129,4.992290249433106,28.0,16.0,97,2.0,19
365,261,410,2.786394557823129,4.435011337868481,28.0,17.0,165,2.0,149
366,261,532,2.786394557823129,4.992290249433106,28.0,2.0,287,2.0,271
367,261,615,2.786394557823129,4.435011337868481,28.0,7.0,361,2.0,354
368,259,145,3.2043537414965986,4.96907029478458,27.0,33.0,137,2.0,114
369,259,146,3.2043537414965986,4.992290249433106,27.0,32.0,137,2.0,113
370,259,256,3.2043537414965986,4.435011337868481,27.0,41.0,53,1.0,3
371,259,242,3.2043537414965986,4.992290249433106,27.0,16.0,79,2.0,17
372,259,410,3.2043537414965986,4.435011337868481,27.0,17.0,160,1.0,151
373,259,532,3.2043537414965986,4.992290249433106,27.0,2.0,284,2.0,273
374,259,615,3.2043537414965986,4.435011337868481,27.0,7.0,360,1.0,356
375,256,194,4.435011337868481,6.524807256235827,41.0,25.0,109,2.0,62
376,256,146,4.435011337868481,7.058866213151928,41.0,28.0,158,3.0,110
377,256,242,4.435011337868481,6.524807256235827,41.0,37.0,91,2.0,14
378,256,255,4.435011337868481,6.9892063492063485,41.0,13.0,110,3.0,1
379,256,485,4.435011337868481,6.5015873015873025,41.0,18.0,246,2.0,229
380,242,194,4.992290249433106,6.524807256235827,16.0,25.0,82,2.0,48
381,242,146,4.992290249433106,7.058866213151928,16.0,28.0,131,2.0,96
382,242,255,4.992290249433106,6.9892063492063485,16.0,13.0,87,2.0,13
383,242,485,4.992290249433106,6.5015873015873025,16.0,18.0,252,2.0,243
384,242,49,6.524807256235827,8.544943310657597,37.0,24.0,212,2.0,193
385,242,146,6.524807256235827,9.102222222222222,37.0,29.0,147,3.0,96
386,242,485,6.524807256235827,8.568163265306122,37.0,18.0,258,2.0,243
387,255,49,6.9892063492063485,8.544943310657597,13.0,24.0,217,2.0,206
388,255,146,6.9892063492063485,9.102222222222222,13.0,29.0,142,2.0,109
389,255,242,6.9892063492063485,8.568163265306122,13.0,37.0,69,2.0,13
390,255,239,6.9892063492063485,9.729160997732428,13.0,16.0,119,3.0,16
391,255,485,6.9892063492063485,8.568163265306122,13.0,18.0,240,2.0,230
392,255,519,6.9892063492063485,9.636281179138322,13.0,6.0,288,3.0,264
393,242,194,8.568163265306122,10.611519274376418,37.0,30.0,100,2.0,48
394,242,146,8.568163265306122,11.168798185941043,37.0,30.0,148,3.0,96
395,242,239,8.568163265306122,9.729160997732428,37.0,16.0,50,1.0,3
396,242,261,8.568163265306122,11.099138321995463,37.0,22.0,111,3.0,19
397,242,519,8.568163265306122,9.636281179138322,37.0,6.0,281,1.0,277
398,242,485,8.568163265306122,10.611519274376418,37.0,23.0,258,2.0,243
399,239,146,9.729160997732428,11.168798185941043,16.0,30.0,112,1.0,93
400,239,194,9.729160997732428,12.67809523809524,16.0,25.0,135,3.0,45
401,239,261,9.729160997732428,11.099138321995463,16.0,22.0,63,1.0,22
402,239,242,9.729160997732428,12.67809523809524,16.0,38.0,127,3.0,3
403,239,453,9.729160997732428,11.58675736961451,16.0,10.0,228,2.0,214
404,239,485,9.729160997732428,12.67809523809524,16.0,19.0,277,3.0,246
405,242,194,10.611519274376418,12.67809523809524,40.0,25.0,101,2.0,48
406,242,86,10.611519274376418,13.188934240362814,40.0,32.0,191,3.0,156
407,242,485,10.611519274376418,12.67809523809524,40.0,19.0,259,2.0,243
408,242,456,10.611519274376418,13.212154195011339,40.0,4.0,242,3.0,214
409,261,194,11.099138321995463,12.67809523809524,22.0,25.0,95,2.0,67
410,261,86,11.099138321995463,13.188934240362814,22.0,32.0,197,2.0,175
411,261,242,11.099138321995463,12.67809523809524,22.0,38.0,71,2.0,19
412,261,355,11.099138321995463,13.839092970521545,22.0,13.0,151,3.0,94
413,261,485,11.099138321995463,12.67809523809524,22.0,19.0,234,2.0,224
414,261,456,11.099138321995463,13.212154195011339,22.0,4.0,215,2.0,195
415,242,87,12.67809523809524,14.466031746031744,38.0,22.0,173,2.0,155
416,242,146,12.67809523809524,15.278730158730161,38.0,28.0,148,3.0,96
417,242,355,12.67809523809524,13.839092970521545,38.0,13.0,124,1.0,113
418,242,231,12.67809523809524,15.278730158730161,38.0,12.0,113,3.0,11
419,242,485,12.67809523809524,14.721451247165533,38.0,18.0,258,2.0,243
420,355,146,13.839092970521545,15.278730158730161,13.0,28.0,218,1.0,209
421,355,151,13.839092970521545,16.76480725623583,13.0,35.0,240,3.0,204
422,355,231,13.839092970521545,15.278730158730161,13.0,12.0,139,1.0,124
423,355,256,13.839092970521545,16.76480725623583,13.0,33.0,160,3.0,99
424,355,542,13.839092970521545,16.741587301587302,13.0,13.0,225,3.0,187
425,242,151,14.721451247165533,16.76480725623583,35.0,35.0,127,2.0,91
426,242,256,14.721451247165533,16.76480725623583,35.0,33.0,89,2.0,14
427,242,542,14.721451247165533,16.741587301587302,35.0,13.0,312,2.0,300
428,242,562,14.721451247165533,17.22920634920635,35.0,26.0,338,3.0,320
429,242,616,14.721451247165533,16.904126984126986,35.0,10.0,386,2.0,374
430,242,616,14.721451247165533,17.22920634920635,35.0,17.0,389,3.0,374
431,231,151,15.278730158730161,16.76480725623583,12.0,35.0,102,1.0,80
432,231,66,15.278730158730161,17.740045351473924,12.0,31.0,196,2.0,165
433,231,256,15.278730158730161,16.76480725623583,12.0,33.0,69,1.0,25
434,231,239,15.278730158730161,17.76326530612245,12.0,27.0,107,2.0,8
435,231,542,15.278730158730161,16.741587301587302,12.0,13.0,317,1.0,311
436,231,562,15.278730158730161,17.22920634920635,12.0,26.0,341,2.0,331
437,231,445,15.278730158730161,18.250884353741494,12.0,23.0,249,3.0,214
438,231,616,15.278730158730161,16.904126984126986,12.0,10.0,391,2.0,385
439,231,616,15.278730158730161,17.22920634920635,12.0,17.0,394,2.0,385
440,231,615,15.278730158730161,18.22766439909297,12.0,18.0,404,3.0,384
441,256,65,16.76480725623583,18.29732426303855,33.0,32.0,202,2.0,191
442,256,68,16.76480725623583,19.295782312925173,33.0,30.0,217,3.0,188
443,256,237,16.76480725623583,18.29732426303855,33.0,29.0,69,2.0,19
444,256,231,16.76480725623583,19.040362811791386,33.0,29.0,101,2.0,25
445,256,445,16.76480725623583,18.250884353741494,33.0,23.0,200,1.0,189
446,256,615,16.76480725623583,18.22766439909297,33.0,18.0,364,1.0,359
447,256,616,16.76480725623583,19.527981859410428,33.0,19.0,379,3.0,360
448,239,68,17.76326530612245,19.295782312925173,27.0,30.0,183,2.0,171
449,239,65,17.76326530612245,20.387120181405894,27.0,33.0,207,3.0,174
450,239,231,17.76326530612245,19.040362811791386,27.0,29.0,56,1.0,8
451,239,241,17.76326530612245,20.31746031746032,27.0,31.0,110,3.0,2
452,239,530,17.76326530612245,19.87628117913832,27.0,21.0,305,2.0,291
453,239,480,17.76326530612245,20.31746031746032,27.0,22.0,265,3.0,241
454,239,616,17.76326530612245,19.527981859410428,27.0,19.0,385,2.0,377
455,237,65,18.29732426303855,20.387120181405894,29.0,33.0,194,2.0,172
456,237,241,18.29732426303855,20.31746031746032,29.0,31.0,87,2.0,4
457,237,530,18.29732426303855,19.87628117913832,29.0,21.0,301,2.0,293
458,237,480,18.29732426303855,20.31746031746032,29.0,22.0,258,2.0,243
459,237,561,18.29732426303855,21.08371882086168,29.0,20.0,346,3.0,324
460,237,616,18.29732426303855,19.527981859410428,29.0,19.0,383,1.0,379
461,237,616,18.29732426303855,20.80507936507936,29.0,16.0,394,3.0,379
462,237,616,18.29732426303855,21.060498866213152,29.0,20.0,397,3.0,379
463,231,65,19.040362811791386,20.387120181405894,29.0,33.0,176,1.0,166
464,231,201,19.040362811791386,21.84997732426304,29.0,30.0,125,3.0,30
465,231,241,19.040362811791386,20.31746031746032,29.0,31.0,56,1.0,10
466,231,480,19.040362811791386,20.31746031746032,29.0,22.0,255,1.0,249
467,231,561,19.040362811791386,21.08371882086168,29.0,20.0,342,2.0,330
468,231,616,19.040362811791386,20.80507936507936,29.0,16.0,392,2.0,385
469,231,616,19.040362811791386,21.060498866213152,29.0,20.0,395,2.0,385
470,241,201,20.31746031746032,21.84997732426304,31.0,30.0,77,2.0,40
471,241,77,20.31746031746032,22.430476190476192,31.0,28.0,188,2.0,164
472,241,231,20.31746031746032,21.89641723356009,31.0,34.0,69,2.0,10
473,241,242,20.31746031746032,22.360816326530614,31.0,30.0,88,2.0,1
474,241,480,20.31746031746032,22.360816326530614,31.0,23.0,255,2.0,239
475,241,561,20.31746031746032,23.12707482993197,31.0,20.0,342,3.0,320
476,241,616,20.31746031746032,22.6162358276644,31.0,18.0,388,2.0,375
477,241,616,20.31746031746032,23.12707482993197,31.0,19.0,394,3.0,375
478,231,195,21.89641723356009,23.40571428571429,34.0,36.0,74,2.0,36
479,231,77,21.89641723356009,23.986213151927444,34.0,24.0,178,2.0,154
480,231,218,21.89641723356009,23.45215419501134,34.0,37.0,68,2.0,13
481,231,561,21.89641723356009,23.12707482993197,34.0,20.0,334,1.0,330
482,231,480,21.89641723356009,24.427392290249433,34.0,21.0,272,3.0,249
483,231,616,21.89641723356009,23.12707482993197,34.0,19.0,389,1.0,385
484,242,195,22.360816326530614,23.40571428571429,30.0,36.0,65,1.0,47
485,242,77,22.360816326530614,23.986213151927444,30.0,24.0,179,2.0,165
486,242,218,22.360816326530614,23.45215419501134,30.0,37.0,53,1.0,24
487,242,256,22.360816326530614,24.96145124716553,30.0,35.0,113,3.0,14
488,242,256,22.360816326530614,24.98467120181406,30.0,30.0,114,3.0,14
489,242,480,22.360816326530614,24.427392290249433,30.0,21.0,254,2.0,238
490,242,616,22.360816326530614,24.91501133786848,30.0,20.0,390,3.0,374
491,242,616,22.360816326530614,25.17043083900227,30.0,21.0,393,3.0,374
492,218,76,23.45215419501134,25.58839002267574,37.0,33.0,169,2.0,142
493,218,180,23.45215419501134,26.23854875283447,37.0,36.0,126,3.0,38
494,218,256,23.45215419501134,24.96145124716553,37.0,35.0,75,2.0,38
495,218,256,23.45215419501134,24.98467120181406,37.0,30.0,76,2.0,38
496,218,562,23.45215419501134,25.44907029478458,37.0,30.0,355,2.0,344
497,218,616,23.45215419501134,24.91501133786848,37.0,20.0,403,1.0,398
498,218,616,23.45215419501134,25.17043083900227,37.0,21.0,405,2.0,398
499,218,616,23.45215419501134,26.19210884353741,37.0,21.0,415,3.0,398
500,256,180,24.96145124716553,26.23854875283447,35.0,36.0,94,1.0,76
501,256,204,24.96145124716553,27.53886621315193,35.0,36.0,123,3.0,52
502,256,218,24.96145124716553,26.563628117913836,35.0,33.0,79,2.0,38
503,256,231,24.96145124716553,27.771065759637192,35.0,40.0,124,3.0,25
504,256,480,24.96145124716553,26.47074829931973,35.0,22.0,233,2.0,224
505,256,562,24.96145124716553,26.981587301587304,35.0,20.0,318,2.0,306
506,256,616,24.96145124716553,26.19210884353741,35.0,21.0,364,1.0,360
507,256,616,24.96145124716553,27.21378684807256,35.0,19.0,373,2.0,360
508,256,180,24.98467120181406,26.23854875283447,30.0,36.0,93,1.0,76
509,256,204,24.98467120181406,27.53886621315193,30.0,36.0,122,3.0,52
510,256,218,24.98467120181406,26.563628117913836,30.0,33.0,78,2.0,38
511,256,231,24.98467120181406,27.771065759637192,30.0,40.0,123,3.0,25
512,256,480,24.98467120181406,26.47074829931973,30.0,22.0,233,1.0,224
513,256,562,24.98467120181406,26.981587301587304,30.0,20.0,318,2.0,306
514,256,616,24.98467120181406,26.19210884353741,30.0,21.0,364,1.0,360
515,256,616,24.98467120181406,27.21378684807256,30.0,19.0,373,2.0,360
516,218,197,26.563628117913836,28.51410430839002,33.0,29.0,87,2.0,21
517,218,231,26.563628117913836,27.771065759637192,33.0,40.0,54,1.0,13
518,218,256,26.563628117913836,28.11936507936508,33.0,37.0,77,2.0,38
519,218,255,26.563628117913836,29.071383219954647,33.0,33.0,114,3.0,37
520,218,550,26.563628117913836,28.51410430839002,33.0,21.0,342,2.0,332
521,218,561,26.563628117913836,29.0249433106576,33.0,20.0,359,2.0,343
522,218,616,26.563628117913836,28.328344671201812,33.0,17.0,405,2.0,398
523,218,616,26.563628117913836,29.280362811791388,33.0,21.0,415,3.0,398
524,231,77,27.771065759637192,29.69832199546485,40.0,31.0,175,2.0,154
525,231,255,27.771065759637192,29.071383219954647,40.0,33.0,61,1.0,24
526,231,219,27.771065759637192,30.557460317460322,40.0,36.0,121,3.0,12
527,231,561,27.771065759637192,29.0249433106576,40.0,20.0,334,1.0,330
528,231,550,27.771065759637192,30.557460317460322,40.0,23.0,341,3.0,319
529,231,616,27.771065759637192,29.280362811791388,40.0,21.0,390,2.0,385
530,231,616,27.771065759637192,30.04662131519275,40.0,19.0,397,2.0,385
531,256,77,28.11936507936508,29.69832199546485,37.0,31.0,191,2.0,179
532,256,195,28.11936507936508,30.83609977324263,37.0,27.0,132,3.0,61
533,256,219,28.11936507936508,30.557460317460322,37.0,36.0,111,2.0,37
534,256,550,28.11936507936508,30.557460317460322,37.0,23.0,312,2.0,294
535,256,616,28.11936507936508,29.280362811791388,37.0,21.0,363,1.0,360
536,256,616,28.11936507936508,30.04662131519275,37.0,19.0,369,2.0,360
537,255,195,29.071383219954647,30.83609977324263,33.0,27.0,97,2.0,60
538,255,204,29.071383219954647,31.579138321995462,33.0,29.0,119,3.0,51
539,255,219,29.071383219954647,30.557460317460322,33.0,36.0,73,1.0,36
540,255,232,29.071383219954647,31.74167800453515,33.0,36.0,117,3.0,23
541,255,550,29.071383219954647,30.557460317460322,33.0,23.0,302,1.0,295
542,255,411,29.071383219954647,31.579138321995462,33.0,23.0,190,3.0,156
543,255,411,29.071383219954647,32.04353741496599,33.0,25.0,202,3.0,156
544,255,616,29.071383219954647,31.32371882086168,33.0,19.0,374,2.0,361
545,219,204,30.557460317460322,31.579138321995462,36.0,29.0,46,1.0,15
546,219,200,30.557460317460322,32.624036281179144,36.0,22.0,91,2.0,19
547,219,232,30.557460317460322,31.74167800453515,36.0,36.0,53,1.0,13
548,219,244,30.557460317460322,32.48471655328798,36.0,37.0,87,2.0,25
549,219,255,30.557460317460322,33.158095238095235,36.0,35.0,118,3.0,36
550,219,411,30.557460317460322,31.579138321995462,36.0,23.0,197,1.0,192
551,219,411,30.557460317460322,32.04353741496599,36.0,25.0,202,1.0,192
552,219,489,30.557460317460322,33.2974149659864,36.0,27.0,295,3.0,270
553,219,616,30.557460317460322,32.43827664399093,36.0,17.0,405,2.0,397
554,219,616,30.557460317460322,33.111655328798186,36.0,20.0,412,3.0,397
555,232,151,31.74167800453515,33.715374149659866,36.0,32.0,117,2.0,81
556,232,195,31.74167800453515,34.22621315192744,36.0,40.0,113,2.0,37
557,232,255,31.74167800453515,33.158095238095235,36.0,35.0,65,1.0,23
558,232,215,31.74167800453515,34.29587301587301,36.0,32.0,111,3.0,17
559,232,489,31.74167800453515,33.2974149659864,36.0,27.0,266,2.0,257
560,232,550,31.74167800453515,34.66739229024943,36.0,20.0,342,3.0,318
561,232,616,31.74167800453515,33.111655328798186,36.0,20.0,389,1.0,384
562,232,616,31.74167800453515,34.411972789115644,36.0,18.0,401,3.0,384
563,244,151,32.48471655328798,33.715374149659866,37.0,32.0,107,1.0,93
564,244,195,32.48471655328798,34.22621315192744,37.0,40.0,90,2.0,49
565,244,65,32.48471655328798,35.085351473922906,37.0,33.0,211,3.0,179
566,244,215,32.48471655328798,34.29587301587301,37.0,32.0,83,2.0,29
567,244,550,32.48471655328798,34.66739229024943,37.0,20.0,320,2.0,306
568,244,616,32.48471655328798,34.411972789115644,37.0,18.0,381,2.0,372
569,255,195,33.158095238095235,34.22621315192744,35.0,40.0,76,1.0,60
570,255,65,33.158095238095235,35.085351473922906,35.0,33.0,207,2.0,190
571,255,215,33.158095238095235,34.29587301587301,35.0,32.0,63,1.0,40
572,255,235,33.158095238095235,35.71229024943311,35.0,29.0,112,3.0,20
573,255,550,33.158095238095235,34.66739229024943,35.0,20.0,302,2.0,295
574,255,561,33.158095238095235,35.94448979591837,35.0,19.0,329,3.0,306
575,255,616,33.158095238095235,34.411972789115644,35.0,18.0,365,1.0,361
576,255,616,33.158095238095235,35.94448979591837,35.0,20.0,380,3.0,361
577,215,188,34.29587301587301,36.269569160997726,32.0,33.0,89,2.0,27
578,215,235,34.29587301587301,35.71229024943311,32.0,29.0,64,1.0,20
579,215,224,34.29587301587301,36.73396825396826,32.0,28.0,105,2.0,9
580,215,256,34.29587301587301,37.26802721088436,32.0,29.0,134,3.0,41
581,215,561,34.29587301587301,35.94448979591837,32.0,19.0,353,2.0,346
582,215,480,34.29587301587301,36.73396825396826,32.0,22.0,285,2.0,265
583,215,426,34.29587301587301,37.198367346938774,32.0,24.0,245,3.0,211
584,215,616,34.29587301587301,35.94448979591837,32.0,20.0,407,2.0,401
585,215,616,34.29587301587301,36.966167800453526,32.0,20.0,417,3.0,401
586,235,66,35.71229024943311,37.29124716553289,29.0,31.0,182,2.0,169
587,235,194,35.71229024943311,38.35936507936508,29.0,39.0,121,3.0,41
588,235,224,35.71229024943311,36.73396825396826,29.0,28.0,45,1.0,11
589,235,256,35.71229024943311,37.26802721088436,29.0,29.0,70,2.0,21
590,235,237,35.71229024943311,38.38258503401361,29.0,31.0,115,3.0,2
591,235,480,35.71229024943311,36.73396825396826,29.0,22.0,249,1.0,245
592,235,426,35.71229024943311,37.198367346938774,29.0,24.0,201,1.0,191
593,235,616,35.71229024943311,36.966167800453526,29.0,20.0,385,1.0,381
594,235,616,35.71229024943311,37.47700680272109,29.0,20.0,389,2.0,381
595,235,616,35.71229024943311,38.24326530612245,29.0,20.0,396,3.0,381
596,224,194,36.73396825396826,38.35936507936508,28.0,39.0,76,2.0,30
597,224,65,36.73396825396826,39.68290249433107,28.0,26.0,203,3.0,159
598,224,237,36.73396825396826,38.38258503401361,28.0,31.0,72,2.0,13
599,224,480,36.73396825396826,38.777324263038544,28.0,23.0,271,2.0,256
600,224,616,36.73396825396826,38.24326530612245,28.0,20.0,397,2.0,392
601,256,194,37.26802721088436,38.35936507936508,29.0,39.0,78,1.0,62
602,256,65,37.26802721088436,39.68290249433107,29.0,26.0,217,2.0,191
603,256,237,37.26802721088436,38.38258503401361,29.0,31.0,52,1.0,19
604,256,239,37.26802721088436,39.845442176870755,29.0,27.0,112,3.0,17
605,256,480,37.26802721088436,38.777324263038544,29.0,23.0,233,2.0,224
606,256,612,37.26802721088436,39.77578231292517,29.0,20.0,372,3.0,356
607,256,616,37.26802721088436,39.77578231292517,29.0,21.0,376,3.0,360
608,256,616,37.26802721088436,40.03120181405896,29.0,20.0,379,3.0,360
609,237,65,38.38258503401361,39.68290249433107,31.0,26.0,181,1.0,172
610,237,178,38.38258503401361,40.61170068027211,31.0,31.0,113,2.0,59
611,237,239,38.38258503401361,39.845442176870755,31.0,27.0,63,1.0,2
612,237,256,38.38258503401361,40.82068027210885,31.0,28.0,107,2.0,19
613,237,612,38.38258503401361,39.77578231292517,31.0,20.0,380,1.0,375
614,237,444,38.38258503401361,40.82068027210885,31.0,21.0,232,2.0,207
615,237,616,38.38258503401361,39.77578231292517,31.0,21.0,384,1.0,379
616,237,616,38.38258503401361,40.03120181405896,31.0,20.0,386,2.0,379
617,237,616,38.38258503401361,41.33151927437642,31.0,21.0,400,3.0,379
618,239,86,39.845442176870755,41.37795918367347,27.0,34.0,167,2.0,153
619,239,151,39.845442176870755,42.42285714285715,27.0,35.0,142,3.0,88
620,239,256,39.845442176870755,41.37795918367347,27.0,32.0,68,2.0,17
621,239,216,39.845442176870755,42.399637188208615,27.0,31.0,112,3.0,23
622,239,528,39.845442176870755,41.865578231292524,27.0,22.0,302,2.0,289
623,239,616,39.845442176870755,41.33151927437642,27.0,21.0,382,1.0,377
624,239,616,39.845442176870755,42.60861678004535,27.0,19.0,395,3.0,377
625,256,151,40.82068027210885,42.42285714285715,28.0,35.0,126,2.0,105
626,256,73,40.82068027210885,43.37487528344671,28.0,30.0,214,3.0,183
627,256,216,40.82068027210885,42.399637188208615,28.0,31.0,79,2.0,40
628,256,218,40.82068027210885,43.42131519274376,28.0,25.0,118,3.0,38
629,256,528,40.82068027210885,41.865578231292524,28.0,22.0,276,1.0,272
630,256,550,40.82068027210885,42.86403628117914,28.0,22.0,307,2.0,294
631,256,475,40.82068027210885,43.37487528344671,28.0,19.0,245,3.0,219
632,256,616,40.82068027210885,42.60861678004535,28.0,19.0,368,2.0,360
633,256,151,41.37795918367347,42.42285714285715,32.0,35.0,114,1.0,105
634,256,73,41.37795918367347,43.37487528344671,32.0,30.0,202,2.0,183
635,256,216,41.37795918367347,42.399637188208615,32.0,31.0,59,1.0,40
636,256,218,41.37795918367347,43.42131519274376,32.0,25.0,96,2.0,38
637,256,550,41.37795918367347,42.86403628117914,32.0,22.0,301,1.0,294
638,256,475,41.37795918367347,43.37487528344671,32.0,19.0,235,2.0,219
639,256,616,41.37795918367347,42.60861678004535,32.0,19.0,364,1.0,360
640,256,616,41.37795918367347,43.88571428571429,32.0,20.0,376,3.0,360
641,256,616,41.37795918367347,44.141133786848066,32.0,20.0,379,3.0,360
642,216,193,42.399637188208615,44.74485260770975,31.0,36.0,104,2.0,23
643,216,218,42.399637188208615,43.42131519274376,31.0,25.0,44,1.0,2
644,216,256,42.399637188208615,44.93061224489796,31.0,29.0,116,3.0,40
645,216,444,42.399637188208615,44.93061224489796,31.0,22.0,253,3.0,228
646,216,616,42.399637188208615,43.88571428571429,31.0,20.0,405,1.0,400
647,216,616,42.399637188208615,44.141133786848066,31.0,20.0,407,2.0,400
648,218,193,43.42131519274376,44.74485260770975,25.0,36.0,62,1.0,25
649,218,174,43.42131519274376,45.441451247165524,25.0,36.0,97,2.0,44
650,218,192,43.42131519274376,46.25414965986395,25.0,34.0,125,3.0,26
651,218,256,43.42131519274376,44.93061224489796,25.0,29.0,75,2.0,38
652,218,256,43.42131519274376,45.46467120181406,25.0,31.0,96,2.0,38
653,218,214,43.42131519274376,46.18448979591837,25.0,33.0,119,3.0,4
654,218,444,43.42131519274376,44.93061224489796,25.0,22.0,235,2.0,226
655,218,612,43.42131519274376,45.41823129251701,25.0,18.0,403,2.0,394
656,218,616,43.42131519274376,45.41823129251701,25.0,19.0,407,2.0,398
657,218,616,43.42131519274376,46.20770975056689,25.0,18.0,416,3.0,398
658,256,192,44.93061224489796,46.25414965986395,29.0,34.0,86,1.0,64
659,256,65,44.93061224489796,47.043628117913826,29.0,30.0,212,2.0,191
660,256,214,44.93061224489796,46.18448979591837,29.0,33.0,68,1.0,42
661,256,444,44.93061224489796,46.973968253968245,29.0,22.0,208,2.0,188
662,256,420,44.93061224489796,46.997188208616784,29.0,22.0,187,2.0,164
663,256,616,44.93061224489796,46.20770975056689,29.0,18.0,364,1.0,360
664,256,616,44.93061224489796,47.74022675736961,29.0,20.0,380,3.0,360
665,256,65,45.46467120181406,47.043628117913826,31.0,30.0,203,2.0,191
666,256,444,45.46467120181406,46.973968253968245,31.0,22.0,199,2.0,188
667,256,420,45.46467120181406,46.997188208616784,31.0,22.0,177,2.0,164
668,256,504,45.46467120181406,47.9956462585034,31.0,20.0,271,3.0,248
669,256,616,45.46467120181406,47.74022675736961,31.0,20.0,373,2.0,360
670,256,616,45.46467120181406,48.251065759637186,31.0,21.0,379,3.0,360
671,214,65,46.18448979591837,48.76190476190477,33.0,28.0,186,3.0,149
672,214,211,46.18448979591837,48.76190476190477,33.0,29.0,111,3.0,3
673,214,504,46.18448979591837,47.9956462585034,33.0,20.0,300,2.0,290
674,214,480,46.18448979591837,49.040544217687085,33.0,21.0,293,3.0,266
675,214,616,46.18448979591837,47.74022675736961,33.0,20.0,408,2.0,402
676,214,616,46.18448979591837,48.251065759637186,33.0,21.0,412,2.0,402
677,256,65,46.997188208616784,48.76190476190477,27.0,28.0,206,2.0,191
678,256,174,46.997188208616784,49.574603174603176,27.0,33.0,138,3.0,82
679,256,211,46.997188208616784,48.76190476190477,27.0,29.0,88,2.0,45
680,256,255,46.997188208616784,49.574603174603176,27.0,29.0,111,3.0,1
681,256,480,46.997188208616784,49.040544217687085,27.0,21.0,241,2.0,224
682,256,616,46.997188208616784,48.251065759637186,27.0,21.0,364,1.0,360
683,256,617,46.997188208616784,49.783582766439906,27.0,18.0,380,3.0,361
684,211,175,48.76190476190477,50.596281179138316,29.0,34.0,87,2.0,36
685,211,203,48.76190476190477,51.641179138322,29.0,37.0,124,3.0,8
686,211,231,48.76190476190477,50.642721088435366,29.0,32.0,83,2.0,20
687,211,562,48.76190476190477,50.10866213151928,29.0,24.0,356,1.0,351
688,211,475,48.76190476190477,51.083900226757365,29.0,23.0,282,2.0,264
689,211,617,48.76190476190477,49.783582766439906,29.0,18.0,408,1.0,406
690,211,649,48.76190476190477,50.062222222222225,29.0,16.0,442,1.0,438
691,211,616,48.76190476190477,51.06068027210885,29.0,18.0,417,2.0,405
692,255,175,49.574603174603176,50.596281179138316,29.0,34.0,91,1.0,80
693,255,203,49.574603174603176,51.641179138322,29.0,37.0,103,2.0,52
694,255,146,49.574603174603176,52.22167800453515,29.0,28.0,158,3.0,109
695,255,231,49.574603174603176,50.642721088435366,29.0,32.0,52,1.0,24
696,255,231,49.574603174603176,51.85015873015873,29.0,34.0,101,2.0,24
697,255,243,49.574603174603176,52.19845804988664,29.0,33.0,114,3.0,12
698,255,475,49.574603174603176,51.083900226757365,29.0,23.0,229,2.0,220
699,255,616,49.574603174603176,51.06068027210885,29.0,18.0,367,1.0,361
700,255,616,49.574603174603176,52.36099773242631,29.0,19.0,380,3.0,361
701,231,146,50.642721088435366,52.22167800453515,32.0,28.0,109,2.0,85
702,231,151,50.642721088435366,53.52199546485261,32.0,32.0,148,3.0,80
703,231,243,50.642721088435366,52.19845804988664,32.0,33.0,68,2.0,12
704,231,487,50.642721088435366,52.96471655328799,32.0,20.0,275,2.0,256
705,231,446,50.642721088435366,53.12725623582767,32.0,22.0,240,2.0,215
706,231,616,50.642721088435366,52.36099773242631,32.0,19.0,392,2.0,385
707,231,151,51.85015873015873,53.52199546485261,34.0,32.0,108,2.0,80
708,231,66,51.85015873015873,54.706213151927436,34.0,35.0,206,3.0,165
709,231,216,51.85015873015873,53.916734693877544,34.0,32.0,90,2.0,15
710,231,233,51.85015873015873,54.00961451247166,34.0,29.0,93,2.0,2
711,231,487,51.85015873015873,52.96471655328799,34.0,20.0,260,1.0,256
712,231,446,51.85015873015873,53.12725623582767,34.0,22.0,222,1.0,215
713,231,476,51.85015873015873,54.659773242630386,34.0,19.0,273,3.0,245
714,231,616,51.85015873015873,53.89351473922903,34.0,20.0,395,2.0,385
715,243,151,52.19845804988664,53.52199546485261,33.0,32.0,108,1.0,92
716,243,66,52.19845804988664,54.706213151927436,33.0,35.0,207,3.0,177
717,243,216,52.19845804988664,53.916734693877544,33.0,32.0,79,2.0,27
718,243,233,52.19845804988664,54.00961451247166,33.0,29.0,79,2.0,10
719,243,476,52.19845804988664,54.659773242630386,33.0,19.0,256,2.0,233
720,243,550,52.19845804988664,55.17061224489796,33.0,23.0,333,3.0,307
721,243,616,52.19845804988664,53.89351473922903,33.0,20.0,380,2.0,373
722,243,616,52.19845804988664,54.91519274376417,33.0,21.0,391,3.0,373
723,216,155,53.916734693877544,55.727891156462576,32.0,29.0,99,2.0,61
724,216,80,53.916734693877544,56.28517006802721,32.0,32.0,170,2.0,136
725,216,242,53.916734693877544,55.751111111111115,32.0,30.0,83,2.0,26
726,216,246,53.916734693877544,56.21551020408163,32.0,25.0,103,2.0,30
727,216,550,53.916734693877544,55.17061224489796,32.0,23.0,338,1.0,334
728,216,581,53.916734693877544,56.796009070294794,32.0,20.0,385,3.0,365
729,216,616,53.916734693877544,55.93687074829932,32.0,20.0,409,2.0,400
730,216,616,53.916734693877544,56.4477097505669,32.0,24.0,415,3.0,400
731,233,155,54.00961451247166,55.727891156462576,29.0,29.0,108,2.0,78
732,233,80,54.00961451247166,56.28517006802721,29.0,32.0,182,2.0,153
733,233,242,54.00961451247166,55.751111111111115,29.0,30.0,76,2.0,9
734,233,246,54.00961451247166,56.21551020408163,29.0,25.0,96,2.0,13
735,233,550,54.00961451247166,55.17061224489796,29.0,23.0,321,1.0,317
736,233,581,54.00961451247166,56.796009070294794,29.0,20.0,368,3.0,348
737,233,616,54.00961451247166,55.93687074829932,29.0,20.0,392,2.0,383
738,233,616,54.00961451247166,56.4477097505669,29.0,24.0,397,2.0,383
739,242,185,55.751111111111115,57.74802721088435,30.0,27.0,103,2.0,57
740,242,243,55.751111111111115,58.53750566893424,30.0,29.0,120,3.0,1
741,242,581,55.751111111111115,56.796009070294794,30.0,20.0,342,1.0,339
742,242,444,55.751111111111115,57.23718820861678,30.0,22.0,212,1.0,202
743,242,562,55.751111111111115,58.35174603174603,30.0,23.0,339,3.0,320
744,242,616,55.751111111111115,57.72480725623583,30.0,20.0,384,2.0,374
745,242,616,55.751111111111115,58.00344671201814,30.0,18.0,386,2.0,374
746,246,185,56.21551020408163,57.74802721088435,25.0,27.0,90,2.0,61
747,246,81,56.21551020408163,58.79292517006804,25.0,34.0,199,3.0,165
748,246,242,56.21551020408163,57.771247165532884,25.0,30.0,67,2.0,4
749,246,243,56.21551020408163,58.53750566893424,25.0,29.0,100,2.0,3
750,246,444,56.21551020408163,57.23718820861678,25.0,22.0,203,1.0,198
751,246,562,56.21551020408163,58.35174603174603,25.0,23.0,329,2.0,316
752,246,616,56.21551020408163,57.72480725623583,25.0,20.0,376,2.0,370
753,246,616,56.21551020408163,58.00344671201814,25.0,18.0,378,2.0,370
754,246,616,56.21551020408163,59.025124716553286,25.0,20.0,389,3.0,370
755,242,81,57.771247165532884,58.79292517006804,30.0,34.0,167,1.0,161
756,242,77,57.771247165532884,59.41986394557824,30.0,28.0,180,2.0,165
757,242,480,57.771247165532884,59.28054421768707,30.0,22.0,247,2.0,238
758,242,616,57.771247165532884,59.025124716553286,30.0,20.0,378,1.0,374
759,243,242,58.53750566893424,59.86104308390022,29.0,36.0,57,1.0,1
760,525,174,1.4164172335600906,3.43655328798186,7.0,28.0,362,2.0,351
761,525,261,1.4164172335600906,2.786394557823129,7.0,28.0,271,1.0,264
762,525,259,1.4164172335600906,3.2043537414965986,7.0,27.0,277,2.0,266
763,525,452,1.4164172335600906,2.7399546485260773,7.0,11.0,93,1.0,73
764,525,450,1.4164172335600906,3.3668934240362813,7.0,14.0,113,2.0,75
765,452,145,2.7399546485260773,4.96907029478458,11.0,33.0,322,2.0,307
766,452,146,2.7399546485260773,4.992290249433106,11.0,32.0,321,2.0,306
767,452,256,2.7399546485260773,4.435011337868481,11.0,41.0,209,2.0,196
768,452,242,2.7399546485260773,4.992290249433106,11.0,16.0,231,2.0,210
769,452,410,2.7399546485260773,4.435011337868481,11.0,17.0,84,2.0,42
770,452,532,2.7399546485260773,4.992290249433106,11.0,2.0,126,2.0,80
771,452,615,2.7399546485260773,4.435011337868481,11.0,7.0,179,2.0,163
772,450,145,3.3668934240362813,4.96907029478458,14.0,33.0,313,2.0,305
773,450,146,3.3668934240362813,4.992290249433106,14.0,32.0,312,2.0,304
774,450,256,3.3668934240362813,4.435011337868481,14.0,41.0,199,1.0,194
775,450,242,3.3668934240362813,4.992290249433106,14.0,16.0,219,2.0,208
776,450,410,3.3668934240362813,4.435011337868481,14.0,17.0,61,1.0,40
777,450,532,3.3668934240362813,4.992290249433106,14.0,2.0,108,2.0,82
778,450,615,3.3668934240362813,4.435011337868481,14.0,7.0,171,1.0,165
779,410,194,4.435011337868481,6.524807256235827,17.0,25.0,234,2.0,216
780,410,146,4.435011337868481,7.058866213151928,17.0,28.0,287,3.0,264
781,410,242,4.435011337868481,6.524807256235827,17.0,37.0,191,2.0,168
782,410,255,4.435011337868481,6.9892063492063485,17.0,13.0,190,3.0,155
783,410,485,4.435011337868481,6.5015873015873025,17.0,18.0,116,2.0,75
784,532,194,4.992290249433106,6.524807256235827,2.0,25.0,344,2.0,338
785,532,146,4.992290249433106,7.058866213151928,2.0,28.0,396,2.0,386
786,532,242,4.992290249433106,6.524807256235827,2.0,37.0,297,2.0,290
787,532,255,4.992290249433106,6.9892063492063485,2.0,13.0,290,2.0,277
788,532,485,4.992290249433106,6.5015873015873025,2.0,18.0,80,2.0,47
789,485,49,6.5015873015873025,8.544943310657597,18.0,24.0,445,2.0,436
790,485,146,6.5015873015873025,9.102222222222222,18.0,29.0,357,3.0,339
791,485,242,6.5015873015873025,8.568163265306122,18.0,37.0,259,2.0,243
792,485,194,8.568163265306122,10.611519274376418,18.0,30.0,304,2.0,291
793,485,146,8.568163265306122,11.168798185941043,18.0,30.0,357,3.0,339
794,485,239,8.568163265306122,9.729160997732428,18.0,16.0,251,1.0,246
795,485,242,8.568163265306122,10.611519274376418,18.0,40.0,258,2.0,243
796,485,261,8.568163265306122,11.099138321995463,18.0,22.0,249,3.0,224
797,485,519,8.568163265306122,9.636281179138322,18.0,6.0,57,1.0,34
798,519,146,9.636281179138322,11.168798185941043,6.0,30.0,379,2.0,373
799,519,261,9.636281179138322,11.099138321995463,6.0,22.0,266,1.0,258
800,519,453,9.636281179138322,11.58675736961451,6.0,10.0,107,2.0,66
801,485,194,10.611519274376418,12.67809523809524,23.0,25.0,304,2.0,291
802,485,86,10.611519274376418,13.188934240362814,23.0,32.0,414,3.0,399
803,485,242,10.611519274376418,12.67809523809524,23.0,38.0,259,2.0,243
804,485,456,10.611519274376418,13.212154195011339,23.0,4.0,116,3.0,29
805,453,194,11.58675736961451,12.67809523809524,10.0,25.0,263,1.0,259
806,453,86,11.58675736961451,13.188934240362814,10.0,32.0,373,2.0,367
807,453,87,11.58675736961451,14.466031746031744,10.0,22.0,386,3.0,366
808,453,242,11.58675736961451,12.67809523809524,10.0,38.0,216,1.0,211
809,453,355,11.58675736961451,13.839092970521545,10.0,13.0,138,2.0,98
810,453,485,11.58675736961451,12.67809523809524,10.0,19.0,57,1.0,32
811,453,456,11.58675736961451,13.212154195011339,10.0,4.0,70,2.0,3
812,485,87,12.67809523809524,14.466031746031744,19.0,22.0,405,2.0,398
813,485,146,12.67809523809524,15.278730158730161,19.0,28.0,357,3.0,339
814,485,355,12.67809523809524,13.839092970521545,19.0,13.0,139,1.0,130
815,485,242,12.67809523809524,14.721451247165533,19.0,35.0,258,2.0,243
816,485,231,12.67809523809524,15.278730158730161,19.0,12.0,278,3.0,254
817,456,87,13.212154195011339,14.466031746031744,4.0,22.0,373,1.0,369
818,456,146,13.212154195011339,15.278730158730161,4.0,28.0,323,2.0,310
819,456,242,13.212154195011339,14.721451247165533,4.0,35.0,224,2.0,214
820,456,231,13.212154195011339,15.278730158730161,4.0,12.0,242,2.0,225
821,456,485,13.212154195011339,14.721451247165533,4.0,18.0,71,2.0,29
822,485,151,14.721451247165533,16.76480725623583,18.0,35.0,345,2.0,334
823,485,256,14.721451247165533,16.76480725623583,18.0,33.0,245,2.0,229
824,485,542,14.721451247165533,16.741587301587302,18.0,13.0,104,2.0,57
825,485,562,14.721451247165533,17.22920634920635,18.0,26.0,133,3.0,77
826,485,616,14.721451247165533,16.904126984126986,18.0,10.0,161,2.0,131
827,485,616,14.721451247165533,17.22920634920635,18.0,17.0,170,3.0,131
828,485,865,14.721451247165533,17.205986394557822,18.0,4.0,395,2.0,380
829,542,65,16.741587301587302,18.29732426303855,13.0,32.0,482,2.0,477
830,542,68,16.741587301587302,19.295782312925173,13.0,30.0,487,3.0,474
831,542,239,16.741587301587302,17.76326530612245,13.0,27.0,306,1.0,303
832,542,237,16.741587301587302,18.29732426303855,13.0,29.0,312,2.0,305
833,542,231,16.741587301587302,19.040362811791386,13.0,29.0,326,2.0,311
834,542,445,16.741587301587302,18.250884353741494,13.0,23.0,117,2.0,97
835,542,615,16.741587301587302,18.22766439909297,13.0,18.0,97,1.0,73
836,542,616,16.741587301587302,19.527981859410428,13.0,19.0,141,3.0,74
837,542,867,16.741587301587302,18.22766439909297,13.0,7.0,331,1.0,325
838,542,869,16.741587301587302,19.202902494331067,13.0,5.0,344,2.0,327
839,562,65,17.22920634920635,18.29732426303855,26.0,32.0,499,1.0,497
840,562,68,17.22920634920635,19.295782312925173,26.0,30.0,502,2.0,494
841,562,237,17.22920634920635,18.29732426303855,26.0,29.0,328,1.0,325
842,562,231,17.22920634920635,19.040362811791386,26.0,29.0,340,2.0,331
843,562,445,17.22920634920635,18.250884353741494,26.0,23.0,125,1.0,117
844,562,530,17.22920634920635,19.87628117913832,26.0,21.0,118,3.0,32
845,562,616,17.22920634920635,19.527981859410428,26.0,19.0,113,2.0,54
846,562,869,17.22920634920635,19.202902494331067,26.0,5.0,319,2.0,307
847,445,68,18.250884353741494,19.295782312925173,23.0,30.0,380,1.0,377
848,445,65,18.250884353741494,20.387120181405894,23.0,33.0,391,2.0,380
849,445,241,18.250884353741494,20.31746031746032,23.0,31.0,223,2.0,204
850,445,530,18.250884353741494,19.87628117913832,23.0,21.0,110,2.0,85
851,445,480,18.250884353741494,20.31746031746032,23.0,22.0,96,2.0,35
852,445,561,18.250884353741494,21.08371882086168,23.0,20.0,168,3.0,116
853,445,616,18.250884353741494,19.527981859410428,23.0,19.0,180,1.0,171
854,445,616,18.250884353741494,20.80507936507936,23.0,16.0,203,3.0,171
855,445,616,18.250884353741494,21.060498866213152,23.0,20.0,209,3.0,171
856,445,864,18.250884353741494,20.294240362811788,23.0,4.0,428,2.0,419
857,530,201,19.87628117913832,21.84997732426304,21.0,30.0,340,2.0,329
858,530,77,19.87628117913832,22.430476190476192,21.0,28.0,466,3.0,453
859,530,231,19.87628117913832,21.89641723356009,21.0,34.0,311,2.0,299
860,530,242,19.87628117913832,22.360816326530614,21.0,30.0,307,2.0,288
861,530,561,19.87628117913832,21.08371882086168,21.0,20.0,61,1.0,31
862,530,480,19.87628117913832,22.360816326530614,21.0,23.0,118,2.0,50
863,530,616,19.87628117913832,21.060498866213152,21.0,20.0,100,1.0,86
864,530,616,19.87628117913832,22.6162358276644,21.0,18.0,146,3.0,86
865,530,822,19.87628117913832,21.524897959183672,21.0,8.0,301,2.0,292
866,530,865,19.87628117913832,22.337596371882086,21.0,4.0,351,2.0,335
867,480,201,20.31746031746032,21.84997732426304,22.0,30.0,287,2.0,279
868,480,77,20.31746031746032,22.430476190476192,22.0,28.0,413,2.0,403
869,480,231,20.31746031746032,21.89641723356009,22.0,34.0,258,2.0,249
870,480,242,20.31746031746032,22.360816326530614,22.0,30.0,254,2.0,238
871,480,561,20.31746031746032,23.12707482993197,22.0,20.0,146,3.0,81
872,480,616,20.31746031746032,22.6162358276644,22.0,18.0,168,2.0,136
873,480,616,20.31746031746032,23.12707482993197,22.0,19.0,182,3.0,136
874,480,822,20.31746031746032,21.524897959183672,22.0,8.0,346,1.0,342
875,480,865,20.31746031746032,22.337596371882086,22.0,4.0,395,2.0,385
876,480,847,20.31746031746032,23.26639455782313,22.0,8.0,388,3.0,367
877,561,77,21.08371882086168,22.430476190476192,20.0,28.0,487,1.0,484
878,561,195,21.08371882086168,23.40571428571429,20.0,36.0,379,2.0,366
879,561,77,21.08371882086168,23.986213151927444,20.0,24.0,500,3.0,484
880,561,242,21.08371882086168,22.360816326530614,20.0,30.0,324,1.0,319
881,561,218,21.08371882086168,23.45215419501134,20.0,37.0,358,2.0,343
882,561,480,21.08371882086168,22.360816326530614,20.0,23.0,98,1.0,81
883,561,616,21.08371882086168,22.6162358276644,20.0,18.0,86,2.0,55
884,561,616,21.08371882086168,23.12707482993197,20.0,19.0,104,2.0,55
885,561,865,21.08371882086168,22.337596371882086,20.0,4.0,309,1.0,304
886,561,847,21.08371882086168,23.26639455782313,20.0,8.0,301,2.0,286
887,480,195,22.360816326530614,23.40571428571429,23.0,36.0,289,1.0,285
888,480,77,22.360816326530614,23.986213151927444,23.0,24.0,409,2.0,403
889,480,218,22.360816326530614,23.45215419501134,23.0,37.0,266,1.0,262
890,480,256,22.360816326530614,24.96145124716553,23.0,35.0,250,3.0,224
891,480,256,22.360816326530614,24.98467120181406,23.0,30.0,251,3.0,224
892,480,616,22.360816326530614,24.91501133786848,23.0,20.0,175,3.0,136
893,480,616,22.360816326530614,25.17043083900227,23.0,21.0,182,3.0,136
894,480,842,22.360816326530614,24.91501133786848,23.0,4.0,378,3.0,362
895,561,76,23.12707482993197,25.58839002267574,20.0,33.0,496,2.0,485
896,561,256,23.12707482993197,24.96145124716553,20.0,35.0,315,2.0,305
897,561,256,23.12707482993197,24.98467120181406,20.0,30.0,315,2.0,305
898,561,480,23.12707482993197,24.427392290249433,20.0,21.0,98,1.0,81
899,561,562,23.12707482993197,25.44907029478458,20.0,30.0,100,2.0,1
900,561,616,23.12707482993197,24.91501133786848,20.0,20.0,95,2.0,55
901,561,616,23.12707482993197,25.17043083900227,20.0,21.0,104,2.0,55
902,561,842,23.12707482993197,24.91501133786848,20.0,4.0,291,2.0,281
903,561,829,23.12707482993197,25.495510204081636,20.0,5.0,287,2.0,268
904,480,76,24.427392290249433,25.58839002267574,21.0,33.0,407,1.0,404
905,480,180,24.427392290249433,26.23854875283447,21.0,36.0,310,2.0,300
906,480,218,24.427392290249433,26.563628117913836,21.0,33.0,278,2.0,262
907,480,562,24.427392290249433,25.44907029478458,21.0,30.0,93,1.0,82
908,480,562,24.427392290249433,26.981587301587304,21.0,20.0,137,3.0,82
909,480,616,24.427392290249433,26.19210884353741,21.0,21.0,156,2.0,136
910,480,616,24.427392290249433,27.21378684807256,21.0,19.0,181,3.0,136
911,480,829,24.427392290249433,25.495510204081636,21.0,5.0,352,1.0,349
912,480,859,24.427392290249433,26.424308390022677,21.0,10.0,389,2.0,379
913,562,204,25.44907029478458,27.53886621315193,30.0,36.0,369,2.0,358
914,562,218,25.44907029478458,26.563628117913836,30.0,33.0,347,1.0,344
915,562,231,25.44907029478458,27.771065759637192,30.0,40.0,346,2.0,331
916,562,256,25.44907029478458,28.11936507936508,30.0,37.0,327,3.0,306
917,562,480,25.44907029478458,26.47074829931973,30.0,22.0,93,1.0,82
918,562,616,25.44907029478458,27.21378684807256,30.0,19.0,93,2.0,54
919,562,616,25.44907029478458,28.328344671201812,30.0,17.0,135,3.0,54
920,562,842,25.44907029478458,27.724625850340136,30.0,3.0,297,2.0,280
921,480,204,26.47074829931973,27.53886621315193,22.0,36.0,280,1.0,276
922,480,197,26.47074829931973,28.51410430839002,22.0,29.0,296,2.0,283
923,480,231,26.47074829931973,27.771065759637192,22.0,40.0,255,1.0,249
924,480,256,26.47074829931973,28.11936507936508,22.0,37.0,235,2.0,224
925,480,255,26.47074829931973,29.071383219954647,22.0,33.0,251,3.0,225
926,480,550,26.47074829931973,28.51410430839002,22.0,21.0,112,2.0,70
927,480,561,26.47074829931973,29.0249433106576,22.0,20.0,137,3.0,81
928,480,616,26.47074829931973,28.328344671201812,22.0,17.0,158,2.0,136
929,480,616,26.47074829931973,29.280362811791388,22.0,21.0,182,3.0,136
930,480,842,26.47074829931973,27.724625850340136,22.0,3.0,366,1.0,362
931,480,878,26.47074829931973,28.4908843537415,22.0,10.0,407,2.0,398
932,480,842,26.47074829931973,29.280362811791388,22.0,3.0,382,3.0,362
933,562,197,26.981587301587304,28.51410430839002,20.0,29.0,371,2.0,365
934,562,77,26.981587301587304,29.69832199546485,20.0,31.0,499,3.0,485
935,562,256,26.981587301587304,28.11936507936508,20.0,37.0,310,1.0,306
936,562,255,26.981587301587304,29.071383219954647,20.0,33.0,320,2.0,307
937,562,550,26.981587301587304,28.51410430839002,20.0,21.0,67,2.0,12
938,562,561,26.981587301587304,29.0249433106576,20.0,20.0,88,2.0,1
939,562,616,26.981587301587304,28.328344671201812,20.0,17.0,79,1.0,54
940,562,616,26.981587301587304,29.280362811791388,20.0,21.0,113,2.0,54
941,562,878,26.981587301587304,28.4908843537415,20.0,10.0,323,2.0,316
942,562,842,26.981587301587304,29.280362811791388,20.0,3.0,297,2.0,280
943,550,77,28.51410430839002,29.69832199546485,21.0,31.0,476,1.0,473
944,550,195,28.51410430839002,30.83609977324263,21.0,27.0,369,2.0,355
945,550,219,28.51410430839002,30.557460317460322,21.0,36.0,342,2.0,331
946,550,616,28.51410430839002,30.04662131519275,21.0,19.0,93,2.0,66
947,550,616,28.51410430839002,31.32371882086168,21.0,19.0,138,3.0,66
948,550,868,28.51410430839002,30.557460317460322,21.0,6.0,330,2.0,318
949,550,826,28.51410430839002,31.021859410430842,21.0,7.0,296,3.0,276
950,561,195,29.0249433106576,30.83609977324263,20.0,27.0,374,2.0,366
951,561,204,29.0249433106576,31.579138321995462,20.0,29.0,374,3.0,357
952,561,219,29.0249433106576,30.557460317460322,20.0,36.0,348,2.0,342
953,561,232,29.0249433106576,31.74167800453515,20.0,36.0,349,3.0,329
954,561,550,29.0249433106576,30.557460317460322,20.0,23.0,67,2.0,11
955,561,411,29.0249433106576,31.579138321995462,20.0,23.0,186,3.0,150
956,561,616,29.0249433106576,30.04662131519275,20.0,19.0,70,1.0,55
957,561,616,29.0249433106576,31.32371882086168,20.0,19.0,113,2.0,55
958,561,868,29.0249433106576,30.557460317460322,20.0,6.0,314,2.0,307
959,561,826,29.0249433106576,31.021859410430842,20.0,7.0,279,2.0,265
960,550,204,30.557460317460322,31.579138321995462,23.0,29.0,349,1.0,346
961,550,200,30.557460317460322,32.624036281179144,23.0,22.0,361,2.0,350
962,550,232,30.557460317460322,31.74167800453515,23.0,36.0,322,1.0,318
963,550,244,30.557460317460322,32.48471655328798,23.0,37.0,317,2.0,306
964,550,255,30.557460317460322,33.158095238095235,23.0,35.0,316,3.0,295
965,550,411,30.557460317460322,31.579138321995462,23.0,23.0,146,1.0,139
966,550,411,30.557460317460322,32.04353741496599,23.0,25.0,153,1.0,139
967,550,489,30.557460317460322,33.2974149659864,23.0,27.0,133,3.0,61
968,550,616,30.557460317460322,32.43827664399093,23.0,17.0,104,2.0,66
969,550,616,30.557460317460322,33.111655328798186,23.0,20.0,128,3.0,66
970,550,855,30.557460317460322,32.53115646258504,23.0,3.0,317,2.0,305
971,411,200,31.579138321995462,32.624036281179144,23.0,22.0,216,1.0,211
972,411,151,31.579138321995462,33.715374149659866,23.0,32.0,276,2.0,260
973,411,195,31.579138321995462,34.22621315192744,23.0,40.0,244,3.0,216
974,411,255,31.579138321995462,33.158095238095235,23.0,35.0,170,2.0,156
975,411,215,31.579138321995462,34.29587301587301,23.0,32.0,228,3.0,196
976,411,489,31.579138321995462,33.2974149659864,23.0,27.0,108,2.0,78
977,411,616,31.579138321995462,33.111655328798186,23.0,20.0,215,2.0,205
978,411,616,31.579138321995462,34.411972789115644,23.0,18.0,239,3.0,205
979,411,855,31.579138321995462,33.552834467120185,23.0,8.0,452,2.0,444
980,411,151,32.04353741496599,33.715374149659866,25.0,32.0,270,2.0,260
981,411,195,32.04353741496599,34.22621315192744,25.0,40.0,236,2.0,216
982,411,255,32.04353741496599,33.158095238095235,25.0,35.0,163,1.0,156
983,411,215,32.04353741496599,34.29587301587301,25.0,32.0,219,2.0,196
984,411,489,32.04353741496599,33.2974149659864,25.0,27.0,95,1.0,78
985,411,550,32.04353741496599,34.66739229024943,25.0,20.0,179,3.0,139
986,411,616,32.04353741496599,33.111655328798186,25.0,20.0,210,1.0,205
987,411,616,32.04353741496599,34.411972789115644,25.0,18.0,229,2.0,205
988,411,855,32.04353741496599,33.552834467120185,25.0,8.0,449,2.0,444
989,411,850,32.04353741496599,34.59773242630386,25.0,11.0,453,3.0,439
990,489,65,33.2974149659864,35.085351473922906,27.0,33.0,431,2.0,424
991,489,188,33.2974149659864,36.269569160997726,27.0,33.0,327,3.0,301
992,489,235,33.2974149659864,35.71229024943311,27.0,29.0,274,2.0,254
993,489,550,33.2974149659864,34.66739229024943,27.0,20.0,85,1.0,61
994,489,561,33.2974149659864,35.94448979591837,27.0,19.0,135,3.0,72
995,489,616,33.2974149659864,34.411972789115644,27.0,18.0,136,1.0,127
996,489,616,33.2974149659864,35.94448979591837,27.0,20.0,171,3.0,127
997,489,850,33.2974149659864,34.59773242630386,27.0,11.0,365,1.0,361
998,489,848,33.2974149659864,35.54975056689342,27.0,9.0,372,2.0,359
999,550,188,34.66739229024943,36.269569160997726,20.0,33.0,369,2.0,362
1000,550,66,34.66739229024943,37.29124716553289,20.0,31.0,497,3.0,484
1001,550,235,34.66739229024943,35.71229024943311,20.0,29.0,318,1.0,315
1002,550,224,34.66739229024943,36.73396825396826,20.0,28.0,338,2.0,326
1003,550,256,34.66739229024943,37.26802721088436,20.0,29.0,315,3.0,294
1004,550,561,34.66739229024943,35.94448979591837,20.0,19.0,56,1.0,11
1005,550,480,34.66739229024943,36.73396825396826,20.0,22.0,113,2.0,70
1006,550,426,34.66739229024943,37.198367346938774,20.0,24.0,165,3.0,124
1007,550,616,34.66739229024943,35.94448979591837,20.0,20.0,86,1.0,66
1008,550,616,34.66739229024943,36.966167800453526,20.0,20.0,119,2.0,66
1009,550,616,34.66739229024943,37.47700680272109,20.0,20.0,138,3.0,66
1010,550,852,34.66739229024943,36.73396825396826,20.0,5.0,315,2.0,302
1011,550,841,34.66739229024943,37.198367346938774,20.0,7.0,311,3.0,291
1012,561,66,35.94448979591837,37.29124716553289,19.0,31.0,498,1.0,495
1013,561,194,35.94448979591837,38.35936507936508,19.0,39.0,381,2.0,367
1014,561,256,35.94448979591837,37.26802721088436,19.0,29.0,310,1.0,305
1015,561,237,35.94448979591837,38.38258503401361,19.0,31.0,341,2.0,324
1016,561,426,35.94448979591837,37.198367346938774,19.0,24.0,145,1.0,135
1017,561,480,35.94448979591837,38.777324263038544,19.0,23.0,146,3.0,81
1018,561,616,35.94448979591837,36.966167800453526,19.0,20.0,70,1.0,55
1019,561,616,35.94448979591837,37.47700680272109,19.0,20.0,86,2.0,55
1020,561,616,35.94448979591837,38.24326530612245,19.0,20.0,113,2.0,55
1021,561,841,35.94448979591837,37.198367346938774,19.0,7.0,285,1.0,280
1022,561,867,35.94448979591837,38.75410430839002,19.0,6.0,329,3.0,306
1023,480,194,36.73396825396826,38.35936507936508,22.0,39.0,294,2.0,286
1024,480,65,36.73396825396826,39.68290249433107,22.0,26.0,434,3.0,415
1025,480,237,36.73396825396826,38.38258503401361,22.0,31.0,253,2.0,243
1026,480,616,36.73396825396826,38.24326530612245,22.0,20.0,151,2.0,136
1027,480,867,36.73396825396826,38.75410430839002,22.0,6.0,397,2.0,387
1028,480,864,36.73396825396826,39.07918367346939,22.0,7.0,397,2.0,384
1029,426,194,37.198367346938774,38.35936507936508,24.0,39.0,237,1.0,232
1030,426,65,37.198367346938774,39.68290249433107,24.0,26.0,377,2.0,361
1031,426,237,37.198367346938774,38.38258503401361,24.0,31.0,196,1.0,189
1032,426,239,37.198367346938774,39.845442176870755,24.0,27.0,219,3.0,187
1033,426,480,37.198367346938774,38.777324263038544,24.0,23.0,87,2.0,54
1034,426,612,37.198367346938774,39.77578231292517,24.0,20.0,217,3.0,186
1035,426,616,37.198367346938774,38.24326530612245,24.0,20.0,195,1.0,190
1036,426,616,37.198367346938774,39.77578231292517,24.0,21.0,220,3.0,190
1037,426,616,37.198367346938774,40.03120181405896,24.0,20.0,226,3.0,190
1038,426,867,37.198367346938774,38.75410430839002,24.0,6.0,446,2.0,441
1039,426,864,37.198367346938774,39.07918367346939,24.0,7.0,445,2.0,438
1040,480,178,38.777324263038544,40.61170068027211,23.0,31.0,312,2.0,302
1041,480,86,38.777324263038544,41.37795918367347,23.0,34.0,410,3.0,394
1042,480,239,38.777324263038544,39.845442176870755,23.0,27.0,245,1.0,241
1043,480,256,38.777324263038544,40.82068027210885,23.0,28.0,241,2.0,224
1044,480,256,38.777324263038544,41.37795918367347,23.0,32.0,250,3.0,224
1045,480,444,38.777324263038544,40.82068027210885,23.0,21.0,95,2.0,36
1046,480,616,38.777324263038544,40.03120181405896,23.0,20.0,146,1.0,136
1047,480,616,38.777324263038544,41.33151927437642,23.0,21.0,175,3.0,136
1048,480,861,38.777324263038544,40.24018140589568,23.0,7.0,386,1.0,381
1049,612,151,39.77578231292517,42.42285714285715,20.0,35.0,475,3.0,461
1050,612,256,39.77578231292517,40.82068027210885,20.0,28.0,359,1.0,356
1051,612,256,39.77578231292517,41.37795918367347,20.0,32.0,363,2.0,356
1052,612,216,39.77578231292517,42.399637188208615,20.0,31.0,412,3.0,396
1053,612,444,39.77578231292517,40.82068027210885,20.0,21.0,174,1.0,168
1054,612,528,39.77578231292517,41.865578231292524,20.0,22.0,123,2.0,84
1055,612,616,39.77578231292517,41.33151927437642,20.0,21.0,67,2.0,4
1056,612,616,39.77578231292517,42.60861678004535,20.0,19.0,122,3.0,4
1057,612,830,39.77578231292517,41.84235827664399,20.0,7.0,235,2.0,218
1058,444,151,40.82068027210885,42.42285714285715,21.0,35.0,301,2.0,293
1059,444,73,40.82068027210885,43.37487528344671,21.0,30.0,387,3.0,371
1060,444,216,40.82068027210885,42.399637188208615,21.0,31.0,238,2.0,228
1061,444,218,40.82068027210885,43.42131519274376,21.0,25.0,252,3.0,226
1062,444,528,40.82068027210885,41.865578231292524,21.0,22.0,95,1.0,84
1063,444,550,40.82068027210885,42.86403628117914,21.0,22.0,138,2.0,106
1064,444,475,40.82068027210885,43.37487528344671,21.0,19.0,114,3.0,31
1065,444,616,40.82068027210885,42.60861678004535,21.0,19.0,188,2.0,172
1066,444,830,40.82068027210885,41.84235827664399,21.0,7.0,388,1.0,386
1067,444,852,40.82068027210885,42.84081632653061,21.0,9.0,417,2.0,408
1068,444,842,40.82068027210885,43.37487528344671,21.0,3.0,413,3.0,398
1069,528,73,41.865578231292524,43.37487528344671,22.0,30.0,460,2.0,455
1070,528,193,41.865578231292524,44.74485260770975,22.0,36.0,357,3.0,335
1071,528,218,41.865578231292524,43.42131519274376,22.0,25.0,317,2.0,310
1072,528,475,41.865578231292524,43.37487528344671,22.0,19.0,84,2.0,53
1073,528,616,41.865578231292524,43.88571428571429,22.0,20.0,124,2.0,88
1074,528,616,41.865578231292524,44.141133786848066,22.0,20.0,132,2.0,88
1075,528,842,41.865578231292524,43.37487528344671,22.0,3.0,321,2.0,314
1076,528,842,41.865578231292524,44.141133786848066,22.0,3.0,329,2.0,314
1077,550,193,42.86403628117914,44.74485260770975,22.0,36.0,366,2.0,357
1078,550,174,42.86403628117914,45.441451247165524,22.0,36.0,392,3.0,376
1079,550,256,42.86403628117914,44.93061224489796,22.0,29.0,307,2.0,294
1080,550,256,42.86403628117914,45.46467120181406,22.0,31.0,315,3.0,294
1081,550,444,42.86403628117914,44.93061224489796,22.0,22.0,138,2.0,106
1082,550,612,42.86403628117914,45.41823129251701,22.0,18.0,126,3.0,62
1083,550,616,42.86403628117914,43.88571428571429,22.0,20.0,79,1.0,66
1084,550,616,42.86403628117914,44.141133786848066,22.0,20.0,86,1.0,66
1085,550,616,42.86403628117914,45.41823129251701,22.0,19.0,128,3.0,66
1086,550,842,42.86403628117914,44.141133786848066,22.0,3.0,297,1.0,292
1087,550,852,42.86403628117914,45.441451247165524,22.0,6.0,322,3.0,302
1088,475,193,43.37487528344671,44.74485260770975,19.0,36.0,288,1.0,282
1089,475,174,43.37487528344671,45.441451247165524,19.0,36.0,314,2.0,301
1090,475,192,43.37487528344671,46.25414965986395,19.0,34.0,309,3.0,283
1091,475,256,43.37487528344671,44.93061224489796,19.0,29.0,229,2.0,219
1092,475,256,43.37487528344671,45.46467120181406,19.0,31.0,237,2.0,219
1093,475,214,43.37487528344671,46.18448979591837,19.0,33.0,288,3.0,261
1094,475,444,43.37487528344671,44.93061224489796,19.0,22.0,74,2.0,31
1095,475,612,43.37487528344671,45.41823129251701,19.0,18.0,163,2.0,137
1096,475,616,43.37487528344671,45.41823129251701,19.0,19.0,166,2.0,141
1097,475,616,43.37487528344671,46.20770975056689,19.0,18.0,186,3.0,141
1098,475,852,43.37487528344671,45.441451247165524,19.0,6.0,387,2.0,377
1099,444,192,44.93061224489796,46.25414965986395,22.0,34.0,258,1.0,252
1100,444,65,44.93061224489796,47.043628117913826,22.0,30.0,390,2.0,379
1101,444,214,44.93061224489796,46.18448979591837,22.0,33.0,236,1.0,230
1102,444,256,44.93061224489796,46.997188208616784,22.0,27.0,208,2.0,188
1103,444,420,44.93061224489796,46.997188208616784,22.0,22.0,92,2.0,24
1104,444,616,44.93061224489796,46.20770975056689,22.0,18.0,181,1.0,172
1105,444,616,44.93061224489796,47.74022675736961,22.0,20.0,210,3.0,172
1106,444,846,44.93061224489796,46.71854875283447,22.0,5.0,409,2.0,402
1107,444,838,44.93061224489796,46.997188208616784,22.0,4.0,404,2.0,394
1108,612,256,45.41823129251701,46.997188208616784,18.0,27.0,362,2.0,356
1109,612,444,45.41823129251701,46.973968253968245,18.0,22.0,181,2.0,168
1110,612,420,45.41823129251701,46.997188208616784,18.0,22.0,204,2.0,192
1111,612,504,45.41823129251701,47.9956462585034,18.0,20.0,155,3.0,108
1112,612,616,45.41823129251701,47.74022675736961,18.0,20.0,100,2.0,4
1113,612,616,45.41823129251701,48.251065759637186,18.0,21.0,122,3.0,4
1114,612,846,45.41823129251701,46.71854875283447,18.0,5.0,241,1.0,234
1115,612,838,45.41823129251701,46.997188208616784,18.0,4.0,236,2.0,226
1116,612,842,45.41823129251701,48.251065759637186,18.0,4.0,260,3.0,230
1117,444,65,46.973968253968245,48.76190476190477,22.0,28.0,387,2.0,379
1118,444,174,46.973968253968245,49.574603174603176,22.0,33.0,292,3.0,270
1119,444,211,46.973968253968245,48.76190476190477,22.0,29.0,245,2.0,233
1120,444,255,46.973968253968245,49.574603174603176,22.0,29.0,220,3.0,189
1121,444,504,46.973968253968245,47.9956462585034,22.0,20.0,74,1.0,60
1122,444,480,46.973968253968245,49.040544217687085,22.0,21.0,96,2.0,36
1123,444,616,46.973968253968245,48.251065759637186,22.0,21.0,181,1.0,172
1124,444,617,46.973968253968245,49.783582766439906,22.0,18.0,211,3.0,173
1125,444,842,46.973968253968245,48.251065759637186,22.0,4.0,402,1.0,398
1126,444,863,46.973968253968245,49.48172335600907,22.0,10.0,433,3.0,419
1127,420,65,46.997188208616784,48.76190476190477,22.0,28.0,363,2.0,355
1128,420,174,46.997188208616784,49.574603174603176,22.0,33.0,270,3.0,246
1129,420,211,46.997188208616784,48.76190476190477,22.0,29.0,222,2.0,209
1130,420,255,46.997188208616784,49.574603174603176,22.0,29.0,199,3.0,165
1131,420,480,46.997188208616784,49.040544217687085,22.0,21.0,107,2.0,60
1132,420,616,46.997188208616784,48.251065759637186,22.0,21.0,203,1.0,196
1133,420,617,46.997188208616784,49.783582766439906,22.0,18.0,231,3.0,197
1134,420,842,46.997188208616784,48.251065759637186,22.0,4.0,425,1.0,422
1135,420,863,46.997188208616784,49.48172335600907,22.0,10.0,456,2.0,443
1136,504,174,47.9956462585034,49.574603174603176,20.0,33.0,337,2.0,330
1137,504,175,47.9956462585034,50.596281179138316,20.0,34.0,348,3.0,329
1138,504,255,47.9956462585034,49.574603174603176,20.0,29.0,258,2.0,249
1139,504,231,47.9956462585034,50.642721088435366,20.0,32.0,296,3.0,273
1140,504,480,47.9956462585034,49.040544217687085,20.0,21.0,51,1.0,24
1141,504,562,47.9956462585034,50.10866213151928,20.0,24.0,108,2.0,58
1142,504,617,47.9956462585034,49.783582766439906,20.0,18.0,137,2.0,113
1143,504,649,47.9956462585034,50.062222222222225,20.0,16.0,170,2.0,145
1144,504,863,47.9956462585034,49.48172335600907,20.0,10.0,365,1.0,359
1145,504,831,47.9956462585034,50.45696145124717,20.0,8.0,344,2.0,327
1146,480,175,49.040544217687085,50.596281179138316,21.0,34.0,312,2.0,305
1147,480,203,49.040544217687085,51.641179138322,21.0,37.0,299,3.0,277
1148,480,231,49.040544217687085,50.642721088435366,21.0,32.0,258,2.0,249
1149,480,231,49.040544217687085,51.85015873015873,21.0,34.0,277,3.0,249
1150,480,562,49.040544217687085,50.10866213151928,21.0,24.0,94,1.0,82
1151,480,475,49.040544217687085,51.083900226757365,21.0,23.0,88,2.0,5
1152,480,649,49.040544217687085,50.062222222222225,21.0,16.0,175,1.0,169
1153,480,616,49.040544217687085,51.06068027210885,21.0,18.0,161,2.0,136
1154,480,831,49.040544217687085,50.45696145124717,21.0,8.0,356,1.0,351
1155,480,853,49.040544217687085,51.52507936507936,21.0,10.0,388,2.0,373
1156,562,203,50.10866213151928,51.641179138322,24.0,37.0,365,2.0,359
1157,562,146,50.10866213151928,52.22167800453515,24.0,28.0,426,2.0,416
1158,562,231,50.10866213151928,51.85015873015873,24.0,34.0,339,2.0,331
1159,562,243,50.10866213151928,52.19845804988664,24.0,33.0,331,2.0,319
1160,562,487,50.10866213151928,52.96471655328799,24.0,20.0,144,3.0,75
1161,562,616,50.10866213151928,52.36099773242631,24.0,19.0,111,2.0,54
1162,562,853,50.10866213151928,51.52507936507936,24.0,10.0,297,1.0,291
1163,562,826,50.10866213151928,52.569977324263036,24.0,7.0,284,2.0,264
1164,475,146,51.083900226757365,52.22167800453515,23.0,28.0,333,1.0,329
1165,475,151,51.083900226757365,53.52199546485261,23.0,32.0,341,2.0,324
1166,475,243,51.083900226757365,52.19845804988664,23.0,33.0,237,1.0,232
1167,475,216,51.083900226757365,53.916734693877544,23.0,32.0,286,3.0,259
1168,475,233,51.083900226757365,54.00961451247166,23.0,29.0,273,3.0,242
1169,475,487,51.083900226757365,52.96471655328799,23.0,20.0,82,2.0,12
1170,475,446,51.083900226757365,53.12725623582767,23.0,22.0,93,2.0,29
1171,475,616,51.083900226757365,52.36099773242631,23.0,19.0,151,1.0,141
1172,475,616,51.083900226757365,53.89351473922903,23.0,20.0,186,3.0,141
1173,475,826,51.083900226757365,52.569977324263036,23.0,7.0,357,1.0,351
1174,475,865,51.083900226757365,53.12725623582767,23.0,5.0,400,2.0,390
1175,487,66,52.96471655328799,54.706213151927436,20.0,35.0,428,2.0,421
1176,487,155,52.96471655328799,55.727891156462576,20.0,29.0,353,3.0,332
1177,487,233,52.96471655328799,54.00961451247166,20.0,29.0,258,1.0,254
1178,487,242,52.96471655328799,55.751111111111115,20.0,30.0,273,3.0,245
1179,487,476,52.96471655328799,54.659773242630386,20.0,19.0,74,2.0,11
1180,487,550,52.96471655328799,55.17061224489796,20.0,23.0,114,2.0,63
1181,487,616,52.96471655328799,54.91519274376417,20.0,21.0,154,2.0,129
1182,487,616,52.96471655328799,55.93687074829932,20.0,20.0,182,3.0,129
1183,487,838,52.96471655328799,54.125714285714295,20.0,8.0,355,1.0,351
1184,487,852,52.96471655328799,55.19383219954649,20.0,6.0,377,2.0,365
1185,446,66,53.12725623582767,54.706213151927436,22.0,35.0,386,2.0,380
1186,446,155,53.12725623582767,55.727891156462576,22.0,29.0,312,3.0,291
1187,446,242,53.12725623582767,55.751111111111115,22.0,30.0,233,3.0,204
1188,446,476,53.12725623582767,54.659773242630386,22.0,19.0,72,2.0,30
1189,446,550,53.12725623582767,55.17061224489796,22.0,23.0,136,2.0,104
1190,446,616,53.12725623582767,54.91519274376417,22.0,21.0,187,2.0,170
1191,446,616,53.12725623582767,55.93687074829932,22.0,20.0,209,3.0,170
1192,446,852,53.12725623582767,55.19383219954649,22.0,6.0,416,2.0,406
1193,476,155,54.659773242630386,55.727891156462576,19.0,29.0,324,1.0,321
1194,476,80,54.659773242630386,56.28517006802721,19.0,32.0,402,2.0,396
1195,476,242,54.659773242630386,55.751111111111115,19.0,30.0,239,1.0,234
1196,476,246,54.659773242630386,56.21551020408163,19.0,25.0,240,2.0,230
1197,476,581,54.659773242630386,56.796009070294794,19.0,20.0,140,2.0,105
1198,476,444,54.659773242630386,57.23718820861678,19.0,22.0,116,3.0,32
1199,476,616,54.659773242630386,55.93687074829932,19.0,20.0,150,1.0,140
1200,476,616,54.659773242630386,56.4477097505669,19.0,24.0,160,2.0,140
1201,476,842,54.659773242630386,56.4477097505669,19.0,4.0,374,2.0,366
1202,550,80,55.17061224489796,56.28517006802721,23.0,32.0,472,1.0,470
1203,550,185,55.17061224489796,57.74802721088435,23.0,27.0,382,3.0,365
1204,550,246,55.17061224489796,56.21551020408163,23.0,25.0,307,1.0,304
1205,550,242,55.17061224489796,57.771247165532884,23.0,30.0,328,3.0,308
1206,550,581,55.17061224489796,56.796009070294794,23.0,20.0,77,2.0,31
1207,550,444,55.17061224489796,57.23718820861678,23.0,22.0,138,2.0,106
1208,550,616,55.17061224489796,56.4477097505669,23.0,24.0,86,1.0,66
1209,550,616,55.17061224489796,57.72480725623583,23.0,20.0,128,3.0,66
1210,550,616,55.17061224489796,58.00344671201814,23.0,18.0,139,3.0,66
1211,550,842,55.17061224489796,56.4477097505669,23.0,4.0,297,1.0,292
1212,581,243,56.796009070294794,58.53750566893424,20.0,29.0,346,2.0,338
1213,581,562,56.796009070294794,58.35174603174603,20.0,23.0,70,2.0,19
1214,581,480,56.796009070294794,59.28054421768707,20.0,22.0,147,2.0,101
1215,581,616,56.796009070294794,58.00344671201814,20.0,18.0,63,1.0,35
1216,581,616,56.796009070294794,59.025124716553286,20.0,20.0,102,2.0,35
1217,581,830,56.796009070294794,58.25886621315193,20.0,5.0,257,1.0,249
1218,581,865,56.796009070294794,59.28054421768707,20.0,5.0,303,2.0,284
1219,444,81,57.23718820861678,58.79292517006804,22.0,34.0,369,2.0,363
1220,444,77,57.23718820861678,59.41986394557824,22.0,28.0,379,2.0,367
1221,444,243,57.23718820861678,58.53750566893424,22.0,29.0,209,1.0,201
1222,444,242,57.23718820861678,59.86104308390022,22.0,36.0,231,3.0,202
1223,444,562,57.23718820861678,58.35174603174603,22.0,23.0,127,1.0,118
1224,444,480,57.23718820861678,59.28054421768707,22.0,22.0,95,2.0,36
1225,444,616,57.23718820861678,59.025124716553286,22.0,20.0,188,2.0,172
1226,444,830,57.23718820861678,58.25886621315193,22.0,5.0,388,1.0,386
1227,444,865,57.23718820861678,59.28054421768707,22.0,5.0,430,2.0,421
1228,562,77,58.35174603174603,59.41986394557824,23.0,28.0,487,1.0,485
1229,562,242,58.35174603174603,59.86104308390022,23.0,36.0,327,2.0,320
1230,615,194,4.435011337868481,6.524807256235827,7.0,25.0,431,2.0,421
1231,615,146,4.435011337868481,7.058866213151928,7.0,28.0,482,3.0,469
1232,615,242,4.435011337868481,6.524807256235827,7.0,37.0,384,2.0,373
1233,615,255,4.435011337868481,6.9892063492063485,7.0,13.0,376,3.0,360
1234,615,485,4.435011337868481,6.5015873015873025,7.0,18.0,158,2.0,130
1235,616,237,16.904126984126986,18.29732426303855,10.0,29.0,384,1.0,379
1236,616,231,16.904126984126986,19.040362811791386,10.0,29.0,396,2.0,385
1237,616,445,16.904126984126986,18.250884353741494,10.0,23.0,181,1.0,171
1238,616,530,16.904126984126986,19.87628117913832,10.0,21.0,154,3.0,86
1239,616,615,16.904126984126986,18.22766439909297,10.0,18.0,57,1.0,1
1240,616,867,16.904126984126986,18.22766439909297,10.0,7.0,257,1.0,251
1241,616,869,16.904126984126986,19.202902494331067,10.0,5.0,272,2.0,253
1242,616,237,17.22920634920635,18.29732426303855,17.0,29.0,382,1.0,379
1243,616,231,17.22920634920635,19.040362811791386,17.0,29.0,393,2.0,385
1244,616,445,17.22920634920635,18.250884353741494,17.0,23.0,177,1.0,171
1245,616,530,17.22920634920635,19.87628117913832,17.0,21.0,143,3.0,86
1246,616,869,17.22920634920635,19.202902494331067,17.0,5.0,267,2.0,253
1247,615,241,18.22766439909297,20.31746031746032,18.0,31.0,385,2.0,374
1248,615,530,18.22766439909297,19.87628117913832,18.0,21.0,111,2.0,85
1249,615,480,18.22766439909297,20.31746031746032,18.0,22.0,162,2.0,135
1250,615,561,18.22766439909297,21.08371882086168,18.0,20.0,134,3.0,54
1251,615,616,18.22766439909297,19.527981859410428,18.0,19.0,56,1.0,1
1252,615,616,18.22766439909297,20.80507936507936,18.0,16.0,111,3.0,1
1253,615,616,18.22766439909297,21.060498866213152,18.0,20.0,122,3.0,1
1254,615,864,18.22766439909297,20.294240362811788,18.0,4.0,264,2.0,249
1255,616,201,19.527981859410428,21.84997732426304,19.0,30.0,427,2.0,415
1256,616,231,19.527981859410428,21.89641723356009,19.0,34.0,398,2.0,385
1257,616,242,19.527981859410428,22.360816326530614,19.0,30.0,393,3.0,374
1258,616,561,19.527981859410428,21.08371882086168,19.0,20.0,87,2.0,55
1259,616,480,19.527981859410428,22.360816326530614,19.0,23.0,183,3.0,136
1260,616,822,19.527981859410428,21.524897959183672,19.0,8.0,223,2.0,206
1261,616,865,19.527981859410428,22.337596371882086,19.0,4.0,277,3.0,249
1262,616,201,20.80507936507936,21.84997732426304,16.0,30.0,417,1.0,415
1263,616,195,20.80507936507936,23.40571428571429,16.0,36.0,436,3.0,421
1264,616,231,20.80507936507936,21.89641723356009,16.0,34.0,388,1.0,385
1265,616,242,20.80507936507936,22.360816326530614,16.0,30.0,380,2.0,374
1266,616,218,20.80507936507936,23.45215419501134,16.0,37.0,414,3.0,398
1267,616,480,20.80507936507936,22.360816326530614,16.0,23.0,152,2.0,136
1268,616,561,20.80507936507936,23.12707482993197,16.0,20.0,114,2.0,55
1269,616,865,20.80507936507936,22.337596371882086,16.0,4.0,258,2.0,249
1270,616,847,20.80507936507936,23.26639455782313,16.0,8.0,254,2.0,231
1271,616,195,21.060498866213152,23.40571428571429,20.0,36.0,433,2.0,421
1272,616,242,21.060498866213152,22.360816326530614,20.0,30.0,378,1.0,374
1273,616,218,21.060498866213152,23.45215419501134,20.0,37.0,411,2.0,398
1274,616,480,21.060498866213152,22.360816326530614,20.0,23.0,147,1.0,136
1275,616,561,21.060498866213152,23.12707482993197,20.0,20.0,105,2.0,55
1276,616,865,21.060498866213152,22.337596371882086,20.0,4.0,255,1.0,249
1277,616,847,21.060498866213152,23.26639455782313,20.0,8.0,250,2.0,231
1278,616,256,22.6162358276644,24.96145124716553,18.0,35.0,374,2.0,360
1279,616,256,22.6162358276644,24.98467120181406,18.0,30.0,374,2.0,360
1280,616,480,22.6162358276644,24.427392290249433,18.0,21.0,157,2.0,136
1281,616,562,22.6162358276644,25.44907029478458,18.0,30.0,133,3.0,54
1282,616,842,22.6162358276644,24.91501133786848,18.0,4.0,247,2.0,226
1283,616,829,22.6162358276644,25.495510204081636,18.0,5.0,246,3.0,213
1284,616,256,23.12707482993197,24.96145124716553,19.0,35.0,369,2.0,360
1285,616,256,23.12707482993197,24.98467120181406,19.0,30.0,369,2.0,360
1286,616,480,23.12707482993197,24.427392290249433,19.0,21.0,147,1.0,136
1287,616,562,23.12707482993197,25.44907029478458,19.0,30.0,114,2.0,54
1288,616,842,23.12707482993197,24.91501133786848,19.0,4.0,239,2.0,226
1289,616,829,23.12707482993197,25.495510204081636,19.0,5.0,236,2.0,213
1290,616,180,24.91501133786848,26.23854875283447,20.0,36.0,440,1.0,436
1291,616,204,24.91501133786848,27.53886621315193,20.0,36.0,427,3.0,412
1292,616,218,24.91501133786848,26.563628117913836,20.0,33.0,404,2.0,398
1293,616,231,24.91501133786848,27.771065759637192,20.0,40.0,404,3.0,385
1294,616,480,24.91501133786848,26.47074829931973,20.0,22.0,152,2.0,136
1295,616,562,24.91501133786848,26.981587301587304,20.0,20.0,104,2.0,54
1296,616,859,24.91501133786848,26.424308390022677,20.0,10.0,252,2.0,243
1297,616,842,24.91501133786848,27.724625850340136,20.0,3.0,256,3.0,226
1298,616,180,25.17043083900227,26.23854875283447,21.0,36.0,438,1.0,436
1299,616,204,25.17043083900227,27.53886621315193,21.0,36.0,424,2.0,412
1300,616,218,25.17043083900227,26.563628117913836,21.0,33.0,402,1.0,398
1301,616,231,25.17043083900227,27.771065759637192,21.0,40.0,401,3.0,385
1302,616,256,25.17043083900227,28.11936507936508,21.0,37.0,382,3.0,360
1303,616,480,25.17043083900227,26.47074829931973,21.0,22.0,147,1.0,136
1304,616,562,25.17043083900227,26.981587301587304,21.0,20.0,95,2.0,54
1305,616,859,25.17043083900227,26.424308390022677,21.0,10.0,249,1.0,243
1306,616,842,25.17043083900227,27.724625850340136,21.0,3.0,251,3.0,226
1307,616,204,26.19210884353741,27.53886621315193,21.0,36.0,416,1.0,412
1308,616,197,26.19210884353741,28.51410430839002,21.0,29.0,431,2.0,419
1309,616,231,26.19210884353741,27.771065759637192,21.0,40.0,391,2.0,385
1310,616,256,26.19210884353741,28.11936507936508,21.0,37.0,369,2.0,360
1311,616,255,26.19210884353741,29.071383219954647,21.0,33.0,382,3.0,361
1312,616,550,26.19210884353741,28.51410430839002,21.0,21.0,120,2.0,66
1313,616,561,26.19210884353741,29.0249433106576,21.0,20.0,134,3.0,55
1314,616,842,26.19210884353741,27.724625850340136,21.0,3.0,235,2.0,226
1315,616,878,26.19210884353741,28.4908843537415,21.0,10.0,280,2.0,262
1316,616,197,27.21378684807256,28.51410430839002,19.0,29.0,423,1.0,419
1317,616,255,27.21378684807256,29.071383219954647,19.0,33.0,370,2.0,361
1318,616,550,27.21378684807256,28.51410430839002,19.0,21.0,87,1.0,66
1319,616,561,27.21378684807256,29.0249433106576,19.0,20.0,95,2.0,55
1320,616,878,27.21378684807256,28.4908843537415,19.0,10.0,268,1.0,262
1321,616,842,27.21378684807256,29.280362811791388,19.0,3.0,243,2.0,226
1322,616,195,28.328344671201812,30.83609977324263,17.0,27.0,435,3.0,421
1323,616,219,28.328344671201812,30.557460317460322,17.0,36.0,408,2.0,397
1324,616,550,28.328344671201812,30.557460317460322,17.0,23.0,116,2.0,66
1325,616,868,28.328344671201812,30.557460317460322,17.0,6.0,270,2.0,252
1326,616,826,28.328344671201812,31.021859410430842,17.0,7.0,240,3.0,210
1327,616,195,29.280362811791388,30.83609977324263,21.0,27.0,426,2.0,421
1328,616,204,29.280362811791388,31.579138321995462,21.0,29.0,424,2.0,412
1329,616,219,29.280362811791388,30.557460317460322,21.0,36.0,401,1.0,397
1330,616,232,29.280362811791388,31.74167800453515,21.0,36.0,398,2.0,384
1331,616,550,29.280362811791388,30.557460317460322,21.0,23.0,86,1.0,66
1332,616,411,29.280362811791388,31.579138321995462,21.0,23.0,228,2.0,205
1333,616,411,29.280362811791388,32.04353741496599,21.0,25.0,237,3.0,205
1334,616,868,29.280362811791388,30.557460317460322,21.0,6.0,258,1.0,252
1335,616,826,29.280362811791388,31.021859410430842,21.0,7.0,223,2.0,210
1336,616,204,30.04662131519275,31.579138321995462,19.0,29.0,417,2.0,412
1337,616,200,30.04662131519275,32.624036281179144,19.0,22.0,431,3.0,416
1338,616,232,30.04662131519275,31.74167800453515,19.0,36.0,391,2.0,384
1339,616,244,30.04662131519275,32.48471655328798,19.0,37.0,387,2.0,372
1340,616,411,30.04662131519275,31.579138321995462,19.0,23.0,215,2.0,205
1341,616,411,30.04662131519275,32.04353741496599,19.0,25.0,222,2.0,205
1342,616,855,30.04662131519275,32.53115646258504,19.0,3.0,262,2.0,239
1343,616,200,31.32371882086168,32.624036281179144,19.0,22.0,420,1.0,416
1344,616,151,31.32371882086168,33.715374149659866,19.0,32.0,476,2.0,465
1345,616,195,31.32371882086168,34.22621315192744,19.0,40.0,439,3.0,421
1346,616,244,31.32371882086168,32.48471655328798,19.0,37.0,375,1.0,372
1347,616,255,31.32371882086168,33.158095238095235,19.0,35.0,370,2.0,361
1348,616,215,31.32371882086168,34.29587301587301,19.0,32.0,421,3.0,401
1349,616,489,31.32371882086168,33.2974149659864,19.0,27.0,153,2.0,127
1350,616,855,31.32371882086168,32.53115646258504,19.0,3.0,245,1.0,239
1351,616,855,31.32371882086168,33.552834467120185,19.0,8.0,258,2.0,239
1352,616,151,32.43827664399093,33.715374149659866,17.0,32.0,468,1.0,465
1353,616,195,32.43827664399093,34.22621315192744,17.0,40.0,428,2.0,421
1354,616,215,32.43827664399093,34.29587301587301,17.0,32.0,409,2.0,401
1355,616,550,32.43827664399093,34.66739229024943,17.0,20.0,116,2.0,66
1356,616,855,32.43827664399093,33.552834467120185,17.0,8.0,244,1.0,239
1357,616,850,32.43827664399093,34.59773242630386,17.0,11.0,252,2.0,234
1358,616,195,33.111655328798186,34.22621315192744,20.0,40.0,424,1.0,421
1359,616,215,33.111655328798186,34.29587301587301,20.0,32.0,404,1.0,401
1360,616,235,33.111655328798186,35.71229024943311,20.0,29.0,397,3.0,381
1361,616,550,33.111655328798186,34.66739229024943,20.0,20.0,94,2.0,66
1362,616,561,33.111655328798186,35.94448979591837,20.0,19.0,134,3.0,55
1363,616,850,33.111655328798186,34.59773242630386,20.0,11.0,243,1.0,234
1364,616,848,33.111655328798186,35.54975056689342,20.0,9.0,255,2.0,232
1365,616,188,34.411972789115644,36.269569160997726,18.0,33.0,435,2.0,428
1366,616,235,34.411972789115644,35.71229024943311,18.0,29.0,385,1.0,381
1367,616,224,34.411972789115644,36.73396825396826,18.0,28.0,405,2.0,392
1368,616,256,34.411972789115644,37.26802721088436,18.0,29.0,380,3.0,360
1369,616,561,34.411972789115644,35.94448979591837,18.0,19.0,86,2.0,55
1370,616,480,34.411972789115644,36.73396825396826,18.0,22.0,169,2.0,136
1371,616,426,34.411972789115644,37.198367346938774,18.0,24.0,225,3.0,190
1372,616,848,34.411972789115644,35.54975056689342,18.0,9.0,237,1.0,232
1373,616,852,34.411972789115644,36.73396825396826,18.0,5.0,256,2.0,236
1374,616,841,34.411972789115644,37.198367346938774,18.0,7.0,255,3.0,225
1375,616,194,35.94448979591837,38.35936507936508,20.0,39.0,435,2.0,422
1376,616,256,35.94448979591837,37.26802721088436,20.0,29.0,364,1.0,360
1377,616,237,35.94448979591837,38.38258503401361,20.0,31.0,393,2.0,379
1378,616,426,35.94448979591837,37.198367346938774,20.0,24.0,198,1.0,190
1379,616,480,35.94448979591837,38.777324263038544,20.0,23.0,183,3.0,136
1380,616,841,35.94448979591837,37.198367346938774,20.0,7.0,231,1.0,225
1381,616,867,35.94448979591837,38.75410430839002,20.0,6.0,279,3.0,251
1382,616,194,36.966167800453526,38.35936507936508,20.0,39.0,426,1.0,422
1383,616,237,36.966167800453526,38.38258503401361,20.0,31.0,384,1.0,379
1384,616,239,36.966167800453526,39.845442176870755,20.0,27.0,397,3.0,377
1385,616,480,36.966167800453526,38.777324263038544,20.0,23.0,157,2.0,136
1386,616,612,36.966167800453526,39.77578231292517,20.0,20.0,121,3.0,4
1387,616,867,36.966167800453526,38.75410430839002,20.0,6.0,263,2.0,251
1388,616,864,36.966167800453526,39.07918367346939,20.0,7.0,264,2.0,248
1389,616,239,37.47700680272109,39.845442176870755,20.0,27.0,391,2.0,377
1390,616,480,37.47700680272109,38.777324263038544,20.0,23.0,147,1.0,136
1391,616,612,37.47700680272109,39.77578231292517,20.0,20.0,99,2.0,4
1392,616,867,37.47700680272109,38.75410430839002,20.0,6.0,257,1.0,251
1393,616,864,37.47700680272109,39.07918367346939,20.0,7.0,257,2.0,248
1394,616,861,37.47700680272109,40.24018140589568,20.0,7.0,272,3.0,245
1395,616,178,38.24326530612245,40.61170068027211,20.0,31.0,450,2.0,438
1396,616,239,38.24326530612245,39.845442176870755,20.0,27.0,383,2.0,377
1397,616,256,38.24326530612245,40.82068027210885,20.0,28.0,377,3.0,360
1398,616,612,38.24326530612245,39.77578231292517,20.0,20.0,66,2.0,4
1399,616,444,38.24326530612245,40.82068027210885,20.0,21.0,205,3.0,172
1400,616,861,38.24326530612245,40.24018140589568,20.0,7.0,260,2.0,245
1401,616,151,39.77578231292517,42.42285714285715,21.0,35.0,479,3.0,465
1402,616,256,39.77578231292517,40.82068027210885,21.0,28.0,363,1.0,360
1403,616,256,39.77578231292517,41.37795918367347,21.0,32.0,367,2.0,360
1404,616,216,39.77578231292517,42.399637188208615,21.0,31.0,416,3.0,400
1405,616,444,39.77578231292517,40.82068027210885,21.0,21.0,178,1.0,172
1406,616,528,39.77578231292517,41.865578231292524,21.0,22.0,126,2.0,88
1407,616,830,39.77578231292517,41.84235827664399,21.0,7.0,232,2.0,214
1408,616,151,40.03120181405896,42.42285714285715,20.0,35.0,476,2.0,465
1409,616,256,40.03120181405896,41.37795918367347,20.0,32.0,365,1.0,360
1410,616,216,40.03120181405896,42.399637188208615,20.0,31.0,413,2.0,400
1411,616,528,40.03120181405896,41.865578231292524,20.0,22.0,118,2.0,88
1412,616,550,40.03120181405896,42.86403628117914,20.0,22.0,139,3.0,66
1413,616,830,40.03120181405896,41.84235827664399,20.0,7.0,228,2.0,214
1414,616,852,40.03120181405896,42.84081632653061,20.0,9.0,265,3.0,236
1415,616,151,41.33151927437642,42.42285714285715,21.0,35.0,467,1.0,465
1416,616,216,41.33151927437642,42.399637188208615,21.0,31.0,403,1.0,400
1417,616,218,41.33151927437642,43.42131519274376,21.0,25.0,408,2.0,398
1418,616,550,41.33151927437642,42.86403628117914,21.0,22.0,93,2.0,66
1419,616,475,41.33151927437642,43.37487528344671,21.0,19.0,166,2.0,141
1420,616,852,41.33151927437642,42.84081632653061,21.0,9.0,245,2.0,236
1421,616,842,41.33151927437642,43.37487528344671,21.0,3.0,243,2.0,226
1422,616,842,41.33151927437642,44.141133786848066,21.0,3.0,256,3.0,226
1423,616,193,42.60861678004535,44.74485260770975,19.0,36.0,433,2.0,423
1424,616,174,42.60861678004535,45.441451247165524,19.0,36.0,459,3.0,442
1425,616,256,42.60861678004535,44.93061224489796,19.0,29.0,374,2.0,360
1426,616,256,42.60861678004535,45.46467120181406,19.0,31.0,380,3.0,360
1427,616,444,42.60861678004535,44.93061224489796,19.0,22.0,199,2.0,172
1428,616,612,42.60861678004535,45.41823129251701,19.0,18.0,121,3.0,4
1429,616,842,42.60861678004535,44.141133786848066,19.0,3.0,235,2.0,226
1430,616,852,42.60861678004535,45.441451247165524,19.0,6.0,266,3.0,236
1431,616,174,43.88571428571429,45.441451247165524,20.0,36.0,447,2.0,442
1432,616,192,43.88571428571429,46.25414965986395,20.0,34.0,436,2.0,424
1433,616,256,43.88571428571429,44.93061224489796,20.0,29.0,363,1.0,360
1434,616,256,43.88571428571429,45.46467120181406,20.0,31.0,366,2.0,360
1435,616,214,43.88571428571429,46.18448979591837,20.0,33.0,414,2.0,402
1436,616,444,43.88571428571429,44.93061224489796,20.0,22.0,178,1.0,172
1437,616,612,43.88571428571429,45.41823129251701,20.0,18.0,66,2.0,4
1438,616,852,43.88571428571429,45.441451247165524,20.0,6.0,245,2.0,236
1439,616,846,43.88571428571429,46.71854875283447,20.0,5.0,260,3.0,230
1440,616,174,44.141133786848066,45.441451247165524,20.0,36.0,446,1.0,442
1441,616,192,44.141133786848066,46.25414965986395,20.0,34.0,434,2.0,424
1442,616,256,44.141133786848066,45.46467120181406,20.0,31.0,364,1.0,360
1443,616,214,44.141133786848066,46.18448979591837,20.0,33.0,412,2.0,402
1444,616,256,44.141133786848066,46.997188208616784,20.0,27.0,380,3.0,360
1445,616,612,44.141133786848066,45.41823129251701,20.0,18.0,55,1.0,4
1446,616,444,44.141133786848066,46.973968253968245,20.0,22.0,211,3.0,172
1447,616,420,44.141133786848066,46.997188208616784,20.0,22.0,231,3.0,196
1448,616,852,44.141133786848066,45.441451247165524,20.0,6.0,243,1.0,236
1449,616,846,44.141133786848066,46.71854875283447,20.0,5.0,255,3.0,230
1450,616,838,44.141133786848066,46.997188208616784,20.0,4.0,254,3.0,222
1451,616,256,45.41823129251701,46.997188208616784,19.0,27.0,366,2.0,360
1452,616,444,45.41823129251701,46.973968253968245,19.0,22.0,185,2.0,172
1453,616,420,45.41823129251701,46.997188208616784,19.0,22.0,207,2.0,196
1454,616,504,45.41823129251701,47.9956462585034,19.0,20.0,158,3.0,112
1455,616,846,45.41823129251701,46.71854875283447,19.0,5.0,237,1.0,230
1456,616,838,45.41823129251701,46.997188208616784,19.0,4.0,232,2.0,222
1457,616,842,45.41823129251701,48.251065759637186,19.0,4.0,257,3.0,226
1458,616,211,46.20770975056689,48.76190476190477,18.0,29.0,420,3.0,405
1459,616,504,46.20770975056689,47.9956462585034,18.0,20.0,136,2.0,112
1460,616,480,46.20770975056689,49.040544217687085,18.0,21.0,183,3.0,136
1461,616,842,46.20770975056689,48.251065759637186,18.0,4.0,243,2.0,226
1462,616,174,47.74022675736961,49.574603174603176,20.0,33.0,449,2.0,442
1463,616,175,47.74022675736961,50.596281179138316,20.0,34.0,458,3.0,441
1464,616,211,47.74022675736961,48.76190476190477,20.0,29.0,407,1.0,405
1465,616,255,47.74022675736961,49.574603174603176,20.0,29.0,370,2.0,361
1466,616,231,47.74022675736961,50.642721088435366,20.0,32.0,405,3.0,385
1467,616,480,47.74022675736961,49.040544217687085,20.0,21.0,147,1.0,136
1468,616,562,47.74022675736961,50.10866213151928,20.0,24.0,115,2.0,54
1469,616,617,47.74022675736961,49.783582766439906,20.0,18.0,88,2.0,1
1470,616,649,47.74022675736961,50.062222222222225,20.0,16.0,105,2.0,33
1471,616,863,47.74022675736961,49.48172335600907,20.0,10.0,258,2.0,247
1472,616,831,47.74022675736961,50.45696145124717,20.0,8.0,245,3.0,215
1473,616,174,48.251065759637186,49.574603174603176,21.0,33.0,446,1.0,442
1474,616,175,48.251065759637186,50.596281179138316,21.0,34.0,452,2.0,441
1475,616,255,48.251065759637186,49.574603174603176,21.0,29.0,365,1.0,361
1476,616,231,48.251065759637186,50.642721088435366,21.0,32.0,399,2.0,385
1477,616,562,48.251065759637186,50.10866213151928,21.0,24.0,97,2.0,54
1478,616,475,48.251065759637186,51.083900226757365,21.0,23.0,186,3.0,141
1479,616,617,48.251065759637186,49.783582766439906,21.0,18.0,66,2.0,1
1480,616,649,48.251065759637186,50.062222222222225,21.0,16.0,85,2.0,33
1481,616,863,48.251065759637186,49.48172335600907,21.0,10.0,253,1.0,247
1482,616,831,48.251065759637186,50.45696145124717,21.0,8.0,235,2.0,215
1483,617,203,49.783582766439906,51.641179138322,18.0,37.0,422,2.0,414
1484,617,146,49.783582766439906,52.22167800453515,18.0,28.0,483,2.0,471
1485,617,231,49.783582766439906,51.85015873015873,18.0,34.0,396,2.0,386
1486,617,243,49.783582766439906,52.19845804988664,18.0,33.0,388,2.0,374
1487,617,475,49.783582766439906,51.083900226757365,18.0,23.0,153,1.0,142
1488,617,616,49.783582766439906,51.06068027210885,18.0,18.0,55,1.0,1
1489,617,616,49.783582766439906,52.36099773242631,18.0,19.0,111,3.0,1
1490,617,853,49.783582766439906,51.52507936507936,18.0,10.0,248,2.0,236
1491,617,826,49.783582766439906,52.569977324263036,18.0,7.0,241,3.0,209
1492,649,203,50.062222222222225,51.641179138322,16.0,37.0,451,2.0,446
1493,649,231,50.062222222222225,51.85015873015873,16.0,34.0,425,2.0,418
1494,649,243,50.062222222222225,52.19845804988664,16.0,33.0,416,2.0,406
1495,649,475,50.062222222222225,51.083900226757365,16.0,23.0,179,1.0,174
1496,649,487,50.062222222222225,52.96471655328799,16.0,20.0,205,3.0,162
1497,649,616,50.062222222222225,52.36099773242631,16.0,19.0,104,2.0,33
1498,649,853,50.062222222222225,51.52507936507936,16.0,10.0,214,1.0,204
1499,649,826,50.062222222222225,52.569977324263036,16.0,7.0,207,3.0,177
1500,616,146,51.06068027210885,52.22167800453515,18.0,28.0,473,1.0,470
1501,616,151,51.06068027210885,53.52199546485261,18.0,32.0,477,2.0,465
1502,616,243,51.06068027210885,52.19845804988664,18.0,33.0,376,1.0,373
1503,616,216,51.06068027210885,53.916734693877544,18.0,32.0,418,3.0,400
1504,616,233,51.06068027210885,54.00961451247166,18.0,29.0,404,3.0,383
1505,616,487,51.06068027210885,52.96471655328799,18.0,20.0,153,2.0,129
1506,616,446,51.06068027210885,53.12725623582767,18.0,22.0,192,2.0,170
1507,616,826,51.06068027210885,52.569977324263036,18.0,7.0,220,2.0,210
1508,616,865,51.06068027210885,53.12725623582767,18.0,5.0,264,2.0,249
1509,616,151,52.36099773242631,53.52199546485261,19.0,32.0,468,1.0,465
1510,616,216,52.36099773242631,53.916734693877544,19.0,32.0,406,2.0,400
1511,616,233,52.36099773242631,54.00961451247166,19.0,29.0,390,2.0,383
1512,616,476,52.36099773242631,54.659773242630386,19.0,19.0,171,2.0,140
1513,616,550,52.36099773242631,55.17061224489796,19.0,23.0,138,3.0,66
1514,616,838,52.36099773242631,54.125714285714295,19.0,8.0,235,2.0,222
1515,616,852,52.36099773242631,55.19383219954649,19.0,6.0,266,3.0,236
1516,616,155,53.89351473922903,55.727891156462576,20.0,29.0,468,2.0,461
1517,616,242,53.89351473922903,55.751111111111115,20.0,30.0,382,2.0,374
1518,616,246,53.89351473922903,56.21551020408163,20.0,25.0,383,2.0,370
1519,616,550,53.89351473922903,55.17061224489796,20.0,23.0,86,1.0,66
1520,616,581,53.89351473922903,56.796009070294794,20.0,20.0,130,3.0,35
1521,616,852,53.89351473922903,55.19383219954649,20.0,6.0,243,1.0,236
1522,616,842,53.89351473922903,56.4477097505669,20.0,4.0,251,3.0,226
1523,616,185,54.91519274376417,57.74802721088435,21.0,27.0,448,3.0,431
1524,616,246,54.91519274376417,56.21551020408163,21.0,25.0,374,1.0,370
1525,616,242,54.91519274376417,57.771247165532884,21.0,30.0,394,3.0,374
1526,616,581,54.91519274376417,56.796009070294794,21.0,20.0,88,2.0,35
1527,616,444,54.91519274376417,57.23718820861678,21.0,22.0,199,2.0,172
1528,616,842,54.91519274376417,56.4477097505669,21.0,4.0,235,2.0,226
1529,616,185,55.93687074829932,57.74802721088435,20.0,27.0,438,2.0,431
1530,616,242,55.93687074829932,57.771247165532884,20.0,30.0,382,2.0,374
1531,616,243,55.93687074829932,58.53750566893424,20.0,29.0,389,3.0,373
1532,616,444,55.93687074829932,57.23718820861678,20.0,22.0,181,1.0,172
1533,616,562,55.93687074829932,58.35174603174603,20.0,23.0,117,2.0,54
1534,616,830,55.93687074829932,58.25886621315193,20.0,5.0,236,2.0,214
1535,616,185,56.4477097505669,57.74802721088435,24.0,27.0,435,1.0,431
1536,616,242,56.4477097505669,57.771247165532884,24.0,30.0,378,1.0,374
1537,616,243,56.4477097505669,58.53750566893424,24.0,29.0,384,2.0,373
1538,616,562,56.4477097505669,58.35174603174603,24.0,23.0,98,2.0,54
1539,616,480,56.4477097505669,59.28054421768707,24.0,22.0,183,3.0,136
1540,616,830,56.4477097505669,58.25886621315193,24.0,5.0,228,2.0,214
1541,616,865,56.4477097505669,59.28054421768707,24.0,5.0,277,3.0,249
1542,616,242,57.72480725623583,59.86104308390022,20.0,36.0,385,2.0,374
1543,616,480,57.72480725623583,59.28054421768707,20.0,22.0,152,2.0,136
1544,616,865,57.72480725623583,59.28054421768707,20.0,5.0,258,2.0,249
1545,616,242,58.00344671201814,59.86104308390022,18.0,36.0,382,2.0,374
1546,616,480,58.00344671201814,59.28054421768707,18.0,22.0,147,1.0,136
1547,616,865,58.00344671201814,59.28054421768707,18.0,5.0,255,1.0,249
1548,865,445,17.205986394557822,18.250884353741494,4.0,23.0,422,1.0,420
1549,865,530,17.205986394557822,19.87628117913832,4.0,21.0,354,3.0,335
1550,865,615,17.205986394557822,18.22766439909297,4.0,18.0,254,1.0,250
1551,865,616,17.205986394557822,19.527981859410428,4.0,19.0,268,2.0,249
1552,865,867,17.205986394557822,18.22766439909297,4.0,7.0,44,1.0,2
1553,865,869,17.205986394557822,19.202902494331067,4.0,5.0,86,2.0,4
1554,867,530,18.22766439909297,19.87628117913832,7.0,21.0,344,2.0,337
1555,867,480,18.22766439909297,20.31746031746032,7.0,22.0,397,2.0,387
1556,867,561,18.22766439909297,21.08371882086168,7.0,20.0,330,3.0,306
1557,867,616,18.22766439909297,19.527981859410428,7.0,19.0,257,1.0,251
1558,867,616,18.22766439909297,20.80507936507936,7.0,16.0,274,3.0,251
1559,867,616,18.22766439909297,21.060498866213152,7.0,20.0,279,3.0,251
1560,867,864,18.22766439909297,20.294240362811788,7.0,4.0,89,2.0,3
1561,869,480,19.202902494331067,20.31746031746032,5.0,22.0,392,1.0,389
1562,869,561,19.202902494331067,21.08371882086168,5.0,20.0,318,2.0,308
1563,869,616,19.202902494331067,20.80507936507936,5.0,16.0,262,2.0,253
1564,869,616,19.202902494331067,21.060498866213152,5.0,20.0,265,2.0,253
1565,869,864,19.202902494331067,20.294240362811788,5.0,4.0,47,1.0,5
1566,869,822,19.202902494331067,21.524897959183672,5.0,8.0,110,2.0,47
1567,864,480,20.294240362811788,22.360816326530614,4.0,23.0,394,2.0,384
1568,864,561,20.294240362811788,23.12707482993197,4.0,20.0,327,3.0,303
1569,864,616,20.294240362811788,22.6162358276644,4.0,18.0,267,2.0,248
1570,864,616,20.294240362811788,23.12707482993197,4.0,19.0,276,3.0,248
1571,864,822,20.294240362811788,21.524897959183672,4.0,8.0,68,1.0,42
1572,864,865,20.294240362811788,22.337596371882086,4.0,4.0,88,2.0,1
1573,864,847,20.294240362811788,23.26639455782313,4.0,8.0,129,3.0,17
1574,822,561,21.524897959183672,23.12707482993197,8.0,20.0,270,2.0,261
1575,822,480,21.524897959183672,24.427392290249433,8.0,21.0,364,3.0,342
1576,822,616,21.524897959183672,22.6162358276644,8.0,18.0,211,1.0,206
1577,822,616,21.524897959183672,23.12707482993197,8.0,19.0,217,2.0,206
1578,822,847,21.524897959183672,23.26639455782313,8.0,8.0,79,2.0,25
1579,865,480,22.337596371882086,24.427392290249433,4.0,21.0,395,2.0,385
1580,865,616,22.337596371882086,24.91501133786848,4.0,20.0,273,3.0,249
1581,865,616,22.337596371882086,25.17043083900227,4.0,21.0,277,3.0,249
1582,865,842,22.337596371882086,24.91501133786848,4.0,4.0,113,3.0,23
1583,847,480,23.26639455782313,24.427392290249433,8.0,21.0,370,1.0,367
1584,847,562,23.26639455782313,25.44907029478458,8.0,30.0,300,2.0,285
1585,847,616,23.26639455782313,24.91501133786848,8.0,20.0,242,2.0,231
1586,847,616,23.26639455782313,25.17043083900227,8.0,21.0,245,2.0,231
1587,847,616,23.26639455782313,26.19210884353741,8.0,21.0,263,3.0,231
1588,847,842,23.26639455782313,24.91501133786848,8.0,4.0,71,2.0,5
1589,847,829,23.26639455782313,25.495510204081636,8.0,5.0,98,2.0,18
1590,842,480,24.91501133786848,26.47074829931973,4.0,22.0,368,2.0,362
1591,842,562,24.91501133786848,26.981587301587304,4.0,20.0,294,2.0,280
1592,842,616,24.91501133786848,26.19210884353741,4.0,21.0,233,1.0,226
1593,842,616,24.91501133786848,27.21378684807256,4.0,19.0,247,2.0,226
1594,842,859,24.91501133786848,26.424308390022677,4.0,10.0,67,2.0,17
1595,829,562,25.495510204081636,26.981587301587304,5.0,20.0,275,1.0,267
1596,829,616,25.495510204081636,27.21378684807256,5.0,19.0,225,2.0,213
1597,829,616,25.495510204081636,28.328344671201812,5.0,17.0,245,3.0,213
1598,829,842,25.495510204081636,27.724625850340136,5.0,3.0,97,2.0,13
1599,859,550,26.424308390022677,28.51410430839002,10.0,21.0,322,2.0,309
1600,859,561,26.424308390022677,29.0249433106576,10.0,20.0,318,3.0,298
1601,859,616,26.424308390022677,28.328344671201812,10.0,17.0,256,2.0,243
1602,859,616,26.424308390022677,29.280362811791388,10.0,21.0,272,3.0,243
1603,859,842,26.424308390022677,27.724625850340136,10.0,3.0,59,1.0,17
1604,859,878,26.424308390022677,28.4908843537415,10.0,10.0,91,2.0,19
1605,859,842,26.424308390022677,29.280362811791388,10.0,3.0,124,3.0,17
1606,842,561,27.724625850340136,29.0249433106576,3.0,20.0,287,1.0,281
1607,842,550,27.724625850340136,30.557460317460322,3.0,23.0,316,3.0,292
1608,842,616,27.724625850340136,29.280362811791388,3.0,21.0,236,2.0,226
1609,842,616,27.724625850340136,30.04662131519275,3.0,19.0,247,2.0,226
1610,842,868,27.724625850340136,30.557460317460322,3.0,6.0,125,3.0,26
1611,878,550,28.4908843537415,30.557460317460322,10.0,23.0,340,2.0,328
1612,878,616,28.4908843537415,30.04662131519275,10.0,19.0,270,2.0,262
1613,878,616,28.4908843537415,31.32371882086168,10.0,19.0,289,3.0,262
1614,878,868,28.4908843537415,30.557460317460322,10.0,6.0,90,2.0,10
1615,878,826,28.4908843537415,31.021859410430842,10.0,7.0,121,3.0,52
1616,842,550,29.280362811791388,30.557460317460322,3.0,23.0,297,1.0,292
1617,842,411,29.280362811791388,31.579138321995462,3.0,23.0,442,2.0,431
1618,842,411,29.280362811791388,32.04353741496599,3.0,25.0,447,3.0,431
1619,842,616,29.280362811791388,31.32371882086168,3.0,19.0,243,2.0,226
1620,842,868,29.280362811791388,30.557460317460322,3.0,6.0,61,1.0,26
1621,842,826,29.280362811791388,31.021859410430842,3.0,7.0,77,2.0,16
1622,868,411,30.557460317460322,31.579138321995462,6.0,23.0,459,1.0,457
1623,868,411,30.557460317460322,32.04353741496599,6.0,25.0,461,1.0,457
1624,868,489,30.557460317460322,33.2974149659864,6.0,27.0,397,3.0,379
1625,868,616,30.557460317460322,32.43827664399093,6.0,17.0,265,2.0,252
1626,868,616,30.557460317460322,33.111655328798186,6.0,20.0,275,3.0,252
1627,868,855,30.557460317460322,32.53115646258504,6.0,3.0,86,2.0,13
1628,826,411,31.021859410430842,32.04353741496599,7.0,25.0,417,1.0,415
1629,826,489,31.021859410430842,33.2974149659864,7.0,27.0,351,2.0,337
1630,826,616,31.021859410430842,32.43827664399093,7.0,17.0,219,1.0,210
1631,826,616,31.021859410430842,33.111655328798186,7.0,20.0,228,2.0,210
1632,826,855,31.021859410430842,32.53115646258504,7.0,3.0,71,2.0,29
1633,826,855,31.021859410430842,33.552834467120185,7.0,8.0,113,3.0,29
1634,855,550,32.53115646258504,34.66739229024943,3.0,20.0,319,2.0,305
1635,855,616,32.53115646258504,34.411972789115644,3.0,18.0,252,2.0,239
1636,855,850,32.53115646258504,34.59773242630386,3.0,11.0,89,2.0,5
1637,855,550,33.552834467120185,34.66739229024943,8.0,20.0,309,1.0,305
1638,855,561,33.552834467120185,35.94448979591837,8.0,19.0,312,2.0,294
1639,855,616,33.552834467120185,35.94448979591837,8.0,20.0,260,2.0,239
1640,855,850,33.552834467120185,34.59773242630386,8.0,11.0,45,1.0,5
1641,855,848,33.552834467120185,35.54975056689342,8.0,9.0,86,2.0,7
1642,850,561,34.59773242630386,35.94448979591837,11.0,19.0,295,1.0,289
1643,850,480,34.59773242630386,36.73396825396826,11.0,22.0,381,2.0,370
1644,850,426,34.59773242630386,37.198367346938774,11.0,24.0,439,3.0,424
1645,850,616,34.59773242630386,35.94448979591837,11.0,20.0,241,1.0,234
1646,850,616,34.59773242630386,36.966167800453526,11.0,20.0,255,2.0,234
1647,850,616,34.59773242630386,37.47700680272109,11.0,20.0,265,3.0,234
1648,850,852,34.59773242630386,36.73396825396826,11.0,5.0,92,2.0,2
1649,850,841,34.59773242630386,37.198367346938774,11.0,7.0,112,3.0,9
1650,848,480,35.54975056689342,36.73396825396826,9.0,22.0,372,1.0,368
1651,848,426,35.54975056689342,37.198367346938774,9.0,24.0,428,2.0,422
1652,848,616,35.54975056689342,36.966167800453526,9.0,20.0,240,1.0,232
1653,848,616,35.54975056689342,37.47700680272109,9.0,20.0,246,2.0,232
1654,848,616,35.54975056689342,38.24326530612245,9.0,20.0,259,3.0,232
1655,848,852,35.54975056689342,36.73396825396826,9.0,5.0,51,1.0,4
1656,848,841,35.54975056689342,37.198367346938774,9.0,7.0,71,2.0,7
1657,852,480,36.73396825396826,38.777324263038544,5.0,23.0,382,2.0,372
1658,852,616,36.73396825396826,38.24326530612245,5.0,20.0,245,2.0,236
1659,852,867,36.73396825396826,38.75410430839002,5.0,6.0,88,2.0,15
1660,852,864,36.73396825396826,39.07918367346939,5.0,7.0,102,2.0,12
1661,841,480,37.198367346938774,38.777324263038544,7.0,23.0,367,2.0,361
1662,841,612,37.198367346938774,39.77578231292517,7.0,20.0,254,3.0,229
1663,841,616,37.198367346938774,38.24326530612245,7.0,20.0,229,1.0,225
1664,841,616,37.198367346938774,39.77578231292517,7.0,21.0,251,3.0,225
1665,841,616,37.198367346938774,40.03120181405896,7.0,20.0,256,3.0,225
1666,841,867,37.198367346938774,38.75410430839002,7.0,6.0,72,2.0,26
1667,841,864,37.198367346938774,39.07918367346939,7.0,7.0,84,2.0,23
1668,867,612,38.75410430839002,39.77578231292517,6.0,20.0,259,1.0,255
1669,867,444,38.75410430839002,40.82068027210885,6.0,21.0,432,2.0,423
1670,867,616,38.75410430839002,39.77578231292517,6.0,21.0,255,1.0,251
1671,867,616,38.75410430839002,40.03120181405896,6.0,20.0,257,1.0,251
1672,867,616,38.75410430839002,41.33151927437642,6.0,21.0,274,3.0,251
1673,867,861,38.75410430839002,40.24018140589568,6.0,7.0,64,1.0,6
1674,864,444,39.07918367346939,40.82068027210885,7.0,21.0,427,2.0,420
1675,864,528,39.07918367346939,41.865578231292524,7.0,22.0,357,3.0,336
1676,864,616,39.07918367346939,41.33151927437642,7.0,21.0,266,2.0,248
1677,864,861,39.07918367346939,40.24018140589568,7.0,7.0,50,1.0,3
1678,864,830,39.07918367346939,41.84235827664399,7.0,7.0,124,3.0,34
1679,861,528,40.24018140589568,41.865578231292524,7.0,22.0,340,2.0,333
1680,861,550,40.24018140589568,42.86403628117914,7.0,22.0,331,3.0,311
1681,861,616,40.24018140589568,41.33151927437642,7.0,21.0,249,1.0,245
1682,861,616,40.24018140589568,42.60861678004535,7.0,19.0,265,2.0,245
1683,861,830,40.24018140589568,41.84235827664399,7.0,7.0,76,2.0,31
1684,861,852,40.24018140589568,42.84081632653061,7.0,9.0,112,3.0,9
1685,830,550,41.84235827664399,42.86403628117914,7.0,22.0,283,1.0,280
1686,830,475,41.84235827664399,43.37487528344671,7.0,19.0,361,2.0,355
1687,830,616,41.84235827664399,43.88571428571429,7.0,20.0,231,2.0,214
1688,830,616,41.84235827664399,44.141133786848066,7.0,20.0,236,2.0,214
1689,830,842,41.84235827664399,43.37487528344671,7.0,3.0,67,2.0,12
1690,830,842,41.84235827664399,44.141133786848066,7.0,3.0,100,2.0,12
1691,852,444,42.84081632653061,44.93061224489796,9.0,22.0,418,2.0,408
1692,852,612,42.84081632653061,45.41823129251701,9.0,18.0,264,3.0,240
1693,852,616,42.84081632653061,43.88571428571429,9.0,20.0,240,1.0,236
1694,852,616,42.84081632653061,44.141133786848066,9.0,20.0,243,1.0,236
1695,852,616,42.84081632653061,45.41823129251701,9.0,19.0,261,3.0,236
1696,852,842,42.84081632653061,44.141133786848066,9.0,3.0,57,1.0,10
1697,842,444,43.37487528344671,44.93061224489796,3.0,22.0,404,2.0,398
1698,842,612,43.37487528344671,45.41823129251701,3.0,18.0,246,2.0,230
1699,842,616,43.37487528344671,45.41823129251701,3.0,19.0,243,2.0,226
1700,842,616,43.37487528344671,46.20770975056689,3.0,18.0,257,3.0,226
1701,842,852,43.37487528344671,45.441451247165524,3.0,6.0,90,2.0,10
1702,842,612,44.141133786848066,45.41823129251701,3.0,18.0,236,1.0,230
1703,842,444,44.141133786848066,46.973968253968245,3.0,22.0,416,3.0,398
1704,842,420,44.141133786848066,46.997188208616784,3.0,22.0,440,3.0,422
1705,842,616,44.141133786848066,45.41823129251701,3.0,19.0,233,1.0,226
1706,842,616,44.141133786848066,46.20770975056689,3.0,18.0,243,2.0,226
1707,842,852,44.141133786848066,45.441451247165524,3.0,6.0,57,1.0,10
1708,842,846,44.141133786848066,46.71854875283447,3.0,5.0,111,3.0,4
1709,842,838,44.141133786848066,46.997188208616784,3.0,4.0,123,3.0,4
1710,852,444,45.441451247165524,46.973968253968245,6.0,22.0,413,2.0,408
1711,852,420,45.441451247165524,46.997188208616784,6.0,22.0,437,2.0,432
1712,852,504,45.441451247165524,47.9956462585034,6.0,20.0,365,3.0,348
1713,852,616,45.441451247165524,47.74022675736961,6.0,20.0,256,2.0,236
1714,852,616,45.441451247165524,48.251065759637186,6.0,21.0,265,3.0,236
1715,852,846,45.441451247165524,46.71854875283447,6.0,5.0,55,1.0,6
1716,852,838,45.441451247165524,46.997188208616784,6.0,4.0,68,2.0,14
1717,852,842,45.441451247165524,48.251065759637186,6.0,4.0,121,3.0,10
1718,846,504,46.71854875283447,47.9956462585034,5.0,20.0,346,1.0,342
1719,846,480,46.71854875283447,49.040544217687085,5.0,21.0,379,2.0,366
1720,846,616,46.71854875283447,47.74022675736961,5.0,20.0,234,1.0,230
1721,846,616,46.71854875283447,48.251065759637186,5.0,21.0,239,2.0,230
1722,846,842,46.71854875283447,48.251065759637186,5.0,4.0,66,2.0,4
1723,846,863,46.71854875283447,49.48172335600907,5.0,10.0,120,3.0,17
1724,838,480,46.997188208616784,49.040544217687085,4.0,21.0,369,2.0,358
1725,838,616,46.997188208616784,48.251065759637186,4.0,21.0,228,1.0,222
1726,838,617,46.997188208616784,49.783582766439906,4.0,18.0,251,3.0,221
1727,838,842,46.997188208616784,48.251065759637186,4.0,4.0,54,1.0,4
1728,838,863,46.997188208616784,49.48172335600907,4.0,10.0,110,2.0,25
1729,842,562,48.251065759637186,50.10866213151928,4.0,24.0,291,2.0,280
1730,842,475,48.251065759637186,51.083900226757365,4.0,23.0,387,3.0,367
1731,842,617,48.251065759637186,49.783582766439906,4.0,18.0,234,2.0,225
1732,842,649,48.251065759637186,50.062222222222225,4.0,16.0,208,2.0,193
1733,842,616,48.251065759637186,51.06068027210885,4.0,18.0,256,3.0,226
1734,842,863,48.251065759637186,49.48172335600907,4.0,10.0,57,1.0,21
1735,842,831,48.251065759637186,50.45696145124717,4.0,8.0,96,2.0,11
1736,863,475,49.48172335600907,51.083900226757365,10.0,23.0,394,2.0,388
1737,863,616,49.48172335600907,51.06068027210885,10.0,18.0,256,2.0,247
1738,863,616,49.48172335600907,52.36099773242631,10.0,19.0,276,3.0,247
1739,863,853,49.48172335600907,51.52507936507936,10.0,10.0,89,2.0,10
1740,831,487,50.45696145124717,52.96471655328799,8.0,20.0,361,3.0,344
1741,831,446,50.45696145124717,53.12725623582767,8.0,22.0,402,3.0,385
1742,831,616,50.45696145124717,52.36099773242631,8.0,19.0,230,2.0,215
1743,831,853,50.45696145124717,51.52507936507936,8.0,10.0,51,1.0,22
1744,831,826,50.45696145124717,52.569977324263036,8.0,7.0,91,2.0,5
1745,831,865,50.45696145124717,53.12725623582767,8.0,5.0,120,3.0,34
1746,853,487,51.52507936507936,52.96471655328799,10.0,20.0,371,1.0,366
1747,853,446,51.52507936507936,53.12725623582767,10.0,22.0,413,2.0,407
1748,853,616,51.52507936507936,53.89351473922903,10.0,20.0,258,2.0,237
1749,853,826,51.52507936507936,52.569977324263036,10.0,7.0,52,1.0,27
1750,853,865,51.52507936507936,53.12725623582767,10.0,5.0,70,2.0,12
1751,853,838,51.52507936507936,54.125714285714295,10.0,8.0,113,3.0,15
1752,826,476,52.569977324263036,54.659773242630386,7.0,19.0,361,2.0,350
1753,826,550,52.569977324263036,55.17061224489796,7.0,23.0,298,3.0,276
1754,826,616,52.569977324263036,53.89351473922903,7.0,20.0,218,1.0,210
1755,826,616,52.569977324263036,54.91519274376417,7.0,21.0,233,2.0,210
1756,826,838,52.569977324263036,54.125714285714295,7.0,8.0,68,2.0,12
1757,826,852,52.569977324263036,55.19383219954649,7.0,6.0,116,3.0,26
1758,865,476,53.12725623582767,54.659773242630386,5.0,19.0,395,2.0,389
1759,865,550,53.12725623582767,55.17061224489796,5.0,23.0,327,2.0,315
1760,865,616,53.12725623582767,54.91519274376417,5.0,21.0,261,2.0,249
1761,865,616,53.12725623582767,55.93687074829932,5.0,20.0,277,3.0,249
1762,865,852,53.12725623582767,55.19383219954649,5.0,6.0,90,2.0,13
1763,838,550,54.125714285714295,55.17061224489796,8.0,23.0,291,1.0,288
1764,838,581,54.125714285714295,56.796009070294794,8.0,20.0,282,3.0,257
1765,838,616,54.125714285714295,55.93687074829932,8.0,20.0,235,2.0,222
1766,838,616,54.125714285714295,56.4477097505669,8.0,24.0,243,2.0,222
1767,838,852,54.125714285714295,55.19383219954649,8.0,6.0,48,1.0,14
1768,838,842,54.125714285714295,56.4477097505669,8.0,4.0,100,2.0,4
1769,852,581,55.19383219954649,56.796009070294794,6.0,20.0,280,2.0,271
1770,852,444,55.19383219954649,57.23718820861678,6.0,22.0,417,2.0,408
1771,852,616,55.19383219954649,56.4477097505669,6.0,24.0,242,1.0,236
1772,852,616,55.19383219954649,57.72480725623583,6.0,20.0,260,3.0,236
1773,852,616,55.19383219954649,58.00344671201814,6.0,18.0,265,3.0,236
1774,852,842,55.19383219954649,56.4477097505669,6.0,4.0,55,1.0,10
1775,842,562,56.4477097505669,58.35174603174603,4.0,23.0,292,2.0,280
1776,842,480,56.4477097505669,59.28054421768707,4.0,22.0,382,3.0,362
1777,842,616,56.4477097505669,57.72480725623583,4.0,20.0,233,1.0,226
1778,842,616,56.4477097505669,58.00344671201814,4.0,18.0,236,2.0,226
1779,842,616,56.4477097505669,59.025124716553286,4.0,20.0,252,3.0,226
1780,842,830,56.4477097505669,58.25886621315193,4.0,5.0,79,2.0,12
1781,842,865,56.4477097505669,59.28054421768707,4.0,5.0,124,3.0,23
1782,830,480,58.25886621315193,59.28054421768707,5.0,22.0,353,1.0,350
1783,830,865,58.25886621315193,59.28054421768707,5.0,5.0,56,1.0,35
