,f0,f1,t0,t1,dB0,dB1,dist,utime,ufreq
0,191,86,0.06965986394557823,1.6253968253968254,0.0,31.0,125,2.0,105
1,191,139,0.06965986394557823,2.2523356009070294,0.0,30.0,107,2.0,52
2,191,228,0.06965986394557823,1.4396371882086167,0.0,26.0,70,1.0,37
3,191,233,0.06965986394557823,2.2755555555555556,0.0,31.0,104,2.0,42
4,191,460,0.06965986394557823,1.8343764172335602,0.0,13.0,280,2.0,269
5,191,420,0.06965986394557823,2.2755555555555556,0.0,7.0,248,2.0,229
6,191,673,0.06965986394557823,1.4164172335600906,0.0,6.0,485,1.0,482
7,86,67,1.6253968253968254,3.297233560090703,31.0,33.0,74,2.0,19
8,86,204,1.6253968253968254,4.597551020408163,31.0,34.0,174,3.0,118
9,86,228,1.6253968253968254,3.784852607709751,31.0,25.0,170,2.0,142
10,86,206,1.6253968253968254,4.597551020408163,31.0,37.0,175,3.0,120
11,86,415,1.6253968253968254,3.784852607709751,31.0,9.0,342,2.0,329
12,139,67,2.2523356009070294,3.297233560090703,30.0,33.0,85,1.0,72
13,139,204,2.2523356009070294,4.597551020408163,30.0,34.0,120,2.0,65
14,139,228,2.2523356009070294,3.784852607709751,30.0,25.0,111,2.0,89
15,139,206,2.2523356009070294,4.597551020408163,30.0,37.0,121,2.0,67
16,139,415,2.2523356009070294,3.784852607709751,30.0,9.0,284,2.0,276
17,139,505,2.2523356009070294,4.922630385487529,30.0,14.0,384,3.0,366
18,139,632,2.2523356009070294,3.784852607709751,30.0,5.0,497,2.0,493
19,139,621,2.2523356009070294,4.899410430839002,30.0,17.0,495,3.0,482
20,67,204,3.297233560090703,4.597551020408163,33.0,34.0,148,1.0,137
21,67,129,3.297233560090703,5.758548752834467,33.0,31.0,123,2.0,62
22,67,206,3.297233560090703,4.597551020408163,33.0,37.0,150,1.0,139
23,67,207,3.297233560090703,5.758548752834467,33.0,29.0,176,2.0,140
24,67,505,3.297233560090703,4.922630385487529,33.0,14.0,444,2.0,438
25,67,411,3.297233560090703,5.758548752834467,33.0,14.0,360,2.0,344
26,204,129,4.597551020408163,5.758548752834467,34.0,31.0,90,1.0,75
27,204,207,4.597551020408163,5.758548752834467,34.0,29.0,50,1.0,3
28,204,208,4.597551020408163,6.57124716553288,34.0,33.0,85,2.0,4
29,204,411,4.597551020408163,5.758548752834467,34.0,14.0,213,1.0,207
30,204,517,4.597551020408163,6.548027210884354,34.0,9.0,324,2.0,313
31,204,676,4.597551020408163,5.758548752834467,34.0,8.0,475,1.0,472
32,204,631,4.597551020408163,6.57124716553288,34.0,7.0,435,2.0,427
33,129,204,5.758548752834467,7.9412244897959186,31.0,32.0,120,2.0,75
34,129,205,5.758548752834467,7.964444444444444,31.0,32.0,122,2.0,76
35,129,205,5.758548752834467,7.987664399092971,31.0,32.0,122,2.0,76
36,129,467,5.758548752834467,7.75546485260771,31.0,10.0,349,2.0,338
37,129,545,5.758548752834467,8.40562358276644,31.0,22.0,431,3.0,416
38,204,65,6.57124716553288,8.962902494331066,32.0,41.0,173,2.0,139
39,204,84,6.57124716553288,9.05578231292517,32.0,42.0,161,2.0,120
40,204,205,6.57124716553288,7.964444444444444,32.0,32.0,60,1.0,1
41,204,205,6.57124716553288,7.987664399092971,32.0,32.0,61,1.0,1
42,204,241,6.57124716553288,9.05578231292517,32.0,28.0,113,2.0,37
43,204,467,6.57124716553288,7.75546485260771,32.0,10.0,268,1.0,263
44,204,545,6.57124716553288,8.40562358276644,32.0,22.0,350,2.0,341
45,204,636,6.57124716553288,7.894784580498866,32.0,8.0,436,1.0,432
46,204,629,6.57124716553288,8.359183673469389,32.0,20.0,432,2.0,425
47,204,65,7.9412244897959186,8.962902494331066,32.0,41.0,146,1.0,139
48,204,84,7.9412244897959186,9.05578231292517,32.0,42.0,129,1.0,120
49,204,75,7.9412244897959186,10.077460317460318,32.0,31.0,158,2.0,129
50,204,241,7.9412244897959186,9.05578231292517,32.0,28.0,61,1.0,37
51,204,251,7.9412244897959186,10.913378684807256,32.0,22.0,136,3.0,47
52,204,595,7.9412244897959186,9.7059410430839,32.0,21.0,398,2.0,391
53,204,459,7.9412244897959186,10.077460317460318,32.0,12.0,271,2.0,255
54,204,666,7.9412244897959186,9.7059410430839,32.0,20.0,468,2.0,462
55,65,75,8.962902494331066,10.077460317460318,41.0,31.0,49,1.0,10
56,65,19,8.962902494331066,11.00625850340136,41.0,29.0,99,2.0,46
57,65,251,8.962902494331066,10.913378684807256,41.0,22.0,204,2.0,186
58,65,255,8.962902494331066,11.168798185941043,41.0,24.0,212,2.0,190
59,65,459,8.962902494331066,10.077460317460318,41.0,12.0,397,1.0,394
60,65,513,8.962902494331066,11.261678004535147,41.0,6.0,459,2.0,448
61,84,75,9.05578231292517,10.077460317460318,42.0,31.0,45,1.0,9
62,84,19,9.05578231292517,11.00625850340136,42.0,29.0,106,2.0,65
63,84,251,9.05578231292517,10.913378684807256,42.0,22.0,185,2.0,167
64,84,255,9.05578231292517,11.168798185941043,42.0,24.0,194,2.0,171
65,84,459,9.05578231292517,10.077460317460318,42.0,12.0,378,1.0,375
66,84,513,9.05578231292517,11.261678004535147,42.0,6.0,439,2.0,429
67,75,65,10.077460317460318,12.445895691609978,31.0,24.0,102,2.0,10
68,75,255,10.077460317460318,11.168798185941043,31.0,24.0,186,1.0,180
69,75,255,10.077460317460318,12.422675736961452,31.0,34.0,206,2.0,180
70,75,513,10.077460317460318,11.261678004535147,31.0,6.0,441,1.0,438
71,75,515,10.077460317460318,12.07437641723356,31.0,17.0,448,2.0,440
72,19,65,11.00625850340136,12.445895691609978,29.0,24.0,77,1.0,46
73,19,138,11.00625850340136,13.955192743764172,29.0,27.0,174,3.0,119
74,19,255,11.00625850340136,12.422675736961452,29.0,34.0,244,1.0,236
75,19,255,11.00625850340136,13.583673469387755,29.0,28.0,261,3.0,236
76,19,515,11.00625850340136,12.07437641723356,29.0,17.0,498,1.0,496
77,65,138,12.445895691609978,13.955192743764172,24.0,27.0,98,2.0,73
78,65,82,12.445895691609978,14.071292517006803,24.0,36.0,72,2.0,17
79,65,130,12.445895691609978,15.09297052154195,24.0,36.0,131,3.0,65
80,65,255,12.445895691609978,13.583673469387755,24.0,28.0,196,1.0,190
81,65,232,12.445895691609978,14.373151927437641,24.0,19.0,186,2.0,167
82,65,458,12.445895691609978,14.210612244897959,24.0,15.0,400,2.0,393
83,138,130,13.955192743764172,15.09297052154195,27.0,36.0,50,1.0,8
84,138,68,13.955192743764172,16.81124716553288,27.0,32.0,142,3.0,70
85,138,260,13.955192743764172,15.789569160997733,27.0,23.0,145,2.0,122
86,138,261,13.955192743764172,16.068208616780044,27.0,21.0,153,2.0,123
87,138,477,13.955192743764172,15.766349206349206,27.0,18.0,348,2.0,339
88,138,605,13.955192743764172,16.27718820861678,27.0,19.0,478,2.0,467
89,82,130,14.071292517006803,15.09297052154195,36.0,36.0,65,1.0,48
90,82,68,14.071292517006803,16.81124716553288,36.0,32.0,119,3.0,14
91,82,260,14.071292517006803,15.789569160997733,36.0,23.0,193,2.0,178
92,82,261,14.071292517006803,16.068208616780044,36.0,21.0,199,2.0,179
93,82,477,14.071292517006803,15.766349206349206,36.0,18.0,402,2.0,395
94,130,68,15.09297052154195,16.81124716553288,36.0,32.0,97,2.0,62
95,130,29,15.09297052154195,17.623945578231293,36.0,35.0,149,3.0,101
96,130,255,15.09297052154195,17.11310657596372,36.0,20.0,152,2.0,125
97,130,605,15.09297052154195,16.27718820861678,36.0,19.0,478,1.0,475
98,130,537,15.09297052154195,17.531065759637187,36.0,16.0,420,2.0,407
99,130,616,15.09297052154195,17.531065759637187,36.0,18.0,497,2.0,486
100,68,22,16.81124716553288,18.15800453514739,32.0,30.0,74,1.0,46
101,68,208,16.81124716553288,18.692063492063493,32.0,17.0,162,2.0,140
102,68,205,16.81124716553288,19.086802721088436,32.0,28.0,168,2.0,137
103,68,498,16.81124716553288,18.320544217687075,32.0,20.0,435,2.0,430
104,29,57,17.623945578231293,19.82984126984127,35.0,32.0,99,2.0,28
105,29,22,17.623945578231293,20.17814058956916,35.0,32.0,110,3.0,7
106,29,208,17.623945578231293,18.692063492063493,35.0,17.0,185,1.0,179
107,29,205,17.623945578231293,19.086802721088436,35.0,28.0,187,1.0,176
108,29,478,17.623945578231293,19.922721088435374,35.0,22.0,460,2.0,449
109,29,475,17.623945578231293,20.526439909297054,35.0,15.0,463,3.0,446
110,22,57,18.15800453514739,19.82984126984127,30.0,32.0,80,2.0,35
111,22,232,18.15800453514739,20.688979591836734,30.0,23.0,237,3.0,210
112,22,228,18.15800453514739,21.037278911564627,30.0,27.0,240,3.0,206
113,22,478,18.15800453514739,19.922721088435374,30.0,22.0,462,2.0,456
114,22,475,18.15800453514739,20.526439909297054,30.0,15.0,464,2.0,453
115,57,22,19.82984126984127,21.501678004535147,32.0,30.0,80,2.0,35
116,57,22,19.82984126984127,22.38403628117914,32.0,33.0,115,3.0,35
117,57,228,19.82984126984127,21.037278911564627,32.0,27.0,179,1.0,171
118,57,459,19.82984126984127,21.36235827664399,32.0,23.0,407,2.0,402
119,57,463,19.82984126984127,22.221496598639455,32.0,9.0,419,2.0,406
120,22,202,20.17814058956916,23.034195011337868,32.0,31.0,218,3.0,180
121,22,235,20.17814058956916,22.96453514739229,32.0,25.0,244,3.0,213
122,22,234,20.17814058956916,22.98775510204082,32.0,32.0,244,3.0,212
123,22,459,20.17814058956916,21.36235827664399,32.0,23.0,440,1.0,437
124,22,463,20.17814058956916,22.221496598639455,32.0,9.0,450,2.0,441
125,22,472,20.17814058956916,23.057414965986396,32.0,20.0,467,3.0,450
126,22,202,21.501678004535147,23.034195011337868,30.0,31.0,192,2.0,180
127,22,235,21.501678004535147,22.96453514739229,30.0,25.0,222,1.0,213
128,22,234,21.501678004535147,22.98775510204082,30.0,32.0,221,1.0,212
129,22,472,21.501678004535147,23.057414965986396,30.0,20.0,455,2.0,450
130,22,204,22.38403628117914,24.961451247165535,33.0,26.0,213,3.0,182
131,22,204,22.38403628117914,24.98467120181406,33.0,31.0,214,3.0,182
132,22,205,22.38403628117914,24.961451247165535,33.0,32.0,214,3.0,183
133,22,205,22.38403628117914,24.98467120181406,33.0,32.0,215,3.0,183
134,22,499,22.38403628117914,24.961451247165535,33.0,17.0,490,3.0,477
135,202,204,23.034195011337868,24.961451247165535,31.0,26.0,83,2.0,2
136,202,204,23.034195011337868,24.98467120181406,31.0,31.0,84,2.0,2
137,202,205,23.034195011337868,24.961451247165535,31.0,32.0,83,2.0,3
138,202,205,23.034195011337868,24.98467120181406,31.0,32.0,84,2.0,3
139,202,499,23.034195011337868,24.961451247165535,31.0,17.0,308,2.0,297
140,202,508,23.034195011337868,25.379410430839002,31.0,23.0,322,2.0,306
141,202,670,23.034195011337868,24.961451247165535,31.0,14.0,475,2.0,468
142,202,681,23.034195011337868,25.007891156462584,31.0,23.0,486,2.0,479
143,204,124,24.961451247165535,26.865487528344673,26.0,31.0,115,2.0,80
144,204,31,24.961451247165535,27.376326530612246,26.0,28.0,202,2.0,173
145,204,232,24.961451247165535,26.865487528344673,26.0,23.0,87,2.0,28
146,204,245,24.961451247165535,27.353106575963718,26.0,26.0,111,2.0,41
147,204,524,24.961451247165535,26.122448979591837,26.0,20.0,324,1.0,320
148,204,479,24.961451247165535,27.678185941043086,26.0,25.0,299,3.0,275
149,204,625,24.961451247165535,26.888707482993198,26.0,26.0,429,2.0,421
150,204,621,24.961451247165535,27.678185941043086,26.0,28.0,433,3.0,417
151,204,124,24.98467120181406,26.865487528344673,31.0,31.0,114,2.0,80
152,204,31,24.98467120181406,27.376326530612246,31.0,28.0,201,2.0,173
153,204,232,24.98467120181406,26.865487528344673,31.0,23.0,86,2.0,28
154,204,245,24.98467120181406,27.353106575963718,31.0,26.0,110,2.0,41
155,204,524,24.98467120181406,26.122448979591837,31.0,20.0,324,1.0,320
156,204,479,24.98467120181406,27.678185941043086,31.0,25.0,298,3.0,275
157,204,625,24.98467120181406,26.888707482993198,31.0,26.0,429,2.0,421
158,204,621,24.98467120181406,27.678185941043086,31.0,28.0,433,3.0,417
159,124,84,26.865487528344673,28.444444444444446,31.0,28.0,79,2.0,40
160,124,228,26.865487528344673,28.46766439909297,31.0,26.0,125,2.0,104
161,124,465,26.865487528344673,28.490884353741496,31.0,23.0,348,2.0,341
162,124,478,26.865487528344673,29.280362811791385,31.0,23.0,369,2.0,354
163,124,623,26.865487528344673,28.490884353741496,31.0,27.0,504,2.0,499
164,124,618,26.865487528344673,29.30358276643991,31.0,18.0,505,2.0,494
165,31,84,27.376326530612246,28.444444444444446,28.0,28.0,70,1.0,53
166,31,69,27.376326530612246,29.930521541950114,28.0,27.0,116,3.0,38
167,31,228,27.376326530612246,28.46766439909297,28.0,26.0,203,1.0,197
168,31,303,27.376326530612246,29.976961451247167,28.0,36.0,294,3.0,272
169,31,304,27.376326530612246,30.00018140589569,28.0,32.0,295,3.0,273
170,31,465,27.376326530612246,28.490884353741496,28.0,23.0,437,1.0,434
171,31,478,27.376326530612246,29.280362811791385,28.0,23.0,454,2.0,447
172,84,69,28.444444444444446,29.930521541950114,28.0,27.0,66,1.0,15
173,84,189,28.444444444444446,30.97541950113379,28.0,27.0,151,3.0,105
174,84,189,28.444444444444446,30.998639455782314,28.0,28.0,152,3.0,105
175,84,303,28.444444444444446,29.976961451247167,28.0,36.0,229,2.0,219
176,84,304,28.444444444444446,30.00018140589569,28.0,32.0,230,2.0,220
177,84,248,28.444444444444446,31.02185941043084,28.0,26.0,198,3.0,164
178,84,466,28.444444444444446,30.859319727891158,28.0,25.0,396,2.0,382
179,69,189,29.930521541950114,30.97541950113379,27.0,27.0,128,1.0,120
180,69,189,29.930521541950114,30.998639455782314,27.0,28.0,129,1.0,120
181,69,183,29.930521541950114,32.391836734693875,27.0,26.0,156,2.0,114
182,69,248,29.930521541950114,31.02185941043084,27.0,26.0,185,1.0,179
183,69,363,29.930521541950114,32.36861678004535,27.0,21.0,312,2.0,294
184,69,469,29.930521541950114,31.579138321995465,27.0,22.0,406,2.0,400
185,69,480,29.930521541950114,32.46149659863946,27.0,25.0,425,3.0,411
186,189,183,30.97541950113379,32.391836734693875,27.0,26.0,61,1.0,6
187,189,68,30.97541950113379,33.668934240362816,27.0,31.0,168,3.0,121
188,189,363,30.97541950113379,32.36861678004535,27.0,21.0,184,1.0,174
189,189,237,30.97541950113379,33.715374149659866,27.0,26.0,127,3.0,48
190,189,480,30.97541950113379,32.46149659863946,27.0,25.0,298,1.0,291
191,189,466,30.97541950113379,33.274195011337866,27.0,27.0,294,2.0,277
192,189,616,30.97541950113379,32.46149659863946,27.0,24.0,432,1.0,427
193,189,615,30.97541950113379,33.274195011337866,27.0,26.0,437,2.0,426
194,189,183,30.998639455782314,32.391836734693875,28.0,26.0,60,1.0,6
195,189,68,30.998639455782314,33.668934240362816,28.0,31.0,167,3.0,121
196,189,363,30.998639455782314,32.36861678004535,28.0,21.0,184,1.0,174
197,189,237,30.998639455782314,33.715374149659866,28.0,26.0,126,3.0,48
198,189,480,30.998639455782314,32.46149659863946,28.0,25.0,298,1.0,291
199,189,466,30.998639455782314,33.274195011337866,28.0,27.0,294,2.0,277
200,189,616,30.998639455782314,32.46149659863946,28.0,24.0,432,1.0,427
201,189,615,30.998639455782314,33.274195011337866,28.0,26.0,437,2.0,426
202,183,68,32.391836734693875,33.668934240362816,26.0,31.0,127,1.0,115
203,183,68,32.391836734693875,34.06367346938776,26.0,31.0,136,2.0,115
204,183,237,32.391836734693875,33.715374149659866,26.0,26.0,79,1.0,54
205,183,251,32.391836734693875,34.06367346938776,26.0,20.0,99,2.0,68
206,183,476,32.391836734693875,34.87637188208617,26.0,25.0,312,2.0,293
207,183,617,32.391836734693875,34.06367346938776,26.0,25.0,440,2.0,434
208,68,137,33.668934240362816,35.66585034013605,31.0,29.0,110,2.0,69
209,68,188,33.668934240362816,36.19990929705215,31.0,31.0,162,3.0,120
210,68,234,33.668934240362816,35.54975056689342,31.0,24.0,185,2.0,166
211,68,476,33.668934240362816,34.87637188208617,31.0,25.0,411,1.0,408
212,68,479,33.668934240362816,35.66585034013605,31.0,19.0,420,2.0,411
213,68,470,33.668934240362816,36.45532879818594,31.0,22.0,420,3.0,402
214,68,137,34.06367346938776,35.66585034013605,31.0,29.0,98,2.0,69
215,68,188,34.06367346938776,36.19990929705215,31.0,31.0,151,2.0,120
216,68,234,34.06367346938776,35.54975056689342,31.0,24.0,178,1.0,166
217,68,237,34.06367346938776,36.94294784580499,31.0,28.0,210,3.0,169
218,68,479,34.06367346938776,35.66585034013605,31.0,19.0,417,2.0,411
219,68,470,34.06367346938776,36.45532879818594,31.0,22.0,415,2.0,402
220,137,125,35.66585034013605,37.29124716553288,29.0,28.0,71,2.0,12
221,137,237,35.66585034013605,36.94294784580499,29.0,28.0,114,1.0,100
222,137,246,35.66585034013605,37.268027210884355,29.0,26.0,129,2.0,109
223,137,233,35.66585034013605,38.42902494331066,29.0,31.0,153,3.0,96
224,137,613,35.66585034013605,37.268027210884355,29.0,24.0,481,2.0,476
225,137,613,35.66585034013605,38.080725623582765,29.0,22.0,487,2.0,476
226,137,620,35.66585034013605,37.268027210884355,29.0,24.0,488,2.0,483
227,188,125,36.19990929705215,37.29124716553288,31.0,28.0,79,1.0,63
228,188,137,36.19990929705215,38.800544217687076,31.0,30.0,123,3.0,51
229,188,246,36.19990929705215,37.268027210884355,31.0,26.0,74,1.0,58
230,188,233,36.19990929705215,38.42902494331066,31.0,31.0,106,2.0,45
231,188,613,36.19990929705215,37.268027210884355,31.0,24.0,427,1.0,425
232,188,613,36.19990929705215,38.080725623582765,31.0,22.0,433,2.0,425
233,188,620,36.19990929705215,37.268027210884355,31.0,24.0,434,1.0,432
234,188,625,36.19990929705215,38.87020408163266,31.0,23.0,452,3.0,437
235,125,137,37.29124716553288,38.800544217687076,28.0,30.0,66,2.0,12
236,125,144,37.29124716553288,39.72934240362812,28.0,29.0,107,2.0,19
237,125,138,37.29124716553288,40.170521541950116,28.0,31.0,125,3.0,13
238,125,233,37.29124716553288,38.42902494331066,28.0,31.0,119,1.0,108
239,125,243,37.29124716553288,39.72934240362812,28.0,22.0,158,2.0,118
240,125,613,37.29124716553288,39.70612244897959,28.0,20.0,499,2.0,488
241,137,138,38.800544217687076,40.170521541950116,30.0,31.0,59,1.0,1
242,137,31,38.800544217687076,41.540498866213156,30.0,30.0,159,3.0,106
243,137,207,38.800544217687076,40.49560090702948,30.0,27.0,101,2.0,70
244,137,467,38.800544217687076,40.49560090702948,30.0,26.0,338,2.0,330
245,137,480,38.800544217687076,41.28507936507937,30.0,22.0,359,2.0,343
246,137,624,38.800544217687076,40.49560090702948,30.0,23.0,492,2.0,487
247,137,624,38.800544217687076,41.28507936507937,30.0,29.0,499,2.0,487
248,144,31,39.72934240362812,41.540498866213156,29.0,30.0,137,2.0,113
249,144,170,39.72934240362812,42.42285714285715,29.0,31.0,119,3.0,26
250,144,228,39.72934240362812,41.95845804988662,29.0,25.0,128,2.0,84
251,144,265,39.72934240362812,42.4692970521542,29.0,27.0,169,3.0,121
252,144,480,39.72934240362812,41.28507936507937,29.0,22.0,343,2.0,336
253,144,471,39.72934240362812,42.074557823129254,29.0,22.0,342,2.0,327
254,144,624,39.72934240362812,41.28507936507937,29.0,29.0,485,2.0,480
255,144,615,39.72934240362812,42.074557823129254,29.0,27.0,482,2.0,471
256,138,31,40.170521541950116,41.540498866213156,31.0,30.0,122,1.0,107
257,138,170,40.170521541950116,42.42285714285715,31.0,31.0,102,2.0,32
258,138,228,40.170521541950116,41.95845804988662,31.0,25.0,118,2.0,90
259,138,265,40.170521541950116,42.4692970521542,31.0,27.0,161,2.0,127
260,138,480,40.170521541950116,41.28507936507937,31.0,22.0,345,1.0,342
261,138,471,40.170521541950116,42.074557823129254,31.0,22.0,343,2.0,333
262,138,624,40.170521541950116,41.28507936507937,31.0,29.0,488,1.0,486
263,138,615,40.170521541950116,42.074557823129254,31.0,27.0,484,2.0,477
264,31,155,41.540498866213156,43.81605442176871,30.0,31.0,158,2.0,124
265,31,245,41.540498866213156,43.281995464852606,30.0,28.0,227,2.0,214
266,31,479,41.540498866213156,43.653514739229024,30.0,20.0,457,2.0,448
267,31,466,41.540498866213156,44.373333333333335,30.0,23.0,452,3.0,435
268,170,155,42.42285714285715,43.81605442176871,31.0,31.0,62,1.0,15
269,170,67,42.42285714285715,44.7912925170068,31.0,35.0,145,2.0,103
270,170,247,42.42285714285715,44.76807256235828,31.0,23.0,127,2.0,77
271,170,479,42.42285714285715,43.653514739229024,31.0,20.0,314,1.0,309
272,170,466,42.42285714285715,44.373333333333335,31.0,23.0,308,2.0,296
273,170,464,42.42285714285715,45.255691609977326,31.0,22.0,318,3.0,294
274,170,616,42.42285714285715,43.653514739229024,31.0,24.0,449,1.0,446
275,170,616,42.42285714285715,44.46621315192744,31.0,25.0,455,2.0,446
276,170,616,42.42285714285715,45.27891156462585,31.0,19.0,463,3.0,446
277,155,148,43.81605442176871,45.743310657596375,31.0,28.0,83,2.0,7
278,155,259,43.81605442176871,45.743310657596375,31.0,25.0,133,2.0,104
279,155,217,43.81605442176871,46.068390022675736,31.0,20.0,115,2.0,62
280,155,464,43.81605442176871,45.255691609977326,31.0,22.0,315,1.0,309
281,155,616,43.81605442176871,45.27891156462585,31.0,19.0,465,1.0,461
282,155,615,43.81605442176871,46.09160997732426,31.0,19.0,470,2.0,460
283,67,175,44.7912925170068,46.85786848072563,35.0,32.0,140,2.0,108
284,67,197,44.7912925170068,47.484807256235825,35.0,38.0,174,3.0,130
285,67,217,44.7912925170068,46.068390022675736,35.0,20.0,160,1.0,150
286,67,395,44.7912925170068,47.50802721088436,35.0,16.0,348,3.0,328
287,67,469,44.7912925170068,46.85786848072563,35.0,21.0,412,2.0,402
288,67,478,44.7912925170068,47.64734693877551,35.0,19.0,429,3.0,411
289,148,175,45.743310657596375,46.85786848072563,28.0,32.0,55,1.0,27
290,148,197,45.743310657596375,47.484807256235825,28.0,38.0,90,2.0,49
291,148,63,45.743310657596375,48.32072562358277,28.0,34.0,140,3.0,85
292,148,395,45.743310657596375,47.50802721088436,28.0,16.0,258,2.0,247
293,148,469,45.743310657596375,46.85786848072563,28.0,21.0,325,1.0,321
294,148,478,45.743310657596375,47.64734693877551,28.0,19.0,340,2.0,330
295,148,476,45.743310657596375,48.46004535147392,28.0,13.0,348,3.0,328
296,148,616,45.743310657596375,47.64734693877551,28.0,21.0,475,2.0,468
297,148,626,45.743310657596375,48.46004535147392,28.0,16.0,492,3.0,478
298,175,63,46.85786848072563,48.32072562358277,32.0,34.0,129,1.0,112
299,175,55,46.85786848072563,49.15664399092971,32.0,31.0,156,2.0,120
300,175,242,46.85786848072563,48.78512471655329,32.0,23.0,107,2.0,67
301,175,280,46.85786848072563,49.20308390022676,32.0,27.0,146,2.0,105
302,175,476,46.85786848072563,48.46004535147392,32.0,13.0,309,2.0,301
303,175,491,46.85786848072563,49.179863945578234,32.0,23.0,331,2.0,316
304,175,626,46.85786848072563,48.46004535147392,32.0,16.0,456,2.0,451
305,175,623,46.85786848072563,49.24952380952381,32.0,12.0,460,2.0,448
306,197,55,47.484807256235825,49.15664399092971,38.0,31.0,159,2.0,142
307,197,129,47.484807256235825,50.062222222222225,38.0,35.0,130,3.0,68
308,197,242,47.484807256235825,48.78512471655329,38.0,23.0,72,1.0,45
309,197,280,47.484807256235825,49.20308390022676,38.0,27.0,111,2.0,83
310,197,258,47.484807256235825,50.062222222222225,38.0,18.0,127,3.0,61
311,197,491,47.484807256235825,49.179863945578234,38.0,23.0,303,2.0,294
312,197,623,47.484807256235825,49.24952380952381,38.0,12.0,433,2.0,426
313,197,624,47.484807256235825,50.0390022675737,38.0,18.0,441,3.0,427
314,63,129,48.32072562358277,50.062222222222225,34.0,35.0,100,2.0,66
315,63,64,48.32072562358277,51.1071201814059,34.0,28.0,120,3.0,1
316,63,258,48.32072562358277,50.062222222222225,34.0,18.0,209,2.0,195
317,63,479,48.32072562358277,50.758820861678004,34.0,23.0,429,2.0,416
318,63,444,48.32072562358277,51.153560090702946,34.0,17.0,400,3.0,381
319,55,64,49.15664399092971,51.1071201814059,31.0,28.0,84,2.0,9
320,55,29,49.15664399092971,52.128798185941044,31.0,37.0,131,3.0,26
321,55,258,49.15664399092971,51.61795918367347,31.0,22.0,229,2.0,203
322,55,479,49.15664399092971,50.758820861678004,31.0,23.0,430,2.0,424
323,55,444,49.15664399092971,51.153560090702946,31.0,17.0,398,2.0,389
324,129,64,50.062222222222225,51.1071201814059,35.0,28.0,79,1.0,65
325,129,29,50.062222222222225,52.128798185941044,35.0,37.0,134,2.0,100
326,129,258,50.062222222222225,51.61795918367347,35.0,22.0,145,2.0,129
327,129,372,50.062222222222225,52.33777777777778,35.0,22.0,262,2.0,243
328,129,444,50.062222222222225,51.153560090702946,35.0,17.0,318,1.0,315
329,129,455,50.062222222222225,52.33777777777778,35.0,14.0,340,2.0,326
330,129,624,50.062222222222225,51.61795918367347,35.0,20.0,500,2.0,495
331,64,29,51.1071201814059,52.128798185941044,28.0,37.0,56,1.0,35
332,64,27,51.1071201814059,53.057596371882084,28.0,30.0,92,2.0,37
333,64,372,51.1071201814059,52.33777777777778,28.0,22.0,313,1.0,308
334,64,237,51.1071201814059,53.91673469387755,28.0,36.0,211,3.0,173
335,64,253,51.1071201814059,53.98639455782313,28.0,30.0,226,3.0,189
336,64,455,51.1071201814059,52.33777777777778,28.0,14.0,395,1.0,391
337,64,477,51.1071201814059,53.893514739229026,28.0,18.0,430,3.0,413
338,29,68,52.128798185941044,54.96163265306122,37.0,29.0,128,3.0,39
339,29,69,52.128798185941044,54.984852607709755,37.0,26.0,129,3.0,40
340,29,237,52.128798185941044,53.91673469387755,37.0,36.0,222,2.0,208
341,29,253,52.128798185941044,53.98639455782313,37.0,30.0,238,2.0,224
342,29,477,52.128798185941044,53.893514739229026,37.0,18.0,454,2.0,448
343,29,467,52.128798185941044,54.31147392290249,37.0,22.0,448,2.0,438
344,27,68,53.057596371882084,54.96163265306122,30.0,29.0,92,2.0,41
345,27,69,53.057596371882084,54.984852607709755,30.0,26.0,93,2.0,42
346,27,258,53.057596371882084,55.193832199546485,30.0,27.0,249,2.0,231
347,27,208,53.057596371882084,56.0065306122449,30.0,27.0,221,3.0,181
348,27,467,53.057596371882084,54.31147392290249,30.0,22.0,443,1.0,440
349,27,466,53.057596371882084,55.54213151927438,30.0,29.0,452,2.0,439
350,68,128,54.96163265306122,56.37804988662132,29.0,30.0,86,1.0,60
351,68,129,54.96163265306122,57.19074829931973,29.0,32.0,114,2.0,61
352,68,208,54.96163265306122,56.0065306122449,29.0,27.0,147,1.0,140
353,68,259,54.96163265306122,57.19074829931973,29.0,29.0,214,2.0,191
354,68,410,54.96163265306122,56.37804988662132,29.0,12.0,347,1.0,342
355,69,128,54.984852607709755,56.37804988662132,26.0,30.0,84,1.0,59
356,69,129,54.984852607709755,57.19074829931973,26.0,32.0,112,2.0,60
357,69,208,54.984852607709755,56.0065306122449,26.0,27.0,146,1.0,139
358,69,259,54.984852607709755,57.19074829931973,26.0,29.0,212,2.0,190
359,69,410,54.984852607709755,56.37804988662132,26.0,12.0,346,1.0,341
360,69,568,54.984852607709755,57.19074829931973,26.0,8.0,508,2.0,499
361,128,67,56.37804988662132,58.39818594104309,30.0,36.0,106,2.0,61
362,128,231,56.37804988662132,58.35174603174603,30.0,25.0,134,2.0,103
363,128,488,56.37804988662132,58.258866213151926,30.0,24.0,369,2.0,360
364,128,595,56.37804988662132,59.025124716553286,30.0,29.0,481,3.0,467
365,129,67,57.19074829931973,58.39818594104309,32.0,36.0,81,1.0,62
366,129,64,57.19074829931973,59.93070294784581,32.0,38.0,135,3.0,65
367,129,231,57.19074829931973,58.35174603174603,32.0,25.0,114,1.0,102
368,129,241,57.19074829931973,59.791383219954646,32.0,25.0,158,3.0,112
369,129,488,57.19074829931973,58.258866213151926,32.0,24.0,362,1.0,359
370,129,595,57.19074829931973,59.025124716553286,32.0,29.0,473,2.0,466
371,67,64,58.39818594104309,59.93070294784581,36.0,38.0,66,2.0,3
372,67,241,58.39818594104309,59.791383219954646,36.0,25.0,184,1.0,174
373,220,86,0.06965986394557823,1.6253968253968254,-4.0,31.0,150,2.0,134
374,220,139,0.06965986394557823,2.2523356009070294,-4.0,30.0,124,2.0,81
375,220,228,0.06965986394557823,1.4396371882086167,-4.0,26.0,60,1.0,8
376,220,233,0.06965986394557823,2.2755555555555556,-4.0,31.0,96,2.0,13
377,220,460,0.06965986394557823,1.8343764172335602,-4.0,13.0,252,2.0,240
378,220,420,0.06965986394557823,2.2755555555555556,-4.0,7.0,221,2.0,200
379,220,673,0.06965986394557823,1.4164172335600906,-4.0,6.0,457,1.0,453
380,228,67,1.4396371882086167,3.297233560090703,26.0,33.0,180,2.0,161
381,228,415,1.4396371882086167,3.784852607709751,26.0,9.0,213,2.0,187
382,228,632,1.4396371882086167,3.784852607709751,26.0,5.0,416,2.0,404
383,233,67,2.2755555555555556,3.297233560090703,31.0,33.0,172,1.0,166
384,233,204,2.2755555555555556,4.597551020408163,31.0,34.0,104,2.0,29
385,233,228,2.2755555555555556,3.784852607709751,31.0,25.0,65,2.0,5
386,233,206,2.2755555555555556,4.597551020408163,31.0,37.0,104,2.0,27
387,233,415,2.2755555555555556,3.784852607709751,31.0,9.0,193,2.0,182
388,233,505,2.2755555555555556,4.922630385487529,31.0,14.0,295,3.0,272
389,233,632,2.2755555555555556,3.784852607709751,31.0,5.0,404,2.0,399
390,233,621,2.2755555555555556,4.899410430839002,31.0,17.0,404,3.0,388
391,228,129,3.784852607709751,5.758548752834467,25.0,31.0,130,2.0,99
392,228,204,3.784852607709751,6.57124716553288,25.0,32.0,122,3.0,24
393,228,207,3.784852607709751,5.758548752834467,25.0,29.0,88,2.0,21
394,228,208,3.784852607709751,6.57124716553288,25.0,33.0,122,3.0,20
395,228,505,3.784852607709751,4.922630385487529,25.0,14.0,281,1.0,277
396,228,411,3.784852607709751,5.758548752834467,25.0,14.0,202,2.0,183
397,228,517,3.784852607709751,6.548027210884354,25.0,9.0,313,3.0,289
398,228,621,3.784852607709751,4.899410430839002,25.0,17.0,396,1.0,393
399,228,676,3.784852607709751,5.758548752834467,25.0,8.0,456,2.0,448
400,228,631,3.784852607709751,6.57124716553288,25.0,7.0,420,3.0,403
401,206,129,4.597551020408163,5.758548752834467,37.0,31.0,92,1.0,77
402,206,204,4.597551020408163,6.57124716553288,37.0,32.0,85,2.0,2
403,206,207,4.597551020408163,5.758548752834467,37.0,29.0,50,1.0,1
404,206,208,4.597551020408163,6.57124716553288,37.0,33.0,85,2.0,2
405,206,411,4.597551020408163,5.758548752834467,37.0,14.0,211,1.0,205
406,206,517,4.597551020408163,6.548027210884354,37.0,9.0,322,2.0,311
407,206,676,4.597551020408163,5.758548752834467,37.0,8.0,473,1.0,470
408,206,631,4.597551020408163,6.57124716553288,37.0,7.0,433,2.0,425
409,207,204,5.758548752834467,7.9412244897959186,29.0,32.0,94,2.0,3
410,207,205,5.758548752834467,7.964444444444444,29.0,32.0,95,2.0,2
411,207,205,5.758548752834467,7.987664399092971,29.0,32.0,96,2.0,2
412,207,467,5.758548752834467,7.75546485260771,29.0,10.0,274,2.0,260
413,207,545,5.758548752834467,8.40562358276644,29.0,22.0,357,3.0,338
414,207,636,5.758548752834467,7.894784580498866,29.0,8.0,439,2.0,429
415,207,629,5.758548752834467,8.359183673469389,29.0,20.0,437,3.0,422
416,208,204,6.57124716553288,7.9412244897959186,33.0,32.0,59,1.0,4
417,208,65,6.57124716553288,8.962902494331066,33.0,41.0,176,2.0,143
418,208,84,6.57124716553288,9.05578231292517,33.0,42.0,164,2.0,124
419,208,205,6.57124716553288,7.964444444444444,33.0,32.0,60,1.0,3
420,208,205,6.57124716553288,7.987664399092971,33.0,32.0,61,1.0,3
421,208,241,6.57124716553288,9.05578231292517,33.0,28.0,112,2.0,33
422,208,467,6.57124716553288,7.75546485260771,33.0,10.0,264,1.0,259
423,208,545,6.57124716553288,8.40562358276644,33.0,22.0,346,2.0,337
424,208,636,6.57124716553288,7.894784580498866,33.0,8.0,432,1.0,428
425,208,629,6.57124716553288,8.359183673469389,33.0,20.0,428,2.0,421
426,205,84,7.964444444444444,9.05578231292517,32.0,42.0,130,1.0,121
427,205,75,7.964444444444444,10.077460317460318,32.0,31.0,159,2.0,130
428,205,241,7.964444444444444,9.05578231292517,32.0,28.0,59,1.0,36
429,205,251,7.964444444444444,10.913378684807256,32.0,22.0,135,3.0,46
430,205,595,7.964444444444444,9.7059410430839,32.0,21.0,397,2.0,390
431,205,459,7.964444444444444,10.077460317460318,32.0,12.0,270,2.0,254
432,205,666,7.964444444444444,9.7059410430839,32.0,20.0,467,2.0,461
433,205,84,7.987664399092971,9.05578231292517,32.0,42.0,129,1.0,121
434,205,75,7.987664399092971,10.077460317460318,32.0,31.0,158,2.0,130
435,205,241,7.987664399092971,9.05578231292517,32.0,28.0,58,1.0,36
436,205,251,7.987664399092971,10.913378684807256,32.0,22.0,134,3.0,46
437,205,595,7.987664399092971,9.7059410430839,32.0,21.0,397,2.0,390
438,205,459,7.987664399092971,10.077460317460318,32.0,12.0,269,2.0,254
439,205,666,7.987664399092971,9.7059410430839,32.0,20.0,467,2.0,461
440,241,75,9.05578231292517,10.077460317460318,28.0,31.0,172,1.0,166
441,241,19,9.05578231292517,11.00625850340136,28.0,29.0,237,2.0,222
442,241,251,9.05578231292517,10.913378684807256,28.0,22.0,81,2.0,10
443,241,255,9.05578231292517,11.168798185941043,28.0,24.0,92,2.0,14
444,241,459,9.05578231292517,10.077460317460318,28.0,12.0,222,1.0,218
445,241,513,9.05578231292517,11.261678004535147,28.0,6.0,288,2.0,272
446,251,65,10.913378684807256,12.445895691609978,22.0,24.0,197,2.0,186
447,251,255,10.913378684807256,12.422675736961452,22.0,34.0,65,2.0,4
448,251,255,10.913378684807256,13.583673469387755,22.0,28.0,115,3.0,4
449,251,515,10.913378684807256,12.07437641723356,22.0,17.0,269,1.0,264
450,251,522,10.913378684807256,13.235374149659863,22.0,10.0,289,2.0,271
451,251,642,10.913378684807256,12.399455782312925,22.0,8.0,396,1.0,391
452,251,643,10.913378684807256,13.212154195011339,22.0,-1.0,404,2.0,392
453,255,65,11.168798185941043,12.445895691609978,24.0,24.0,198,1.0,190
454,255,138,11.168798185941043,13.955192743764172,24.0,27.0,168,3.0,117
455,255,82,11.168798185941043,14.071292517006803,24.0,36.0,213,3.0,173
456,255,522,11.168798185941043,13.235374149659863,24.0,10.0,281,2.0,267
457,255,642,11.168798185941043,12.399455782312925,24.0,8.0,391,1.0,387
458,255,643,11.168798185941043,13.212154195011339,24.0,-1.0,398,2.0,388
459,255,138,12.422675736961452,13.955192743764172,34.0,27.0,134,2.0,117
460,255,82,12.422675736961452,14.071292517006803,34.0,36.0,187,2.0,173
461,255,130,12.422675736961452,15.09297052154195,34.0,36.0,170,3.0,125
462,255,232,12.422675736961452,14.373151927437641,34.0,19.0,87,2.0,23
463,255,458,12.422675736961452,14.210612244897959,34.0,15.0,217,2.0,203
464,255,643,12.422675736961452,14.419591836734694,34.0,11.0,397,2.0,388
465,255,681,12.422675736961452,15.209070294784581,34.0,16.0,443,3.0,426
466,255,130,13.583673469387755,15.09297052154195,28.0,36.0,141,2.0,125
467,255,260,13.583673469387755,15.789569160997733,28.0,23.0,95,2.0,5
468,255,261,13.583673469387755,16.068208616780044,28.0,21.0,107,2.0,6
469,255,477,13.583673469387755,15.766349206349206,28.0,18.0,241,2.0,222
470,255,605,13.583673469387755,16.27718820861678,28.0,19.0,369,3.0,350
471,255,681,13.583673469387755,15.209070294784581,28.0,16.0,432,2.0,426
472,255,656,13.583673469387755,16.300408163265306,28.0,19.0,418,3.0,401
473,232,68,14.373151927437641,16.81124716553288,19.0,32.0,195,2.0,164
474,232,260,14.373151927437641,15.789569160997733,19.0,23.0,67,1.0,28
475,232,261,14.373151927437641,16.068208616780044,19.0,21.0,79,2.0,29
476,232,255,14.373151927437641,17.11310657596372,19.0,20.0,120,3.0,23
477,232,477,14.373151927437641,15.766349206349206,19.0,18.0,252,1.0,245
478,232,605,14.373151927437641,16.27718820861678,19.0,19.0,382,2.0,373
479,232,656,14.373151927437641,16.300408163265306,19.0,19.0,432,2.0,424
480,260,68,15.789569160997733,16.81124716553288,23.0,32.0,197,1.0,192
481,260,29,15.789569160997733,17.623945578231293,23.0,35.0,244,2.0,231
482,260,22,15.789569160997733,18.15800453514739,23.0,30.0,259,2.0,238
483,260,255,15.789569160997733,17.11310657596372,23.0,20.0,57,1.0,5
484,260,208,15.789569160997733,18.692063492063493,23.0,17.0,135,3.0,52
485,260,537,15.789569160997733,17.531065759637187,23.0,16.0,287,2.0,277
486,260,498,15.789569160997733,18.320544217687075,23.0,20.0,262,3.0,238
487,260,616,15.789569160997733,17.531065759637187,23.0,18.0,364,2.0,356
488,260,658,15.789569160997733,18.320544217687075,23.0,24.0,413,3.0,398
489,261,29,16.068208616780044,17.623945578231293,21.0,35.0,241,2.0,232
490,261,22,16.068208616780044,18.15800453514739,21.0,30.0,255,2.0,239
491,261,255,16.068208616780044,17.11310657596372,21.0,20.0,45,1.0,6
492,261,208,16.068208616780044,18.692063492063493,21.0,17.0,125,3.0,53
493,261,537,16.068208616780044,17.531065759637187,21.0,16.0,283,1.0,276
494,261,498,16.068208616780044,18.320544217687075,21.0,20.0,256,2.0,237
495,261,616,16.068208616780044,17.531065759637187,21.0,18.0,361,1.0,355
496,261,658,16.068208616780044,18.320544217687075,21.0,24.0,409,2.0,397
497,255,22,17.11310657596372,18.15800453514739,20.0,30.0,237,1.0,233
498,255,57,17.11310657596372,19.82984126984127,20.0,32.0,230,3.0,198
499,255,208,17.11310657596372,18.692063492063493,20.0,17.0,83,2.0,47
500,255,205,17.11310657596372,19.086802721088436,20.0,28.0,99,2.0,50
501,255,498,17.11310657596372,18.320544217687075,20.0,20.0,249,1.0,243
502,255,478,17.11310657596372,19.922721088435374,20.0,22.0,254,3.0,223
503,255,658,17.11310657596372,18.320544217687075,20.0,24.0,406,1.0,403
504,255,655,17.11310657596372,19.945941043083902,20.0,14.0,418,3.0,400
505,255,655,17.11310657596372,19.99238095238095,20.0,6.0,419,3.0,400
506,208,57,18.692063492063493,19.82984126984127,17.0,32.0,159,1.0,151
507,208,22,18.692063492063493,20.17814058956916,17.0,32.0,197,1.0,186
508,208,22,18.692063492063493,21.501678004535147,17.0,30.0,222,3.0,186
509,208,232,18.692063492063493,20.688979591836734,17.0,23.0,89,2.0,24
510,208,228,18.692063492063493,21.037278911564627,17.0,27.0,103,2.0,20
511,208,478,18.692063492063493,19.922721088435374,17.0,22.0,275,1.0,270
512,208,475,18.692063492063493,20.526439909297054,17.0,15.0,278,2.0,267
513,208,459,18.692063492063493,21.36235827664399,17.0,23.0,276,3.0,251
514,208,655,18.692063492063493,19.945941043083902,17.0,14.0,450,1.0,447
515,208,655,18.692063492063493,19.99238095238095,17.0,6.0,450,1.0,447
516,208,661,18.692063492063493,21.478458049886623,17.0,24.0,469,3.0,453
517,205,22,19.086802721088436,20.17814058956916,28.0,32.0,189,1.0,183
518,205,22,19.086802721088436,21.501678004535147,28.0,30.0,210,2.0,183
519,205,232,19.086802721088436,20.688979591836734,28.0,23.0,74,2.0,27
520,205,228,19.086802721088436,21.037278911564627,28.0,27.0,87,2.0,23
521,205,475,19.086802721088436,20.526439909297054,28.0,15.0,277,1.0,270
522,205,459,19.086802721088436,21.36235827664399,28.0,23.0,272,2.0,254
523,205,661,19.086802721088436,21.478458049886623,28.0,24.0,467,2.0,456
524,232,22,20.688979591836734,22.38403628117914,23.0,33.0,222,2.0,210
525,232,202,20.688979591836734,23.034195011337868,23.0,31.0,105,2.0,30
526,232,235,20.688979591836734,22.96453514739229,23.0,25.0,98,2.0,3
527,232,234,20.688979591836734,22.98775510204082,23.0,32.0,99,2.0,2
528,232,463,20.688979591836734,22.221496598639455,23.0,9.0,240,2.0,231
529,232,472,20.688979591836734,23.057414965986396,23.0,20.0,261,2.0,240
530,232,670,20.688979591836734,22.221496598639455,23.0,6.0,443,2.0,438
531,232,615,20.688979591836734,23.08063492063492,23.0,19.0,397,2.0,383
532,228,22,21.037278911564627,22.38403628117914,27.0,33.0,214,1.0,206
533,228,202,21.037278911564627,23.034195011337868,27.0,31.0,90,2.0,26
534,228,235,21.037278911564627,22.96453514739229,27.0,25.0,83,2.0,7
535,228,234,21.037278911564627,22.98775510204082,27.0,32.0,84,2.0,6
536,228,463,21.037278911564627,22.221496598639455,27.0,9.0,240,1.0,235
537,228,472,21.037278911564627,23.057414965986396,27.0,20.0,259,2.0,244
538,228,670,21.037278911564627,22.221496598639455,27.0,6.0,445,1.0,442
539,228,615,21.037278911564627,23.08063492063492,27.0,19.0,397,2.0,387
540,235,204,22.96453514739229,24.961451247165535,25.0,26.0,91,2.0,31
541,235,204,22.96453514739229,24.98467120181406,25.0,31.0,92,2.0,31
542,235,205,22.96453514739229,24.961451247165535,25.0,32.0,91,2.0,30
543,235,205,22.96453514739229,24.98467120181406,25.0,32.0,92,2.0,30
544,235,499,22.96453514739229,24.961451247165535,25.0,17.0,278,2.0,264
545,235,508,22.96453514739229,25.379410430839002,25.0,23.0,292,2.0,273
546,235,670,22.96453514739229,24.961451247165535,25.0,14.0,443,2.0,435
547,235,681,22.96453514739229,25.007891156462584,25.0,23.0,455,2.0,446
548,234,204,22.98775510204082,24.961451247165535,32.0,26.0,90,2.0,30
549,234,204,22.98775510204082,24.98467120181406,32.0,31.0,91,2.0,30
550,234,205,22.98775510204082,24.961451247165535,32.0,32.0,90,2.0,29
551,234,205,22.98775510204082,24.98467120181406,32.0,32.0,91,2.0,29
552,234,499,22.98775510204082,24.961451247165535,32.0,17.0,278,2.0,265
553,234,508,22.98775510204082,25.379410430839002,32.0,23.0,293,2.0,274
554,234,670,22.98775510204082,24.961451247165535,32.0,14.0,444,2.0,436
555,234,681,22.98775510204082,25.007891156462584,32.0,23.0,455,2.0,447
556,205,124,24.961451247165535,26.865487528344673,32.0,31.0,115,2.0,81
557,205,31,24.961451247165535,27.376326530612246,32.0,28.0,203,2.0,174
558,205,232,24.961451247165535,26.865487528344673,32.0,23.0,86,2.0,27
559,205,245,24.961451247165535,27.353106575963718,32.0,26.0,110,2.0,40
560,205,524,24.961451247165535,26.122448979591837,32.0,20.0,323,1.0,319
561,205,479,24.961451247165535,27.678185941043086,32.0,25.0,298,3.0,274
562,205,625,24.961451247165535,26.888707482993198,32.0,26.0,428,2.0,420
563,205,621,24.961451247165535,27.678185941043086,32.0,28.0,432,3.0,416
564,205,124,24.98467120181406,26.865487528344673,32.0,31.0,115,2.0,81
565,205,31,24.98467120181406,27.376326530612246,32.0,28.0,202,2.0,174
566,205,232,24.98467120181406,26.865487528344673,32.0,23.0,85,2.0,27
567,205,245,24.98467120181406,27.353106575963718,32.0,26.0,110,2.0,40
568,205,524,24.98467120181406,26.122448979591837,32.0,20.0,323,1.0,319
569,205,479,24.98467120181406,27.678185941043086,32.0,25.0,298,3.0,274
570,205,625,24.98467120181406,26.888707482993198,32.0,26.0,428,2.0,420
571,205,621,24.98467120181406,27.678185941043086,32.0,28.0,432,3.0,416
572,232,84,26.865487528344673,28.444444444444446,23.0,28.0,163,2.0,148
573,232,228,26.865487528344673,28.46766439909297,23.0,26.0,69,2.0,4
574,232,465,26.865487528344673,28.490884353741496,23.0,23.0,243,2.0,233
575,232,478,26.865487528344673,29.280362811791385,23.0,23.0,267,2.0,246
576,232,623,26.865487528344673,28.490884353741496,23.0,27.0,397,2.0,391
577,232,618,26.865487528344673,29.30358276643991,23.0,18.0,400,2.0,386
578,245,84,27.353106575963718,28.444444444444446,26.0,28.0,168,1.0,161
579,245,69,27.353106575963718,29.930521541950114,26.0,27.0,208,3.0,176
580,245,228,27.353106575963718,28.46766439909297,26.0,26.0,51,1.0,17
581,245,303,27.353106575963718,29.976961451247167,26.0,36.0,127,3.0,58
582,245,304,27.353106575963718,30.00018140589569,26.0,32.0,128,3.0,59
583,245,465,27.353106575963718,28.490884353741496,26.0,23.0,225,1.0,220
584,245,478,27.353106575963718,29.280362811791385,26.0,23.0,247,2.0,233
585,245,623,27.353106575963718,28.490884353741496,26.0,27.0,381,1.0,378
586,245,618,27.353106575963718,29.30358276643991,26.0,18.0,382,2.0,373
587,228,69,28.46766439909297,29.930521541950114,26.0,27.0,171,1.0,159
588,228,189,28.46766439909297,30.97541950113379,26.0,27.0,115,3.0,39
589,228,189,28.46766439909297,30.998639455782314,26.0,28.0,116,3.0,39
590,228,303,28.46766439909297,29.976961451247167,26.0,36.0,99,2.0,75
591,228,304,28.46766439909297,30.00018140589569,26.0,32.0,101,2.0,76
592,228,248,28.46766439909297,31.02185941043084,26.0,26.0,112,3.0,20
593,228,466,28.46766439909297,30.859319727891158,26.0,25.0,259,2.0,238
594,228,616,28.46766439909297,30.882539682539683,26.0,23.0,402,2.0,388
595,303,189,29.976961451247167,30.998639455782314,36.0,28.0,122,1.0,114
596,303,183,29.976961451247167,32.391836734693875,36.0,26.0,159,2.0,120
597,303,248,29.976961451247167,31.02185941043084,36.0,26.0,71,1.0,55
598,303,363,29.976961451247167,32.36861678004535,36.0,21.0,119,2.0,60
599,303,469,29.976961451247167,31.579138321995465,36.0,22.0,180,2.0,166
600,303,480,29.976961451247167,32.46149659863946,36.0,25.0,207,2.0,177
601,303,627,29.976961451247167,31.579138321995465,36.0,21.0,331,2.0,324
602,303,616,29.976961451247167,32.46149659863946,36.0,24.0,331,2.0,313
603,304,183,30.00018140589569,32.391836734693875,32.0,26.0,159,2.0,121
604,304,248,30.00018140589569,31.02185941043084,32.0,26.0,71,1.0,56
605,304,363,30.00018140589569,32.36861678004535,32.0,21.0,118,2.0,59
606,304,469,30.00018140589569,31.579138321995465,32.0,22.0,178,2.0,165
607,304,480,30.00018140589569,32.46149659863946,32.0,25.0,205,2.0,176
608,304,627,30.00018140589569,31.579138321995465,32.0,21.0,330,2.0,323
609,304,616,30.00018140589569,32.46149659863946,32.0,24.0,330,2.0,312
610,248,183,31.02185941043084,32.391836734693875,26.0,26.0,88,1.0,65
611,248,68,31.02185941043084,33.668934240362816,26.0,31.0,213,3.0,180
612,248,363,31.02185941043084,32.36861678004535,26.0,21.0,129,1.0,115
613,248,237,31.02185941043084,33.715374149659866,26.0,26.0,117,3.0,11
614,248,480,31.02185941043084,32.46149659863946,26.0,25.0,240,1.0,232
615,248,466,31.02185941043084,33.274195011337866,26.0,27.0,239,2.0,218
616,248,616,31.02185941043084,32.46149659863946,26.0,24.0,373,1.0,368
617,248,615,31.02185941043084,33.274195011337866,26.0,26.0,380,2.0,367
618,363,68,32.36861678004535,33.668934240362816,21.0,31.0,300,1.0,295
619,363,68,32.36861678004535,34.06367346938776,21.0,31.0,304,2.0,295
620,363,237,32.36861678004535,33.715374149659866,21.0,26.0,139,1.0,126
621,363,251,32.36861678004535,34.06367346938776,21.0,20.0,134,2.0,112
622,363,476,32.36861678004535,34.87637188208617,21.0,25.0,156,3.0,113
623,363,617,32.36861678004535,34.06367346938776,21.0,25.0,264,2.0,254
624,237,137,33.715374149659866,35.66585034013605,26.0,29.0,131,2.0,100
625,237,188,33.715374149659866,36.19990929705215,26.0,31.0,118,2.0,49
626,237,234,33.715374149659866,35.54975056689342,26.0,24.0,79,2.0,3
627,237,476,33.715374149659866,34.87637188208617,26.0,25.0,244,1.0,239
628,237,479,33.715374149659866,35.66585034013605,26.0,19.0,256,2.0,242
629,237,470,33.715374149659866,36.45532879818594,26.0,22.0,261,3.0,233
630,237,623,33.715374149659866,35.68907029478458,26.0,17.0,395,2.0,386
631,237,624,33.715374149659866,36.47854875283447,26.0,24.0,405,3.0,387
632,251,137,34.06367346938776,35.66585034013605,20.0,29.0,133,2.0,114
633,251,188,34.06367346938776,36.19990929705215,20.0,31.0,112,2.0,63
634,251,234,34.06367346938776,35.54975056689342,20.0,24.0,66,1.0,17
635,251,237,34.06367346938776,36.94294784580499,20.0,28.0,125,3.0,14
636,251,479,34.06367346938776,35.66585034013605,20.0,19.0,238,2.0,228
637,251,470,34.06367346938776,36.45532879818594,20.0,22.0,242,2.0,219
638,251,623,34.06367346938776,35.68907029478458,20.0,17.0,379,2.0,372
639,251,624,34.06367346938776,36.47854875283447,20.0,24.0,387,2.0,373
640,234,125,35.54975056689342,37.29124716553288,24.0,28.0,132,2.0,109
641,234,237,35.54975056689342,36.94294784580499,24.0,28.0,60,1.0,3
642,234,246,35.54975056689342,37.268027210884355,24.0,26.0,75,2.0,12
643,234,233,35.54975056689342,38.42902494331066,24.0,31.0,124,3.0,1
644,234,613,35.54975056689342,37.268027210884355,24.0,24.0,386,2.0,379
645,234,613,35.54975056689342,38.080725623582765,24.0,22.0,394,3.0,379
646,234,620,35.54975056689342,37.268027210884355,24.0,24.0,393,2.0,386
647,237,137,36.94294784580499,38.800544217687076,28.0,30.0,128,2.0,100
648,237,144,36.94294784580499,39.72934240362812,28.0,29.0,152,3.0,93
649,237,233,36.94294784580499,38.42902494331066,28.0,31.0,64,1.0,4
650,237,243,36.94294784580499,39.72934240362812,28.0,22.0,120,3.0,6
651,237,613,36.94294784580499,38.080725623582765,28.0,22.0,379,1.0,376
652,237,613,36.94294784580499,39.70612244897959,28.0,20.0,394,3.0,376
653,237,625,36.94294784580499,38.87020408163266,28.0,23.0,397,2.0,388
654,237,625,36.94294784580499,39.68290249433107,28.0,18.0,406,3.0,388
655,246,137,37.268027210884355,38.800544217687076,26.0,30.0,127,2.0,109
656,246,144,37.268027210884355,39.72934240362812,26.0,29.0,147,2.0,102
657,246,138,37.268027210884355,40.170521541950116,26.0,31.0,165,3.0,108
658,246,233,37.268027210884355,38.42902494331066,26.0,31.0,52,1.0,13
659,246,243,37.268027210884355,39.72934240362812,26.0,22.0,106,2.0,3
660,246,613,37.268027210884355,39.70612244897959,26.0,20.0,382,2.0,367
661,246,625,37.268027210884355,38.87020408163266,26.0,23.0,385,2.0,379
662,246,625,37.268027210884355,39.68290249433107,26.0,18.0,393,2.0,379
663,233,144,38.42902494331066,39.72934240362812,31.0,29.0,105,1.0,89
664,233,138,38.42902494331066,40.170521541950116,31.0,31.0,121,2.0,95
665,233,243,38.42902494331066,39.72934240362812,31.0,22.0,57,1.0,10
666,233,207,38.42902494331066,40.49560090702948,31.0,27.0,93,2.0,26
667,233,613,38.42902494331066,39.70612244897959,31.0,20.0,384,1.0,380
668,233,467,38.42902494331066,40.49560090702948,31.0,26.0,250,2.0,234
669,233,480,38.42902494331066,41.28507936507937,31.0,22.0,276,3.0,247
670,233,625,38.42902494331066,39.68290249433107,31.0,18.0,396,1.0,392
671,233,624,38.42902494331066,40.49560090702948,31.0,23.0,401,2.0,391
672,233,624,38.42902494331066,41.28507936507937,31.0,29.0,410,3.0,391
673,243,31,39.72934240362812,41.540498866213156,22.0,30.0,226,2.0,212
674,243,170,39.72934240362812,42.42285714285715,22.0,31.0,137,3.0,73
675,243,228,39.72934240362812,41.95845804988662,22.0,25.0,97,2.0,15
676,243,265,39.72934240362812,42.4692970521542,22.0,27.0,120,3.0,22
677,243,480,39.72934240362812,41.28507936507937,22.0,22.0,246,2.0,237
678,243,471,39.72934240362812,42.074557823129254,22.0,22.0,249,2.0,228
679,243,624,39.72934240362812,41.28507936507937,22.0,29.0,387,2.0,381
680,243,615,39.72934240362812,42.074557823129254,22.0,27.0,385,2.0,372
681,207,31,40.49560090702948,41.540498866213156,27.0,30.0,182,1.0,176
682,207,170,40.49560090702948,42.42285714285715,27.0,31.0,91,2.0,37
683,207,228,40.49560090702948,41.95845804988662,27.0,25.0,66,1.0,21
684,207,265,40.49560090702948,42.4692970521542,27.0,27.0,103,2.0,58
685,207,245,40.49560090702948,43.281995464852606,27.0,28.0,126,3.0,38
686,207,471,40.49560090702948,42.074557823129254,27.0,22.0,273,2.0,264
687,207,615,40.49560090702948,42.074557823129254,27.0,27.0,414,2.0,408
688,228,155,41.95845804988662,43.81605442176871,25.0,31.0,108,2.0,73
689,228,67,41.95845804988662,44.7912925170068,25.0,35.0,202,3.0,161
690,228,245,41.95845804988662,43.281995464852606,25.0,28.0,59,1.0,17
691,228,247,41.95845804988662,44.76807256235828,25.0,23.0,122,3.0,19
692,228,479,41.95845804988662,43.653514739229024,25.0,20.0,261,2.0,251
693,228,466,41.95845804988662,44.373333333333335,25.0,23.0,260,2.0,238
694,228,616,41.95845804988662,43.653514739229024,25.0,24.0,395,2.0,388
695,228,616,41.95845804988662,44.46621315192744,25.0,25.0,403,3.0,388
696,265,155,42.4692970521542,43.81605442176871,27.0,31.0,124,1.0,110
697,265,67,42.4692970521542,44.7912925170068,27.0,35.0,222,2.0,198
698,265,247,42.4692970521542,44.76807256235828,27.0,23.0,101,2.0,18
699,265,479,42.4692970521542,43.653514739229024,27.0,20.0,220,1.0,214
700,265,466,42.4692970521542,44.373333333333335,27.0,23.0,217,2.0,201
701,265,464,42.4692970521542,45.255691609977326,27.0,22.0,232,3.0,199
702,265,616,42.4692970521542,43.653514739229024,27.0,24.0,355,1.0,351
703,265,616,42.4692970521542,44.46621315192744,27.0,25.0,361,2.0,351
704,265,616,42.4692970521542,45.27891156462585,27.0,19.0,371,3.0,351
705,245,67,43.281995464852606,44.7912925170068,28.0,35.0,189,2.0,178
706,245,148,43.281995464852606,45.743310657596375,28.0,28.0,144,2.0,97
707,245,247,43.281995464852606,44.76807256235828,28.0,23.0,64,1.0,2
708,245,259,43.281995464852606,45.743310657596375,28.0,25.0,107,2.0,14
709,245,217,43.281995464852606,46.068390022675736,28.0,20.0,123,3.0,28
710,245,466,43.281995464852606,44.373333333333335,28.0,23.0,226,1.0,221
711,245,464,43.281995464852606,45.255691609977326,28.0,22.0,235,2.0,219
712,245,616,43.281995464852606,44.46621315192744,28.0,25.0,374,1.0,371
713,245,616,43.281995464852606,45.27891156462585,28.0,19.0,381,2.0,371
714,245,615,43.281995464852606,46.09160997732426,28.0,19.0,389,3.0,370
715,247,175,44.76807256235828,46.85786848072563,23.0,32.0,115,2.0,72
716,247,197,44.76807256235828,47.484807256235825,23.0,38.0,127,3.0,50
717,247,217,44.76807256235828,46.068390022675736,23.0,20.0,64,1.0,30
718,247,395,44.76807256235828,47.50802721088436,23.0,16.0,189,3.0,148
719,247,469,44.76807256235828,46.85786848072563,23.0,21.0,240,2.0,222
720,247,478,44.76807256235828,47.64734693877551,23.0,19.0,262,3.0,231
721,247,615,44.76807256235828,46.09160997732426,23.0,19.0,372,1.0,368
722,247,616,44.76807256235828,47.64734693877551,23.0,21.0,389,3.0,369
723,259,175,45.743310657596375,46.85786848072563,25.0,32.0,97,1.0,84
724,259,197,45.743310657596375,47.484807256235825,25.0,38.0,97,2.0,62
725,259,63,45.743310657596375,48.32072562358277,25.0,34.0,225,3.0,196
726,259,395,45.743310657596375,47.50802721088436,25.0,16.0,156,2.0,136
727,259,469,45.743310657596375,46.85786848072563,25.0,21.0,215,1.0,210
728,259,478,45.743310657596375,47.64734693877551,25.0,19.0,234,2.0,219
729,259,476,45.743310657596375,48.46004535147392,25.0,13.0,247,3.0,217
730,259,616,45.743310657596375,47.64734693877551,25.0,21.0,366,2.0,357
731,259,626,45.743310657596375,48.46004535147392,25.0,16.0,385,3.0,367
732,217,197,46.068390022675736,47.484807256235825,20.0,38.0,64,1.0,20
733,217,63,46.068390022675736,48.32072562358277,20.0,34.0,182,2.0,154
734,217,395,46.068390022675736,47.50802721088436,20.0,16.0,188,1.0,178
735,217,242,46.068390022675736,48.78512471655329,20.0,23.0,120,3.0,25
736,217,478,46.068390022675736,47.64734693877551,20.0,19.0,270,2.0,261
737,217,476,46.068390022675736,48.46004535147392,20.0,13.0,279,2.0,259
738,217,616,46.068390022675736,47.64734693877551,20.0,21.0,405,2.0,399
739,217,626,46.068390022675736,48.46004535147392,20.0,16.0,422,2.0,409
740,395,55,47.50802721088436,49.15664399092971,16.0,31.0,347,2.0,340
741,395,129,47.50802721088436,50.062222222222225,16.0,35.0,288,3.0,266
742,395,242,47.50802721088436,48.78512471655329,16.0,23.0,163,1.0,153
743,395,280,47.50802721088436,49.20308390022676,16.0,27.0,136,2.0,115
744,395,258,47.50802721088436,50.062222222222225,16.0,18.0,176,3.0,137
745,395,491,47.50802721088436,49.179863945578234,16.0,23.0,120,2.0,96
746,395,623,47.50802721088436,49.24952380952381,16.0,12.0,240,2.0,228
747,395,624,47.50802721088436,50.0390022675737,16.0,18.0,254,3.0,229
748,395,876,47.50802721088436,49.179863945578234,16.0,2.0,486,2.0,481
749,242,129,48.78512471655329,50.062222222222225,23.0,35.0,126,1.0,113
750,242,64,48.78512471655329,51.1071201814059,23.0,28.0,204,2.0,178
751,242,258,48.78512471655329,50.062222222222225,23.0,18.0,57,1.0,16
752,242,258,48.78512471655329,51.61795918367347,23.0,22.0,123,3.0,16
753,242,479,48.78512471655329,50.758820861678004,23.0,23.0,252,2.0,237
754,242,444,48.78512471655329,51.153560090702946,23.0,17.0,226,2.0,202
755,242,624,48.78512471655329,50.0390022675737,23.0,18.0,386,1.0,382
756,242,624,48.78512471655329,51.61795918367347,23.0,20.0,401,3.0,382
757,280,64,49.20308390022676,51.1071201814059,27.0,28.0,231,2.0,216
758,280,29,49.20308390022676,52.128798185941044,27.0,37.0,281,3.0,251
759,280,258,49.20308390022676,51.61795918367347,27.0,22.0,106,2.0,22
760,280,479,49.20308390022676,50.758820861678004,27.0,23.0,210,2.0,199
761,280,444,49.20308390022676,51.153560090702946,27.0,17.0,184,2.0,164
762,280,624,49.20308390022676,51.61795918367347,27.0,20.0,359,2.0,344
763,258,64,50.062222222222225,51.1071201814059,18.0,28.0,199,1.0,194
764,258,29,50.062222222222225,52.128798185941044,18.0,37.0,246,2.0,229
765,258,372,50.062222222222225,52.33777777777778,18.0,22.0,150,2.0,114
766,258,444,50.062222222222225,51.153560090702946,18.0,17.0,192,1.0,186
767,258,455,50.062222222222225,52.33777777777778,18.0,14.0,220,2.0,197
768,258,624,50.062222222222225,51.61795918367347,18.0,20.0,372,2.0,366
769,258,661,50.062222222222225,52.314557823129256,18.0,12.0,415,2.0,403
770,258,27,51.61795918367347,53.057596371882084,22.0,30.0,239,1.0,231
771,258,237,51.61795918367347,53.91673469387755,22.0,36.0,101,2.0,21
772,258,253,51.61795918367347,53.98639455782313,22.0,30.0,102,2.0,5
773,258,477,51.61795918367347,53.893514739229026,22.0,18.0,240,2.0,219
774,258,467,51.61795918367347,54.31147392290249,22.0,22.0,239,3.0,209
775,258,664,51.61795918367347,54.33469387755102,22.0,15.0,423,3.0,406
776,372,68,52.33777777777778,54.96163265306122,22.0,29.0,324,3.0,304
777,372,69,52.33777777777778,54.984852607709755,22.0,26.0,324,3.0,303
778,372,237,52.33777777777778,53.91673469387755,22.0,36.0,151,2.0,135
779,372,253,52.33777777777778,53.98639455782313,22.0,30.0,139,2.0,119
780,372,258,52.33777777777778,55.193832199546485,22.0,27.0,168,3.0,114
781,372,477,52.33777777777778,53.893514739229026,22.0,18.0,125,2.0,105
782,372,467,52.33777777777778,54.31147392290249,22.0,22.0,127,2.0,95
783,372,773,52.33777777777778,53.893514739229026,22.0,12.0,407,2.0,401
784,372,664,52.33777777777778,54.33469387755102,22.0,15.0,304,2.0,292
785,372,822,52.33777777777778,53.91673469387755,22.0,11.0,455,2.0,450
786,372,824,52.33777777777778,53.98639455782313,22.0,-0.0,458,2.0,452
787,237,68,53.91673469387755,54.96163265306122,36.0,29.0,175,1.0,169
788,237,69,53.91673469387755,54.984852607709755,36.0,26.0,174,1.0,168
789,237,128,53.91673469387755,56.37804988662132,36.0,30.0,152,2.0,109
790,237,258,53.91673469387755,55.193832199546485,36.0,27.0,59,1.0,21
791,237,208,53.91673469387755,56.0065306122449,36.0,27.0,95,2.0,29
792,237,466,53.91673469387755,55.54213151927438,36.0,29.0,239,2.0,229
793,237,410,53.91673469387755,56.37804988662132,36.0,12.0,203,2.0,173
794,237,646,53.91673469387755,55.51891156462585,36.0,18.0,415,2.0,409
795,237,645,53.91673469387755,56.37804988662132,36.0,-2.0,422,2.0,408
796,253,128,53.98639455782313,56.37804988662132,30.0,30.0,162,2.0,125
797,253,258,53.98639455782313,55.193832199546485,30.0,27.0,52,1.0,5
798,253,208,53.98639455782313,56.0065306122449,30.0,27.0,98,2.0,45
799,253,466,53.98639455782313,55.54213151927438,30.0,29.0,223,2.0,213
800,253,410,53.98639455782313,56.37804988662132,30.0,12.0,188,2.0,157
801,253,646,53.98639455782313,55.51891156462585,30.0,18.0,399,2.0,393
802,253,645,53.98639455782313,56.37804988662132,30.0,-2.0,405,2.0,392
803,258,128,55.193832199546485,56.37804988662132,27.0,30.0,140,1.0,130
804,258,129,55.193832199546485,57.19074829931973,27.0,32.0,155,2.0,129
805,258,259,55.193832199546485,57.19074829931973,27.0,29.0,86,2.0,1
806,258,410,55.193832199546485,56.37804988662132,27.0,12.0,160,1.0,152
807,258,568,55.193832199546485,57.19074829931973,27.0,8.0,322,2.0,310
808,258,645,55.193832199546485,56.37804988662132,27.0,-2.0,390,1.0,387
809,258,662,55.193832199546485,57.167528344671204,27.0,13.0,413,2.0,404
810,208,129,56.0065306122449,57.19074829931973,27.0,32.0,94,1.0,79
811,208,67,56.0065306122449,58.39818594104309,27.0,36.0,175,2.0,141
812,208,259,56.0065306122449,57.19074829931973,27.0,29.0,72,1.0,51
813,208,231,56.0065306122449,58.35174603174603,27.0,25.0,104,2.0,23
814,208,568,56.0065306122449,57.19074829931973,27.0,8.0,364,1.0,360
815,208,488,56.0065306122449,58.258866213151926,27.0,24.0,296,2.0,280
816,208,662,56.0065306122449,57.167528344671204,27.0,13.0,457,1.0,454
817,208,641,56.0065306122449,58.258866213151926,27.0,25.0,444,2.0,433
818,259,67,57.19074829931973,58.39818594104309,29.0,36.0,199,1.0,192
819,259,64,57.19074829931973,59.93070294784581,29.0,38.0,228,3.0,195
820,259,231,57.19074829931973,58.35174603174603,29.0,25.0,57,1.0,28
821,259,241,57.19074829931973,59.791383219954646,29.0,25.0,113,3.0,18
822,259,488,57.19074829931973,58.258866213151926,29.0,24.0,234,1.0,229
823,259,595,57.19074829931973,59.025124716553286,29.0,29.0,345,2.0,336
824,259,641,57.19074829931973,58.258866213151926,29.0,25.0,385,1.0,382
825,259,644,57.19074829931973,59.025124716553286,29.0,24.0,393,2.0,385
826,231,64,58.35174603174603,59.93070294784581,25.0,38.0,180,2.0,167
827,231,241,58.35174603174603,59.791383219954646,25.0,25.0,63,1.0,10
828,460,67,1.8343764172335602,3.297233560090703,13.0,33.0,398,1.0,393
829,460,204,1.8343764172335602,4.597551020408163,13.0,34.0,282,3.0,256
830,460,228,1.8343764172335602,3.784852607709751,13.0,25.0,247,2.0,232
831,460,206,1.8343764172335602,4.597551020408163,13.0,37.0,280,3.0,254
832,460,415,1.8343764172335602,3.784852607709751,13.0,9.0,95,2.0,45
833,460,632,1.8343764172335602,3.784852607709751,13.0,5.0,191,2.0,172
834,460,923,1.8343764172335602,3.784852607709751,13.0,0.0,471,2.0,463
835,420,67,2.2755555555555556,3.297233560090703,7.0,33.0,356,1.0,353
836,420,204,2.2755555555555556,4.597551020408163,7.0,34.0,238,2.0,216
837,420,228,2.2755555555555556,3.784852607709751,7.0,25.0,203,2.0,192
838,420,206,2.2755555555555556,4.597551020408163,7.0,37.0,236,2.0,214
839,420,415,2.2755555555555556,3.784852607709751,7.0,9.0,65,2.0,5
840,420,505,2.2755555555555556,4.922630385487529,7.0,14.0,142,3.0,85
841,420,632,2.2755555555555556,3.784852607709751,7.0,5.0,222,2.0,212
842,420,621,2.2755555555555556,4.899410430839002,7.0,17.0,231,3.0,201
843,420,820,2.2755555555555556,4.9458503401360545,7.0,9.0,416,3.0,400
844,420,839,2.2755555555555556,4.992290249433107,7.0,0.0,435,3.0,419
845,415,129,3.784852607709751,5.758548752834467,9.0,31.0,298,2.0,286
846,415,204,3.784852607709751,6.57124716553288,9.0,32.0,243,3.0,211
847,415,207,3.784852607709751,5.758548752834467,9.0,29.0,225,2.0,208
848,415,208,3.784852607709751,6.57124716553288,9.0,33.0,239,3.0,207
849,415,505,3.784852607709751,4.922630385487529,9.0,14.0,102,1.0,90
850,415,411,3.784852607709751,5.758548752834467,9.0,14.0,85,2.0,4
851,415,517,3.784852607709751,6.548027210884354,9.0,9.0,157,3.0,102
852,415,621,3.784852607709751,4.899410430839002,9.0,17.0,212,1.0,206
853,415,676,3.784852607709751,5.758548752834467,9.0,8.0,274,2.0,261
854,415,631,3.784852607709751,6.57124716553288,9.0,7.0,247,3.0,216
855,415,820,3.784852607709751,4.9458503401360545,9.0,9.0,408,1.0,405
856,415,839,3.784852607709751,4.992290249433107,9.0,0.0,427,1.0,424
857,415,902,3.784852607709751,6.57124716553288,9.0,3.0,502,3.0,487
858,505,204,4.922630385487529,6.57124716553288,14.0,32.0,309,2.0,301
859,505,208,4.922630385487529,6.57124716553288,14.0,33.0,305,2.0,297
860,505,517,4.922630385487529,6.548027210884354,14.0,9.0,71,2.0,12
861,505,467,4.922630385487529,7.75546485260771,14.0,10.0,128,3.0,38
862,505,631,4.922630385487529,6.57124716553288,14.0,7.0,145,2.0,126
863,505,636,4.922630385487529,7.894784580498866,14.0,8.0,183,3.0,131
864,505,902,4.922630385487529,6.57124716553288,14.0,3.0,403,2.0,397
865,411,204,5.758548752834467,7.9412244897959186,14.0,32.0,227,2.0,207
866,411,205,5.758548752834467,7.964444444444444,14.0,32.0,227,2.0,206
867,411,205,5.758548752834467,7.987664399092971,14.0,32.0,227,2.0,206
868,411,467,5.758548752834467,7.75546485260771,14.0,10.0,103,2.0,56
869,411,545,5.758548752834467,8.40562358276644,14.0,22.0,176,3.0,134
870,411,636,5.758548752834467,7.894784580498866,14.0,8.0,243,2.0,225
871,411,629,5.758548752834467,8.359183673469389,14.0,20.0,245,3.0,218
872,411,869,5.758548752834467,8.382403628117913,14.0,0.0,472,3.0,458
873,517,204,6.548027210884354,7.9412244897959186,9.0,32.0,319,1.0,313
874,517,65,6.548027210884354,8.962902494331066,9.0,41.0,464,2.0,452
875,517,84,6.548027210884354,9.05578231292517,9.0,42.0,446,3.0,433
876,517,205,6.548027210884354,7.964444444444444,9.0,32.0,318,1.0,312
877,517,205,6.548027210884354,7.987664399092971,9.0,32.0,318,1.0,312
878,517,241,6.548027210884354,9.05578231292517,9.0,28.0,296,3.0,276
879,517,467,6.548027210884354,7.75546485260771,9.0,10.0,72,1.0,50
880,517,545,6.548027210884354,8.40562358276644,9.0,22.0,85,2.0,28
881,517,636,6.548027210884354,7.894784580498866,9.0,8.0,132,1.0,119
882,517,629,6.548027210884354,8.359183673469389,9.0,20.0,136,2.0,112
883,517,869,6.548027210884354,8.382403628117913,9.0,0.0,361,2.0,352
884,467,65,7.75546485260771,8.962902494331066,10.0,41.0,405,1.0,402
885,467,84,7.75546485260771,9.05578231292517,10.0,42.0,387,1.0,383
886,467,75,7.75546485260771,10.077460317460318,10.0,31.0,405,2.0,392
887,467,241,7.75546485260771,9.05578231292517,10.0,28.0,233,1.0,226
888,467,595,7.75546485260771,9.7059410430839,10.0,21.0,153,2.0,128
889,467,459,7.75546485260771,10.077460317460318,10.0,12.0,100,2.0,8
890,467,666,7.75546485260771,9.7059410430839,10.0,20.0,216,2.0,199
891,467,836,7.75546485260771,9.7059410430839,10.0,1.0,378,2.0,369
892,545,75,8.40562358276644,10.077460317460318,22.0,31.0,475,2.0,470
893,545,251,8.40562358276644,10.913378684807256,22.0,22.0,313,3.0,294
894,545,255,8.40562358276644,11.168798185941043,22.0,24.0,313,3.0,290
895,545,595,8.40562358276644,9.7059410430839,22.0,21.0,75,1.0,50
896,545,459,8.40562358276644,10.077460317460318,22.0,12.0,112,2.0,86
897,545,513,8.40562358276644,11.261678004535147,22.0,6.0,127,3.0,32
898,545,666,8.40562358276644,9.7059410430839,22.0,20.0,133,1.0,121
899,545,836,8.40562358276644,9.7059410430839,22.0,1.0,296,1.0,291
900,595,251,9.7059410430839,10.913378684807256,21.0,22.0,348,1.0,344
901,595,255,9.7059410430839,11.168798185941043,21.0,24.0,346,1.0,340
902,595,255,9.7059410430839,12.422675736961452,21.0,34.0,360,3.0,340
903,595,513,9.7059410430839,11.261678004535147,21.0,6.0,106,2.0,82
904,595,515,9.7059410430839,12.07437641723356,21.0,17.0,130,2.0,80
905,595,642,9.7059410430839,12.399455782312925,21.0,8.0,125,3.0,47
906,595,888,9.7059410430839,12.445895691609978,21.0,-0.0,316,3.0,293
907,459,65,10.077460317460318,12.445895691609978,12.0,24.0,407,2.0,394
908,459,255,10.077460317460318,11.168798185941043,12.0,24.0,209,1.0,204
909,459,255,10.077460317460318,12.422675736961452,12.0,34.0,228,2.0,204
910,459,513,10.077460317460318,11.261678004535147,12.0,6.0,74,1.0,54
911,459,515,10.077460317460318,12.07437641723356,12.0,17.0,103,2.0,56
912,459,642,10.077460317460318,12.399455782312925,12.0,8.0,209,2.0,183
913,459,888,10.077460317460318,12.445895691609978,12.0,-0.0,441,2.0,429
914,513,65,11.261678004535147,12.445895691609978,6.0,24.0,451,1.0,448
915,513,138,11.261678004535147,13.955192743764172,6.0,27.0,393,3.0,375
916,513,82,11.261678004535147,14.071292517006803,6.0,36.0,448,3.0,431
917,513,255,11.261678004535147,12.422675736961452,6.0,34.0,263,1.0,258
918,513,255,11.261678004535147,13.583673469387755,6.0,28.0,277,2.0,258
919,513,522,11.261678004535147,13.235374149659863,6.0,10.0,85,2.0,9
920,513,458,11.261678004535147,14.210612244897959,6.0,15.0,138,3.0,55
921,513,642,11.261678004535147,12.399455782312925,6.0,8.0,138,1.0,129
922,513,643,11.261678004535147,13.212154195011339,6.0,-1.0,155,2.0,130
923,513,888,11.261678004535147,12.445895691609978,6.0,-0.0,378,1.0,375
924,515,138,12.07437641723356,13.955192743764172,17.0,27.0,386,2.0,377
925,515,82,12.07437641723356,14.071292517006803,17.0,36.0,441,2.0,433
926,515,255,12.07437641723356,13.583673469387755,17.0,28.0,268,2.0,260
927,515,232,12.07437641723356,14.373151927437641,17.0,19.0,300,2.0,283
928,515,522,12.07437641723356,13.235374149659863,17.0,10.0,50,1.0,7
929,515,458,12.07437641723356,14.210612244897959,17.0,15.0,108,2.0,57
930,515,643,12.07437641723356,13.212154195011339,17.0,-1.0,137,1.0,128
931,515,643,12.07437641723356,14.419591836734694,17.0,11.0,163,2.0,128
932,515,888,12.07437641723356,14.373151927437641,17.0,-3.0,386,2.0,373
933,522,130,13.235374149659863,15.09297052154195,10.0,36.0,400,2.0,392
934,522,232,13.235374149659863,14.373151927437641,10.0,19.0,294,1.0,290
935,522,260,13.235374149659863,15.789569160997733,10.0,23.0,284,3.0,262
936,522,261,13.235374149659863,16.068208616780044,10.0,21.0,288,3.0,261
937,522,477,13.235374149659863,15.766349206349206,10.0,18.0,118,3.0,45
938,522,643,13.235374149659863,14.419591836734694,10.0,11.0,131,1.0,121
939,522,681,13.235374149659863,15.209070294784581,10.0,16.0,180,2.0,159
940,522,888,13.235374149659863,14.373151927437641,10.0,-3.0,369,1.0,366
941,522,878,13.235374149659863,15.185850340136055,10.0,-2.0,366,2.0,356
942,458,68,14.210612244897959,16.81124716553288,15.0,32.0,406,3.0,390
943,458,260,14.210612244897959,15.789569160997733,15.0,23.0,209,2.0,198
944,458,261,14.210612244897959,16.068208616780044,15.0,21.0,213,2.0,197
945,458,255,14.210612244897959,17.11310657596372,15.0,20.0,238,3.0,203
946,458,477,14.210612244897959,15.766349206349206,15.0,18.0,70,2.0,19
947,458,605,14.210612244897959,16.27718820861678,15.0,19.0,172,2.0,147
948,458,656,14.210612244897959,16.300408163265306,15.0,19.0,217,2.0,198
949,458,826,14.210612244897959,16.27718820861678,15.0,-3.0,379,2.0,368
950,458,821,14.210612244897959,17.11310657596372,15.0,-1.0,384,3.0,363
951,477,68,15.766349206349206,16.81124716553288,18.0,32.0,411,1.0,409
952,477,29,15.766349206349206,17.623945578231293,18.0,35.0,455,2.0,448
953,477,22,15.766349206349206,18.15800453514739,18.0,30.0,467,2.0,455
954,477,255,15.766349206349206,17.11310657596372,18.0,20.0,229,1.0,222
955,477,208,15.766349206349206,18.692063492063493,18.0,17.0,297,3.0,269
956,477,537,15.766349206349206,17.531065759637187,18.0,16.0,97,2.0,60
957,477,498,15.766349206349206,18.320544217687075,18.0,20.0,112,3.0,21
958,477,616,15.766349206349206,17.531065759637187,18.0,18.0,158,2.0,139
959,477,658,15.766349206349206,18.320544217687075,18.0,24.0,212,3.0,181
960,477,821,15.766349206349206,17.11310657596372,18.0,-1.0,349,1.0,344
961,477,896,15.766349206349206,18.320544217687075,18.0,-5.0,433,3.0,419
962,605,208,16.27718820861678,18.692063492063493,19.0,17.0,410,2.0,397
963,605,205,16.27718820861678,19.086802721088436,19.0,28.0,418,3.0,400
964,605,537,16.27718820861678,17.531065759637187,19.0,16.0,87,1.0,68
965,605,498,16.27718820861678,18.320544217687075,19.0,20.0,139,2.0,107
966,605,616,16.27718820861678,17.531065759637187,19.0,18.0,55,1.0,11
967,605,658,16.27718820861678,18.320544217687075,19.0,24.0,103,2.0,53
968,605,896,16.27718820861678,18.320544217687075,19.0,-5.0,304,2.0,291
969,605,888,16.27718820861678,19.086802721088436,19.0,2.0,308,3.0,283
970,537,57,17.531065759637187,19.82984126984127,16.0,32.0,490,2.0,480
971,537,208,17.531065759637187,18.692063492063493,16.0,17.0,333,1.0,329
972,537,205,17.531065759637187,19.086802721088436,16.0,28.0,339,2.0,332
973,537,478,17.531065759637187,19.922721088435374,16.0,22.0,119,2.0,59
974,537,655,17.531065759637187,19.945941043083902,16.0,14.0,157,2.0,118
975,537,655,17.531065759637187,19.99238095238095,16.0,6.0,159,2.0,118
976,537,888,17.531065759637187,19.086802721088436,16.0,2.0,357,2.0,351
977,498,57,18.320544217687075,19.82984126984127,20.0,32.0,446,2.0,441
978,498,22,18.320544217687075,20.17814058956916,20.0,32.0,483,2.0,476
979,498,232,18.320544217687075,20.688979591836734,20.0,23.0,285,2.0,266
980,498,228,18.320544217687075,21.037278911564627,20.0,27.0,294,3.0,270
981,498,478,18.320544217687075,19.922721088435374,20.0,22.0,72,2.0,20
982,498,475,18.320544217687075,20.526439909297054,20.0,15.0,98,2.0,23
983,498,655,18.320544217687075,19.945941043083902,20.0,14.0,172,2.0,157
984,498,655,18.320544217687075,19.99238095238095,20.0,6.0,173,2.0,157
985,498,885,18.320544217687075,21.0140589569161,20.0,-1.0,404,3.0,387
986,478,22,19.922721088435374,21.501678004535147,22.0,30.0,461,2.0,456
987,478,22,19.922721088435374,22.38403628117914,22.0,33.0,468,2.0,456
988,478,228,19.922721088435374,21.037278911564627,22.0,27.0,255,1.0,250
989,478,459,19.922721088435374,21.36235827664399,22.0,23.0,65,1.0,19
990,478,463,19.922721088435374,22.221496598639455,22.0,9.0,100,2.0,15
991,478,661,19.922721088435374,21.478458049886623,22.0,24.0,195,2.0,183
992,478,670,19.922721088435374,22.221496598639455,22.0,6.0,216,2.0,192
993,478,885,19.922721088435374,21.0140589569161,22.0,-1.0,410,1.0,407
994,478,899,19.922721088435374,22.221496598639455,22.0,-0.0,432,2.0,421
995,475,22,20.526439909297054,22.38403628117914,15.0,33.0,460,2.0,453
996,475,202,20.526439909297054,23.034195011337868,15.0,31.0,294,3.0,273
997,475,235,20.526439909297054,22.96453514739229,15.0,25.0,262,2.0,240
998,475,234,20.526439909297054,22.98775510204082,15.0,32.0,263,2.0,241
999,475,463,20.526439909297054,22.221496598639455,15.0,9.0,74,2.0,12
1000,475,472,20.526439909297054,23.057414965986396,15.0,20.0,109,3.0,3
1001,475,670,20.526439909297054,22.221496598639455,15.0,6.0,208,2.0,195
1002,475,615,20.526439909297054,23.08063492063492,15.0,19.0,178,3.0,140
1003,475,899,20.526439909297054,22.221496598639455,15.0,-0.0,430,2.0,424
1004,475,886,20.526439909297054,22.98775510204082,15.0,2.0,424,2.0,411
1005,459,22,21.36235827664399,22.38403628117914,23.0,33.0,439,1.0,437
1006,459,202,21.36235827664399,23.034195011337868,23.0,31.0,267,2.0,257
1007,459,235,21.36235827664399,22.96453514739229,23.0,25.0,234,2.0,224
1008,459,234,21.36235827664399,22.98775510204082,23.0,32.0,236,2.0,225
1009,459,472,21.36235827664399,23.057414965986396,23.0,20.0,74,2.0,13
1010,459,615,21.36235827664399,23.08063492063492,23.0,19.0,173,2.0,156
1011,459,886,21.36235827664399,22.98775510204082,23.0,2.0,433,2.0,427
1012,463,204,22.221496598639455,24.961451247165535,9.0,26.0,285,3.0,259
1013,463,204,22.221496598639455,24.98467120181406,9.0,31.0,285,3.0,259
1014,463,205,22.221496598639455,24.961451247165535,9.0,32.0,284,3.0,258
1015,463,205,22.221496598639455,24.98467120181406,9.0,32.0,284,3.0,258
1016,463,499,22.221496598639455,24.961451247165535,9.0,17.0,123,3.0,36
1017,463,670,22.221496598639455,24.961451247165535,9.0,14.0,238,3.0,207
1018,463,681,22.221496598639455,25.007891156462584,9.0,23.0,249,3.0,218
1019,463,889,22.221496598639455,24.961451247165535,9.0,4.0,442,3.0,426
1020,463,889,22.221496598639455,24.98467120181406,9.0,5.0,442,3.0,426
1021,472,204,23.057414965986396,24.961451247165535,20.0,26.0,280,2.0,268
1022,472,204,23.057414965986396,24.98467120181406,20.0,31.0,281,2.0,268
1023,472,205,23.057414965986396,24.961451247165535,20.0,32.0,279,2.0,267
1024,472,205,23.057414965986396,24.98467120181406,20.0,32.0,280,2.0,267
1025,472,499,23.057414965986396,24.961451247165535,20.0,17.0,86,2.0,27
1026,472,508,23.057414965986396,25.379410430839002,20.0,23.0,106,2.0,36
1027,472,670,23.057414965986396,24.961451247165535,20.0,14.0,214,2.0,198
1028,472,681,23.057414965986396,25.007891156462584,20.0,23.0,225,2.0,209
1029,472,889,23.057414965986396,24.961451247165535,20.0,4.0,425,2.0,417
1030,472,889,23.057414965986396,24.98467120181406,20.0,5.0,425,2.0,417
1031,499,124,24.961451247165535,26.865487528344673,17.0,31.0,384,2.0,375
1032,499,31,24.961451247165535,27.376326530612246,17.0,28.0,479,2.0,468
1033,499,232,24.961451247165535,26.865487528344673,17.0,23.0,279,2.0,267
1034,499,245,24.961451247165535,27.353106575963718,17.0,26.0,274,2.0,254
1035,499,524,24.961451247165535,26.122448979591837,17.0,20.0,56,1.0,25
1036,499,479,24.961451247165535,27.678185941043086,17.0,25.0,119,3.0,20
1037,499,625,24.961451247165535,26.888707482993198,17.0,26.0,151,2.0,126
1038,499,621,24.961451247165535,27.678185941043086,17.0,28.0,169,3.0,122
1039,499,900,24.961451247165535,26.122448979591837,17.0,-1.0,404,1.0,401
1040,499,896,24.961451247165535,27.678185941043086,17.0,1.0,414,3.0,397
1041,508,124,25.379410430839002,26.865487528344673,23.0,31.0,389,1.0,384
1042,508,31,25.379410430839002,27.376326530612246,23.0,28.0,485,2.0,477
1043,508,232,25.379410430839002,26.865487528344673,23.0,23.0,283,1.0,276
1044,508,245,25.379410430839002,27.353106575963718,23.0,26.0,276,2.0,263
1045,508,479,25.379410430839002,27.678185941043086,23.0,25.0,103,2.0,29
1046,508,625,25.379410430839002,26.888707482993198,23.0,26.0,134,2.0,117
1047,508,621,25.379410430839002,27.678185941043086,23.0,28.0,150,2.0,113
1048,508,896,25.379410430839002,27.678185941043086,23.0,1.0,400,2.0,388
1049,524,31,26.122448979591837,27.376326530612246,20.0,28.0,496,1.0,493
1050,524,84,26.122448979591837,28.444444444444446,20.0,28.0,451,2.0,440
1051,524,245,26.122448979591837,27.353106575963718,20.0,26.0,284,1.0,279
1052,524,228,26.122448979591837,28.46766439909297,20.0,26.0,313,2.0,296
1053,524,479,26.122448979591837,27.678185941043086,20.0,25.0,81,2.0,45
1054,524,465,26.122448979591837,28.490884353741496,20.0,23.0,118,2.0,59
1055,524,621,26.122448979591837,27.678185941043086,20.0,28.0,118,2.0,97
1056,524,623,26.122448979591837,28.490884353741496,20.0,27.0,142,2.0,99
1057,524,896,26.122448979591837,27.678185941043086,20.0,1.0,378,2.0,372
1058,524,876,26.122448979591837,28.46766439909297,20.0,-3.0,366,2.0,352
1059,479,69,27.678185941043086,29.930521541950114,25.0,27.0,421,2.0,410
1060,479,303,27.678185941043086,29.976961451247167,25.0,36.0,202,2.0,176
1061,479,304,27.678185941043086,30.00018140589569,25.0,32.0,202,2.0,175
1062,479,478,27.678185941043086,29.280362811791385,25.0,23.0,69,2.0,1
1063,479,618,27.678185941043086,29.30358276643991,25.0,18.0,156,2.0,139
1064,479,887,27.678185941043086,29.164263038548754,25.0,8.0,413,1.0,408
1065,465,69,28.490884353741496,29.930521541950114,23.0,27.0,401,1.0,396
1066,465,189,28.490884353741496,30.97541950113379,23.0,27.0,296,2.0,276
1067,465,189,28.490884353741496,30.998639455782314,23.0,28.0,296,3.0,276
1068,465,303,28.490884353741496,29.976961451247167,23.0,36.0,174,1.0,162
1069,465,304,28.490884353741496,30.00018140589569,23.0,32.0,174,2.0,161
1070,465,248,28.490884353741496,31.02185941043084,23.0,26.0,243,3.0,217
1071,465,466,28.490884353741496,30.859319727891158,23.0,25.0,102,2.0,1
1072,465,616,28.490884353741496,30.882539682539683,23.0,23.0,183,2.0,151
1073,465,887,28.490884353741496,30.859319727891158,23.0,4.0,434,2.0,422
1074,478,189,29.280362811791385,30.97541950113379,23.0,27.0,298,2.0,289
1075,478,189,29.280362811791385,30.998639455782314,23.0,28.0,298,2.0,289
1076,478,248,29.280362811791385,31.02185941043084,23.0,26.0,242,2.0,230
1077,478,466,29.280362811791385,30.859319727891158,23.0,25.0,69,2.0,12
1078,478,469,29.280362811791385,31.579138321995465,23.0,22.0,99,2.0,9
1079,478,616,29.280362811791385,30.882539682539683,23.0,23.0,154,2.0,138
1080,478,627,29.280362811791385,31.579138321995465,23.0,21.0,179,2.0,149
1081,478,887,29.280362811791385,30.859319727891158,23.0,4.0,415,2.0,409
1082,478,821,29.280362811791385,31.579138321995465,23.0,-0.0,357,2.0,343
1083,466,183,30.859319727891158,32.391836734693875,25.0,26.0,291,2.0,283
1084,466,68,30.859319727891158,33.668934240362816,25.0,31.0,416,3.0,398
1085,466,363,30.859319727891158,32.36861678004535,25.0,21.0,122,2.0,103
1086,466,237,30.859319727891158,33.715374149659866,25.0,26.0,260,3.0,229
1087,466,480,30.859319727891158,32.46149659863946,25.0,25.0,70,2.0,14
1088,466,616,30.859319727891158,32.46149659863946,25.0,24.0,165,2.0,150
1089,466,615,30.859319727891158,33.274195011337866,25.0,26.0,182,2.0,149
1090,466,896,30.859319727891158,32.36861678004535,25.0,1.0,435,2.0,430
1091,466,887,30.859319727891158,33.274195011337866,25.0,-1.0,434,2.0,421
1092,469,68,31.579138321995465,33.668934240362816,22.0,31.0,411,2.0,401
1093,469,68,31.579138321995465,34.06367346938776,22.0,31.0,415,2.0,401
1094,469,237,31.579138321995465,33.715374149659866,22.0,26.0,250,2.0,232
1095,469,251,31.579138321995465,34.06367346938776,22.0,20.0,243,2.0,218
1096,469,466,31.579138321995465,33.274195011337866,22.0,27.0,73,2.0,3
1097,469,615,31.579138321995465,33.274195011337866,22.0,26.0,163,2.0,146
1098,469,617,31.579138321995465,34.06367346938776,22.0,25.0,183,2.0,148
1099,469,887,31.579138321995465,33.274195011337866,22.0,-1.0,424,2.0,418
1100,469,896,31.579138321995465,34.06367346938776,22.0,2.0,440,2.0,427
1101,480,68,32.46149659863946,33.668934240362816,25.0,31.0,415,1.0,412
1102,480,68,32.46149659863946,34.06367346938776,25.0,31.0,418,2.0,412
1103,480,237,32.46149659863946,33.715374149659866,25.0,26.0,249,1.0,243
1104,480,251,32.46149659863946,34.06367346938776,25.0,20.0,239,2.0,229
1105,480,476,32.46149659863946,34.87637188208617,25.0,25.0,104,2.0,4
1106,480,617,32.46149659863946,34.06367346938776,25.0,25.0,153,2.0,137
1107,480,896,32.46149659863946,34.06367346938776,25.0,2.0,422,2.0,416
1108,466,137,33.274195011337866,35.66585034013605,27.0,29.0,345,2.0,329
1109,466,188,33.274195011337866,36.19990929705215,27.0,31.0,305,3.0,278
1110,466,234,33.274195011337866,35.54975056689342,27.0,24.0,252,2.0,232
1111,466,476,33.274195011337866,34.87637188208617,27.0,25.0,70,2.0,10
1112,466,479,33.274195011337866,35.66585034013605,27.0,19.0,104,2.0,13
1113,466,623,33.274195011337866,35.68907029478458,27.0,17.0,188,2.0,157
1114,466,889,33.274195011337866,35.5265306122449,27.0,-4.0,434,2.0,423
1115,476,188,34.87637188208617,36.19990929705215,25.0,31.0,294,1.0,288
1116,476,125,34.87637188208617,37.29124716553288,25.0,28.0,366,2.0,351
1117,476,237,34.87637188208617,36.94294784580499,25.0,28.0,255,2.0,239
1118,476,246,34.87637188208617,37.268027210884355,25.0,26.0,252,2.0,230
1119,476,470,34.87637188208617,36.45532879818594,25.0,22.0,68,2.0,6
1120,476,613,34.87637188208617,37.268027210884355,25.0,24.0,171,2.0,137
1121,476,624,34.87637188208617,36.47854875283447,25.0,24.0,163,2.0,148
1122,476,620,34.87637188208617,37.268027210884355,25.0,24.0,177,2.0,144
1123,476,888,34.87637188208617,36.45532879818594,25.0,2.0,418,2.0,412
1124,476,899,34.87637188208617,37.268027210884355,25.0,5.0,435,2.0,423
1125,479,125,35.66585034013605,37.29124716553288,19.0,28.0,361,2.0,354
1126,479,237,35.66585034013605,36.94294784580499,19.0,28.0,248,1.0,242
1127,479,246,35.66585034013605,37.268027210884355,19.0,26.0,243,2.0,233
1128,479,233,35.66585034013605,38.42902494331066,19.0,31.0,273,3.0,246
1129,479,613,35.66585034013605,37.268027210884355,19.0,24.0,151,2.0,134
1130,479,613,35.66585034013605,38.080725623582765,19.0,22.0,170,2.0,134
1131,479,620,35.66585034013605,37.268027210884355,19.0,24.0,157,2.0,141
1132,479,899,35.66585034013605,37.268027210884355,19.0,5.0,426,2.0,420
1133,479,905,35.66585034013605,38.40580498866213,19.0,-1.0,442,3.0,426
1134,470,137,36.45532879818594,38.800544217687076,22.0,30.0,348,2.0,333
1135,470,233,36.45532879818594,38.42902494331066,22.0,31.0,252,2.0,237
1136,470,613,36.45532879818594,38.080725623582765,22.0,22.0,159,2.0,143
1137,470,625,36.45532879818594,38.87020408163266,22.0,23.0,187,2.0,155
1138,470,905,36.45532879818594,38.40580498866213,22.0,-1.0,443,2.0,435
1139,613,137,37.268027210884355,38.800544217687076,24.0,30.0,481,2.0,476
1140,613,144,37.268027210884355,39.72934240362812,24.0,29.0,481,2.0,469
1141,613,138,37.268027210884355,40.170521541950116,24.0,31.0,491,3.0,475
1142,613,233,37.268027210884355,38.42902494331066,24.0,31.0,383,1.0,380
1143,613,243,37.268027210884355,39.72934240362812,24.0,22.0,385,2.0,370
1144,613,625,37.268027210884355,38.87020408163266,24.0,23.0,70,2.0,12
1145,613,625,37.268027210884355,39.68290249433107,24.0,18.0,105,2.0,12
1146,613,905,37.268027210884355,38.40580498866213,24.0,-1.0,296,1.0,292
1147,613,888,37.268027210884355,39.68290249433107,24.0,-1.0,294,2.0,275
1148,613,144,38.080725623582765,39.72934240362812,22.0,29.0,474,2.0,469
1149,613,138,38.080725623582765,40.170521541950116,22.0,31.0,483,2.0,475
1150,613,243,38.080725623582765,39.72934240362812,22.0,22.0,377,2.0,370
1151,613,207,38.080725623582765,40.49560090702948,22.0,27.0,419,2.0,406
1152,613,467,38.080725623582765,40.49560090702948,22.0,26.0,179,2.0,146
1153,613,625,38.080725623582765,39.68290249433107,22.0,18.0,70,2.0,12
1154,613,624,38.080725623582765,40.49560090702948,22.0,23.0,105,2.0,11
1155,613,888,38.080725623582765,39.68290249433107,22.0,-1.0,284,2.0,275
1156,613,901,38.080725623582765,40.47238095238095,22.0,2.0,306,2.0,288
1157,613,170,39.70612244897959,42.42285714285715,20.0,31.0,458,3.0,443
1158,613,228,39.70612244897959,41.95845804988662,20.0,25.0,397,2.0,385
1159,613,265,39.70612244897959,42.4692970521542,20.0,27.0,368,3.0,348
1160,613,480,39.70612244897959,41.28507936507937,20.0,22.0,149,2.0,133
1161,613,471,39.70612244897959,42.074557823129254,20.0,22.0,175,2.0,142
1162,613,624,39.70612244897959,41.28507936507937,20.0,29.0,69,2.0,11
1163,613,615,39.70612244897959,42.074557823129254,20.0,27.0,102,2.0,2
1164,613,891,39.70612244897959,42.4692970521542,20.0,0.0,302,3.0,278
1165,467,31,40.49560090702948,41.540498866213156,26.0,30.0,438,1.0,436
1166,467,170,40.49560090702948,42.42285714285715,26.0,31.0,308,2.0,297
1167,467,228,40.49560090702948,41.95845804988662,26.0,25.0,247,1.0,239
1168,467,265,40.49560090702948,42.4692970521542,26.0,27.0,219,2.0,202
1169,467,245,40.49560090702948,43.281995464852606,26.0,28.0,252,3.0,222
1170,467,471,40.49560090702948,42.074557823129254,26.0,22.0,68,2.0,4
1171,467,615,40.49560090702948,42.074557823129254,26.0,27.0,163,2.0,148
1172,467,891,40.49560090702948,42.4692970521542,26.0,0.0,432,2.0,424
1173,480,170,41.28507936507937,42.42285714285715,22.0,31.0,314,1.0,310
1174,480,155,41.28507936507937,43.81605442176871,22.0,31.0,343,3.0,325
1175,480,265,41.28507936507937,42.4692970521542,22.0,27.0,221,1.0,215
1176,480,245,41.28507936507937,43.281995464852606,22.0,28.0,250,2.0,235
1177,480,479,41.28507936507937,43.653514739229024,22.0,20.0,102,2.0,1
1178,480,616,41.28507936507937,43.653514739229024,22.0,24.0,170,2.0,136
1179,480,891,41.28507936507937,42.4692970521542,22.0,0.0,414,1.0,411
1180,480,900,41.28507936507937,43.653514739229024,22.0,2.0,432,2.0,420
1181,471,155,42.074557823129254,43.81605442176871,22.0,31.0,325,2.0,316
1182,471,67,42.074557823129254,44.7912925170068,22.0,35.0,421,3.0,404
1183,471,245,42.074557823129254,43.281995464852606,22.0,28.0,232,1.0,226
1184,471,247,42.074557823129254,44.76807256235828,22.0,23.0,252,3.0,224
1185,471,479,42.074557823129254,43.653514739229024,22.0,20.0,68,2.0,8
1186,471,466,42.074557823129254,44.373333333333335,22.0,23.0,99,2.0,5
1187,471,616,42.074557823129254,43.653514739229024,22.0,24.0,160,2.0,145
1188,471,616,42.074557823129254,44.46621315192744,22.0,25.0,178,2.0,145
1189,471,900,42.074557823129254,43.653514739229024,22.0,2.0,434,2.0,429
1190,471,888,42.074557823129254,44.44299319727891,22.0,-0.0,429,2.0,417
1191,479,67,43.653514739229024,44.7912925170068,20.0,35.0,415,1.0,412
1192,479,148,43.653514739229024,45.743310657596375,20.0,28.0,343,2.0,331
1193,479,247,43.653514739229024,44.76807256235828,20.0,23.0,237,1.0,232
1194,479,259,43.653514739229024,45.743310657596375,20.0,25.0,238,2.0,220
1195,479,217,43.653514739229024,46.068390022675736,20.0,20.0,282,2.0,262
1196,479,464,43.653514739229024,45.255691609977326,20.0,22.0,71,2.0,15
1197,479,616,43.653514739229024,45.27891156462585,20.0,19.0,154,2.0,137
1198,479,615,43.653514739229024,46.09160997732426,20.0,19.0,172,2.0,136
1199,479,887,43.653514739229024,45.743310657596375,20.0,-4.0,418,2.0,408
1200,466,148,44.373333333333335,45.743310657596375,23.0,28.0,323,1.0,318
1201,466,175,44.373333333333335,46.85786848072563,23.0,32.0,310,2.0,291
1202,466,259,44.373333333333335,45.743310657596375,23.0,25.0,215,1.0,207
1203,466,217,44.373333333333335,46.068390022675736,23.0,20.0,259,2.0,249
1204,466,469,44.373333333333335,46.85786848072563,23.0,21.0,107,2.0,3
1205,466,615,44.373333333333335,46.09160997732426,23.0,19.0,166,2.0,149
1206,466,887,44.373333333333335,45.743310657596375,23.0,-4.0,425,1.0,421
1207,466,820,44.373333333333335,46.834648526077096,23.0,-3.0,370,2.0,354
1208,464,175,45.255691609977326,46.85786848072563,22.0,32.0,297,2.0,289
1209,464,197,45.255691609977326,47.484807256235825,22.0,38.0,284,2.0,267
1210,464,395,45.255691609977326,47.50802721088436,22.0,16.0,119,2.0,69
1211,464,469,45.255691609977326,46.85786848072563,22.0,21.0,69,2.0,5
1212,464,478,45.255691609977326,47.64734693877551,22.0,19.0,104,2.0,14
1213,464,616,45.255691609977326,47.64734693877551,22.0,21.0,184,2.0,152
1214,464,820,45.255691609977326,46.834648526077096,22.0,-3.0,362,2.0,356
1215,464,886,45.255691609977326,47.484807256235825,22.0,-2.0,433,2.0,422
1216,469,63,46.85786848072563,48.32072562358277,21.0,34.0,411,1.0,406
1217,469,55,46.85786848072563,49.15664399092971,21.0,31.0,426,2.0,414
1218,469,242,46.85786848072563,48.78512471655329,21.0,23.0,242,2.0,227
1219,469,280,46.85786848072563,49.20308390022676,21.0,27.0,214,2.0,189
1220,469,476,46.85786848072563,48.46004535147392,21.0,13.0,69,2.0,7
1221,469,491,46.85786848072563,49.179863945578234,21.0,23.0,102,2.0,22
1222,469,626,46.85786848072563,48.46004535147392,21.0,16.0,171,2.0,157
1223,469,623,46.85786848072563,49.24952380952381,21.0,12.0,185,2.0,154
1224,469,900,46.85786848072563,48.87800453514739,21.0,-5.0,440,2.0,431
1225,469,876,46.85786848072563,49.179863945578234,21.0,2.0,419,2.0,407
1226,478,55,47.64734693877551,49.15664399092971,19.0,31.0,428,2.0,423
1227,478,129,47.64734693877551,50.062222222222225,19.0,35.0,364,2.0,349
1228,478,242,47.64734693877551,48.78512471655329,19.0,23.0,241,1.0,236
1229,478,280,47.64734693877551,49.20308390022676,19.0,27.0,209,2.0,198
1230,478,258,47.64734693877551,50.062222222222225,19.0,18.0,243,2.0,220
1231,478,491,47.64734693877551,49.179863945578234,19.0,23.0,67,2.0,13
1232,478,623,47.64734693877551,49.24952380952381,19.0,12.0,161,2.0,145
1233,478,624,47.64734693877551,50.0390022675737,19.0,18.0,179,2.0,146
1234,478,900,47.64734693877551,48.87800453514739,19.0,-5.0,425,1.0,422
1235,478,876,47.64734693877551,49.179863945578234,19.0,2.0,403,2.0,398
1236,478,900,47.64734693877551,50.062222222222225,19.0,-2.0,435,2.0,422
1237,476,129,48.46004535147392,50.062222222222225,13.0,35.0,354,2.0,347
1238,476,64,48.46004535147392,51.1071201814059,13.0,28.0,427,3.0,412
1239,476,258,48.46004535147392,50.062222222222225,13.0,18.0,229,2.0,218
1240,476,479,48.46004535147392,50.758820861678004,13.0,23.0,99,2.0,3
1241,476,444,48.46004535147392,51.153560090702946,13.0,17.0,120,3.0,32
1242,476,624,48.46004535147392,50.0390022675737,13.0,18.0,163,2.0,148
1243,476,900,48.46004535147392,50.062222222222225,13.0,-2.0,430,2.0,424
1244,491,64,49.179863945578234,51.1071201814059,23.0,28.0,435,2.0,427
1245,491,29,49.179863945578234,52.128798185941044,23.0,37.0,479,3.0,462
1246,491,258,49.179863945578234,51.61795918367347,23.0,22.0,256,2.0,233
1247,491,479,49.179863945578234,50.758820861678004,23.0,23.0,69,2.0,12
1248,491,444,49.179863945578234,51.153560090702946,23.0,17.0,97,2.0,47
1249,491,624,49.179863945578234,51.61795918367347,23.0,20.0,169,2.0,133
1250,491,888,49.179863945578234,51.61795918367347,23.0,-2.0,411,2.0,397
1251,479,29,50.758820861678004,52.128798185941044,23.0,37.0,454,1.0,450
1252,479,27,50.758820861678004,53.057596371882084,23.0,30.0,463,2.0,452
1253,479,372,50.758820861678004,52.33777777777778,23.0,22.0,127,2.0,107
1254,479,455,50.758820861678004,52.33777777777778,23.0,14.0,72,2.0,24
1255,479,661,50.758820861678004,52.314557823129256,23.0,12.0,194,2.0,182
1256,444,27,51.153560090702946,53.057596371882084,17.0,30.0,425,2.0,417
1257,444,372,51.153560090702946,52.33777777777778,17.0,22.0,88,1.0,72
1258,444,237,51.153560090702946,53.91673469387755,17.0,36.0,239,3.0,207
1259,444,253,51.153560090702946,53.98639455782313,17.0,30.0,227,3.0,191
1260,444,455,51.153560090702946,52.33777777777778,17.0,14.0,52,1.0,11
1261,444,477,51.153560090702946,53.893514739229026,17.0,18.0,123,3.0,33
1262,444,661,51.153560090702946,52.314557823129256,17.0,12.0,223,1.0,217
1263,444,773,51.153560090702946,53.893514739229026,17.0,12.0,350,3.0,329
1264,444,822,51.153560090702946,53.91673469387755,17.0,11.0,396,3.0,378
1265,444,824,51.153560090702946,53.98639455782313,17.0,-0.0,399,3.0,380
1266,455,68,52.33777777777778,54.96163265306122,14.0,29.0,403,3.0,387
1267,455,69,52.33777777777778,54.984852607709755,14.0,26.0,402,3.0,386
1268,455,237,52.33777777777778,53.91673469387755,14.0,36.0,228,2.0,218
1269,455,253,52.33777777777778,53.98639455782313,14.0,30.0,214,2.0,202
1270,455,258,52.33777777777778,55.193832199546485,14.0,27.0,232,3.0,197
1271,455,477,52.33777777777778,53.893514739229026,14.0,18.0,71,2.0,22
1272,455,467,52.33777777777778,54.31147392290249,14.0,22.0,86,2.0,12
1273,455,773,52.33777777777778,53.893514739229026,14.0,12.0,325,2.0,318
1274,455,664,52.33777777777778,54.33469387755102,14.0,15.0,226,2.0,209
1275,455,822,52.33777777777778,53.91673469387755,14.0,11.0,373,2.0,367
1276,455,824,52.33777777777778,53.98639455782313,14.0,-0.0,376,2.0,369
1277,477,68,53.893514739229026,54.96163265306122,18.0,29.0,412,1.0,409
1278,477,69,53.893514739229026,54.984852607709755,18.0,26.0,411,1.0,408
1279,477,128,53.893514739229026,56.37804988662132,18.0,30.0,365,2.0,349
1280,477,258,53.893514739229026,55.193832199546485,18.0,27.0,226,1.0,219
1281,477,208,53.893514739229026,56.0065306122449,18.0,27.0,284,2.0,269
1282,477,466,53.893514739229026,55.54213151927438,18.0,29.0,72,2.0,11
1283,477,410,53.893514739229026,56.37804988662132,18.0,12.0,126,2.0,67
1284,477,646,53.893514739229026,55.51891156462585,18.0,18.0,183,2.0,169
1285,477,645,53.893514739229026,56.37804988662132,18.0,-2.0,199,2.0,168
1286,477,888,53.893514739229026,55.51891156462585,18.0,6.0,417,2.0,411
1287,477,899,53.893514739229026,56.37804988662132,18.0,-4.0,435,2.0,422
1288,467,128,54.31147392290249,56.37804988662132,22.0,30.0,350,2.0,339
1289,467,129,54.31147392290249,57.19074829931973,22.0,32.0,360,3.0,338
1290,467,208,54.31147392290249,56.0065306122449,22.0,27.0,269,2.0,259
1291,467,259,54.31147392290249,57.19074829931973,22.0,29.0,242,3.0,208
1292,467,466,54.31147392290249,55.54213151927438,22.0,29.0,53,1.0,1
1293,467,410,54.31147392290249,56.37804988662132,22.0,12.0,106,2.0,57
1294,467,568,54.31147392290249,57.19074829931973,22.0,8.0,160,3.0,101
1295,467,646,54.31147392290249,55.51891156462585,22.0,18.0,186,1.0,179
1296,467,645,54.31147392290249,56.37804988662132,22.0,-2.0,199,2.0,178
1297,467,662,54.31147392290249,57.167528344671204,22.0,13.0,231,3.0,195
1298,467,888,54.31147392290249,55.51891156462585,22.0,6.0,424,1.0,421
1299,467,899,54.31147392290249,56.37804988662132,22.0,-4.0,441,2.0,432
1300,467,900,54.31147392290249,57.167528344671204,22.0,5.0,450,3.0,433
1301,466,129,55.54213151927438,57.19074829931973,29.0,32.0,344,2.0,337
1302,466,67,55.54213151927438,58.39818594104309,29.0,36.0,418,3.0,399
1303,466,259,55.54213151927438,57.19074829931973,29.0,29.0,219,2.0,207
1304,466,231,55.54213151927438,58.35174603174603,29.0,25.0,264,3.0,235
1305,466,568,55.54213151927438,57.19074829931973,29.0,8.0,124,2.0,102
1306,466,488,55.54213151927438,58.258866213151926,29.0,24.0,119,3.0,22
1307,466,662,55.54213151927438,57.167528344671204,29.0,13.0,208,2.0,196
1308,466,641,55.54213151927438,58.258866213151926,29.0,25.0,211,3.0,175
1309,466,900,55.54213151927438,57.167528344671204,29.0,5.0,440,2.0,434
1310,466,842,55.54213151927438,58.258866213151926,29.0,5.0,394,3.0,376
1311,410,67,56.37804988662132,58.39818594104309,12.0,36.0,354,2.0,343
1312,410,231,56.37804988662132,58.35174603174603,12.0,25.0,198,2.0,179
1313,410,488,56.37804988662132,58.258866213151926,12.0,24.0,112,2.0,78
1314,410,595,56.37804988662132,59.025124716553286,12.0,29.0,217,3.0,185
1315,410,641,56.37804988662132,58.258866213151926,12.0,25.0,245,2.0,231
1316,410,644,56.37804988662132,59.025124716553286,12.0,24.0,260,3.0,234
1317,410,842,56.37804988662132,58.258866213151926,12.0,5.0,440,2.0,432
1318,410,887,56.37804988662132,59.025124716553286,12.0,3.0,490,3.0,477
1319,568,231,57.19074829931973,58.35174603174603,8.0,25.0,341,1.0,337
1320,568,241,57.19074829931973,59.791383219954646,8.0,25.0,346,3.0,327
1321,568,488,57.19074829931973,58.258866213151926,8.0,24.0,92,1.0,80
1322,568,595,57.19074829931973,59.025124716553286,8.0,29.0,83,2.0,27
1323,568,641,57.19074829931973,58.258866213151926,8.0,25.0,86,1.0,73
1324,568,644,57.19074829931973,59.025124716553286,8.0,24.0,110,2.0,76
1325,568,842,57.19074829931973,58.258866213151926,8.0,5.0,278,1.0,274
1326,568,887,57.19074829931973,59.025124716553286,8.0,3.0,329,2.0,319
1327,488,64,58.258866213151926,59.93070294784581,24.0,38.0,430,2.0,424
1328,488,241,58.258866213151926,59.791383219954646,24.0,25.0,256,2.0,247
1329,673,228,1.4164172335600906,3.784852607709751,6.0,25.0,457,2.0,445
1330,673,415,1.4164172335600906,3.784852607709751,6.0,9.0,277,2.0,258
1331,673,632,1.4164172335600906,3.784852607709751,6.0,5.0,110,2.0,41
1332,673,837,1.4164172335600906,2.6006349206349206,6.0,-4.0,172,1.0,164
1333,673,923,1.4164172335600906,3.784852607709751,6.0,0.0,270,2.0,250
1334,805,415,2.2523356009070294,3.784852607709751,-0.0,9.0,396,2.0,390
1335,805,505,2.2523356009070294,4.922630385487529,-0.0,14.0,321,3.0,300
1336,805,632,2.2523356009070294,3.784852607709751,-0.0,5.0,185,2.0,173
1337,805,621,2.2523356009070294,4.899410430839002,-0.0,17.0,216,3.0,184
1338,805,923,2.2523356009070294,3.784852607709751,-0.0,0.0,135,2.0,118
1339,805,820,2.2523356009070294,4.9458503401360545,-0.0,9.0,117,3.0,15
1340,805,839,2.2523356009070294,4.992290249433107,-0.0,0.0,123,3.0,34
1341,632,204,3.784852607709751,6.57124716553288,5.0,32.0,445,3.0,428
1342,632,207,3.784852607709751,5.758548752834467,5.0,29.0,433,2.0,425
1343,632,208,3.784852607709751,6.57124716553288,5.0,33.0,441,3.0,424
1344,632,505,3.784852607709751,4.922630385487529,5.0,14.0,136,1.0,127
1345,632,411,3.784852607709751,5.758548752834467,5.0,14.0,237,2.0,221
1346,632,517,3.784852607709751,6.548027210884354,5.0,9.0,165,3.0,115
1347,632,621,3.784852607709751,4.899410430839002,5.0,17.0,49,1.0,11
1348,632,676,3.784852607709751,5.758548752834467,5.0,8.0,96,2.0,44
1349,632,631,3.784852607709751,6.57124716553288,5.0,7.0,120,3.0,1
1350,632,820,3.784852607709751,4.9458503401360545,5.0,9.0,195,1.0,188
1351,632,839,3.784852607709751,4.992290249433107,5.0,0.0,213,1.0,207
1352,632,902,3.784852607709751,6.57124716553288,5.0,3.0,295,3.0,270
1353,621,204,4.899410430839002,6.57124716553288,17.0,32.0,423,2.0,417
1354,621,208,4.899410430839002,6.57124716553288,17.0,33.0,419,2.0,413
1355,621,517,4.899410430839002,6.548027210884354,17.0,9.0,126,2.0,104
1356,621,467,4.899410430839002,7.75546485260771,17.0,10.0,197,3.0,154
1357,621,631,4.899410430839002,6.57124716553288,17.0,7.0,73,2.0,10
1358,621,902,4.899410430839002,6.57124716553288,17.0,3.0,290,2.0,281
1359,676,204,5.758548752834467,7.9412244897959186,8.0,32.0,481,2.0,472
1360,676,205,5.758548752834467,7.964444444444444,8.0,32.0,480,2.0,471
1361,676,205,5.758548752834467,7.987664399092971,8.0,32.0,481,2.0,471
1362,676,467,5.758548752834467,7.75546485260771,8.0,10.0,226,2.0,209
1363,676,545,5.758548752834467,8.40562358276644,8.0,22.0,174,3.0,131
1364,676,636,5.758548752834467,7.894784580498866,8.0,8.0,100,2.0,40
1365,676,629,5.758548752834467,8.359183673469389,8.0,20.0,121,3.0,47
1366,676,869,5.758548752834467,8.382403628117913,8.0,0.0,224,3.0,193
1367,631,204,6.57124716553288,7.9412244897959186,7.0,32.0,431,1.0,427
1368,631,205,6.57124716553288,7.964444444444444,7.0,32.0,430,1.0,426
1369,631,205,6.57124716553288,7.987664399092971,7.0,32.0,430,1.0,426
1370,631,241,6.57124716553288,9.05578231292517,7.0,28.0,404,2.0,390
1371,631,467,6.57124716553288,7.75546485260771,7.0,10.0,172,1.0,164
1372,631,545,6.57124716553288,8.40562358276644,7.0,22.0,117,2.0,86
1373,631,636,6.57124716553288,7.894784580498866,7.0,8.0,57,1.0,5
1374,631,629,6.57124716553288,8.359183673469389,7.0,20.0,77,2.0,2
1375,631,869,6.57124716553288,8.382403628117913,7.0,0.0,250,2.0,238
1376,636,241,7.894784580498866,9.05578231292517,8.0,28.0,398,1.0,395
1377,636,595,7.894784580498866,9.7059410430839,8.0,21.0,88,2.0,41
1378,636,459,7.894784580498866,10.077460317460318,8.0,12.0,200,2.0,177
1379,636,666,7.894784580498866,9.7059410430839,8.0,20.0,84,2.0,30
1380,636,836,7.894784580498866,9.7059410430839,8.0,1.0,215,2.0,200
1381,629,251,8.359183673469389,10.913378684807256,20.0,22.0,394,3.0,378
1382,629,255,8.359183673469389,11.168798185941043,20.0,24.0,393,3.0,374
1383,629,595,8.359183673469389,9.7059410430839,20.0,21.0,67,1.0,34
1384,629,459,8.359183673469389,10.077460317460318,20.0,12.0,185,2.0,170
1385,629,513,8.359183673469389,11.261678004535147,20.0,6.0,171,3.0,116
1386,629,666,8.359183673469389,9.7059410430839,20.0,20.0,69,1.0,37
1387,629,836,8.359183673469389,9.7059410430839,20.0,1.0,215,1.0,207
1388,666,251,9.7059410430839,10.913378684807256,20.0,22.0,418,1.0,415
1389,666,255,9.7059410430839,11.168798185941043,20.0,24.0,416,1.0,411
1390,666,255,9.7059410430839,12.422675736961452,20.0,34.0,427,3.0,411
1391,666,513,9.7059410430839,11.261678004535147,20.0,6.0,167,2.0,153
1392,666,515,9.7059410430839,12.07437641723356,20.0,17.0,182,2.0,151
1393,666,642,9.7059410430839,12.399455782312925,20.0,8.0,118,3.0,24
1394,666,888,9.7059410430839,12.445895691609978,20.0,-0.0,251,3.0,222
1395,642,255,12.399455782312925,13.583673469387755,8.0,28.0,390,1.0,387
1396,642,232,12.399455782312925,14.373151927437641,8.0,19.0,419,2.0,410
1397,642,458,12.399455782312925,14.210612244897959,8.0,15.0,200,2.0,184
1398,642,643,12.399455782312925,14.419591836734694,8.0,11.0,87,2.0,1
1399,642,681,12.399455782312925,15.209070294784581,8.0,16.0,127,3.0,39
1400,642,888,12.399455782312925,14.373151927437641,8.0,-3.0,260,2.0,246
1401,642,878,12.399455782312925,15.185850340136055,8.0,-2.0,265,3.0,236
1402,643,232,13.212154195011339,14.373151927437641,-1.0,19.0,414,1.0,411
1403,643,260,13.212154195011339,15.789569160997733,-1.0,23.0,399,3.0,383
1404,643,261,13.212154195011339,16.068208616780044,-1.0,21.0,401,3.0,382
1405,643,477,13.212154195011339,15.766349206349206,-1.0,18.0,199,3.0,166
1406,643,681,13.212154195011339,15.209070294784581,-1.0,16.0,94,2.0,38
1407,643,888,13.212154195011339,14.373151927437641,-1.0,-3.0,250,1.0,245
1408,643,878,13.212154195011339,15.185850340136055,-1.0,-2.0,250,2.0,235
1409,643,260,14.419591836734694,15.789569160997733,11.0,23.0,388,1.0,383
1410,643,261,14.419591836734694,16.068208616780044,11.0,21.0,389,2.0,382
1411,643,255,14.419591836734694,17.11310657596372,11.0,20.0,405,3.0,388
1412,643,477,14.419591836734694,15.766349206349206,11.0,18.0,176,1.0,166
1413,643,605,14.419591836734694,16.27718820861678,11.0,19.0,89,2.0,38
1414,643,656,14.419591836734694,16.300408163265306,11.0,19.0,82,2.0,13
1415,643,826,14.419591836734694,16.27718820861678,11.0,-3.0,200,2.0,183
1416,643,821,14.419591836734694,17.11310657596372,11.0,-1.0,212,3.0,178
1417,681,255,15.209070294784581,17.11310657596372,16.0,20.0,434,2.0,426
1418,681,605,15.209070294784581,16.27718820861678,16.0,19.0,89,1.0,76
1419,681,537,15.209070294784581,17.531065759637187,16.0,16.0,175,2.0,144
1420,681,656,15.209070294784581,16.300408163265306,16.0,19.0,53,1.0,25
1421,681,616,15.209070294784581,17.531065759637187,16.0,18.0,119,2.0,65
1422,681,826,15.209070294784581,16.27718820861678,16.0,-3.0,152,1.0,145
1423,681,821,15.209070294784581,17.11310657596372,16.0,-1.0,162,2.0,140
1424,656,208,16.300408163265306,18.692063492063493,19.0,17.0,460,2.0,448
1425,656,205,16.300408163265306,19.086802721088436,19.0,28.0,467,3.0,451
1426,656,537,16.300408163265306,17.531065759637187,19.0,16.0,130,1.0,119
1427,656,498,16.300408163265306,18.320544217687075,19.0,20.0,180,2.0,158
1428,656,616,16.300408163265306,17.531065759637187,19.0,18.0,66,1.0,40
1429,656,658,16.300408163265306,18.320544217687075,19.0,24.0,87,2.0,2
1430,656,896,16.300408163265306,18.320544217687075,19.0,-5.0,255,2.0,240
1431,656,888,16.300408163265306,19.086802721088436,19.0,2.0,261,3.0,232
1432,616,208,17.531065759637187,18.692063492063493,18.0,17.0,411,1.0,408
1433,616,205,17.531065759637187,19.086802721088436,18.0,28.0,416,2.0,411
1434,616,478,17.531065759637187,19.922721088435374,18.0,22.0,172,2.0,138
1435,616,655,17.531065759637187,19.945941043083902,18.0,14.0,111,2.0,39
1436,616,655,17.531065759637187,19.99238095238095,18.0,6.0,113,2.0,39
1437,616,888,17.531065759637187,19.086802721088436,18.0,2.0,280,2.0,272
1438,658,232,18.320544217687075,20.688979591836734,24.0,23.0,438,2.0,426
1439,658,228,18.320544217687075,21.037278911564627,24.0,27.0,446,3.0,430
1440,658,478,18.320544217687075,19.922721088435374,24.0,22.0,193,2.0,180
1441,658,475,18.320544217687075,20.526439909297054,24.0,15.0,206,2.0,183
1442,658,655,18.320544217687075,19.945941043083902,24.0,14.0,70,2.0,3
1443,658,655,18.320544217687075,19.99238095238095,24.0,6.0,72,2.0,3
1444,658,885,18.320544217687075,21.0140589569161,24.0,-1.0,255,3.0,227
1445,655,228,19.945941043083902,21.037278911564627,14.0,27.0,430,1.0,427
1446,655,459,19.945941043083902,21.36235827664399,14.0,23.0,205,1.0,196
1447,655,463,19.945941043083902,22.221496598639455,14.0,9.0,216,2.0,192
1448,655,661,19.945941043083902,21.478458049886623,14.0,24.0,66,2.0,6
1449,655,670,19.945941043083902,22.221496598639455,14.0,6.0,99,2.0,15
1450,655,885,19.945941043083902,21.0140589569161,14.0,-1.0,235,1.0,230
1451,655,899,19.945941043083902,22.221496598639455,14.0,-0.0,263,2.0,244
1452,655,228,19.99238095238095,21.037278911564627,6.0,27.0,429,1.0,427
1453,655,235,19.99238095238095,22.96453514739229,6.0,25.0,439,3.0,420
1454,655,459,19.99238095238095,21.36235827664399,6.0,23.0,205,1.0,196
1455,655,463,19.99238095238095,22.221496598639455,6.0,9.0,215,2.0,192
1456,655,661,19.99238095238095,21.478458049886623,6.0,24.0,64,1.0,6
1457,655,670,19.99238095238095,22.221496598639455,6.0,6.0,97,2.0,15
1458,655,885,19.99238095238095,21.0140589569161,6.0,-1.0,234,1.0,230
1459,655,899,19.99238095238095,22.221496598639455,6.0,-0.0,262,2.0,244
1460,661,202,21.478458049886623,23.034195011337868,24.0,31.0,464,2.0,459
1461,661,235,21.478458049886623,22.96453514739229,24.0,25.0,431,1.0,426
1462,661,234,21.478458049886623,22.98775510204082,24.0,32.0,432,2.0,427
1463,661,472,21.478458049886623,23.057414965986396,24.0,20.0,201,2.0,189
1464,661,615,21.478458049886623,23.08063492063492,24.0,19.0,83,2.0,46
1465,661,886,21.478458049886623,22.98775510204082,24.0,2.0,234,2.0,225
1466,670,204,22.221496598639455,24.961451247165535,6.0,26.0,481,3.0,466
1467,670,204,22.221496598639455,24.98467120181406,6.0,31.0,481,3.0,466
1468,670,205,22.221496598639455,24.961451247165535,6.0,32.0,480,3.0,465
1469,670,205,22.221496598639455,24.98467120181406,6.0,32.0,480,3.0,465
1470,670,499,22.221496598639455,24.961451247165535,6.0,17.0,208,3.0,171
1471,670,681,22.221496598639455,25.007891156462584,6.0,23.0,121,3.0,11
1472,670,889,22.221496598639455,24.961451247165535,6.0,4.0,249,3.0,219
1473,670,889,22.221496598639455,24.98467120181406,6.0,5.0,249,3.0,219
1474,615,204,23.08063492063492,24.961451247165535,19.0,26.0,419,2.0,411
1475,615,204,23.08063492063492,24.98467120181406,19.0,31.0,419,2.0,411
1476,615,205,23.08063492063492,24.961451247165535,19.0,32.0,418,2.0,410
1477,615,205,23.08063492063492,24.98467120181406,19.0,32.0,418,2.0,410
1478,615,499,23.08063492063492,24.961451247165535,19.0,17.0,141,2.0,116
1479,615,508,23.08063492063492,25.379410430839002,19.0,23.0,146,2.0,107
1480,615,670,23.08063492063492,24.961451247165535,19.0,14.0,98,2.0,55
1481,615,681,23.08063492063492,25.007891156462584,19.0,23.0,106,2.0,66
1482,615,889,23.08063492063492,24.961451247165535,19.0,4.0,286,2.0,274
1483,615,889,23.08063492063492,24.98467120181406,19.0,5.0,286,2.0,274
1484,670,232,24.961451247165535,26.865487528344673,14.0,23.0,446,2.0,438
1485,670,245,24.961451247165535,27.353106575963718,14.0,26.0,437,2.0,425
1486,670,524,24.961451247165535,26.122448979591837,14.0,20.0,154,1.0,146
1487,670,479,24.961451247165535,27.678185941043086,14.0,25.0,224,3.0,191
1488,670,625,24.961451247165535,26.888707482993198,14.0,26.0,94,2.0,45
1489,670,621,24.961451247165535,27.678185941043086,14.0,28.0,127,3.0,49
1490,670,900,24.961451247165535,26.122448979591837,14.0,-1.0,235,1.0,230
1491,670,896,24.961451247165535,27.678185941043086,14.0,1.0,254,3.0,226
1492,681,232,25.007891156462584,26.865487528344673,23.0,23.0,456,2.0,449
1493,681,245,25.007891156462584,27.353106575963718,23.0,26.0,448,2.0,436
1494,681,524,25.007891156462584,26.122448979591837,23.0,20.0,164,1.0,157
1495,681,479,25.007891156462584,27.678185941043086,23.0,25.0,232,3.0,202
1496,681,625,25.007891156462584,26.888707482993198,23.0,26.0,98,2.0,56
1497,681,621,25.007891156462584,27.678185941043086,23.0,28.0,130,3.0,60
1498,681,900,25.007891156462584,26.122448979591837,23.0,-1.0,224,1.0,219
1499,681,896,25.007891156462584,27.678185941043086,23.0,1.0,244,3.0,215
1500,625,228,26.888707482993198,28.46766439909297,26.0,26.0,403,2.0,397
1501,625,465,26.888707482993198,28.490884353741496,26.0,23.0,174,2.0,160
1502,625,478,26.888707482993198,29.280362811791385,26.0,23.0,179,2.0,147
1503,625,623,26.888707482993198,28.490884353741496,26.0,27.0,69,2.0,2
1504,625,618,26.888707482993198,29.30358276643991,26.0,18.0,104,2.0,7
1505,625,876,26.888707482993198,28.46766439909297,26.0,-3.0,260,2.0,251
1506,625,887,26.888707482993198,29.164263038548754,26.0,8.0,280,2.0,262
1507,621,303,27.678185941043086,29.976961451247167,28.0,36.0,333,2.0,318
1508,621,304,27.678185941043086,30.00018140589569,28.0,32.0,332,2.0,317
1509,621,478,27.678185941043086,29.280362811791385,28.0,23.0,159,2.0,143
1510,621,618,27.678185941043086,29.30358276643991,28.0,18.0,70,2.0,3
1511,621,887,27.678185941043086,29.164263038548754,28.0,8.0,274,1.0,266
1512,623,189,28.490884353741496,30.97541950113379,27.0,27.0,447,2.0,434
1513,623,189,28.490884353741496,30.998639455782314,27.0,28.0,447,3.0,434
1514,623,303,28.490884353741496,29.976961451247167,27.0,36.0,326,1.0,320
1515,623,304,28.490884353741496,30.00018140589569,27.0,32.0,326,2.0,319
1516,623,248,28.490884353741496,31.02185941043084,27.0,26.0,391,3.0,375
1517,623,466,28.490884353741496,30.859319727891158,27.0,25.0,187,2.0,157
1518,623,616,28.490884353741496,30.882539682539683,27.0,23.0,103,2.0,7
1519,623,887,28.490884353741496,30.859319727891158,27.0,4.0,283,2.0,264
1520,618,189,29.30358276643991,30.97541950113379,18.0,27.0,435,2.0,429
1521,618,189,29.30358276643991,30.998639455782314,18.0,28.0,435,2.0,429
1522,618,248,29.30358276643991,31.02185941043084,18.0,26.0,377,2.0,370
1523,618,466,29.30358276643991,30.859319727891158,18.0,25.0,166,2.0,152
1524,618,469,29.30358276643991,31.579138321995465,18.0,22.0,178,2.0,149
1525,618,616,29.30358276643991,30.882539682539683,18.0,23.0,68,2.0,2
1526,618,627,29.30358276643991,31.579138321995465,18.0,21.0,98,2.0,9
1527,618,887,29.30358276643991,30.859319727891158,18.0,4.0,277,2.0,269
1528,618,821,29.30358276643991,31.579138321995465,18.0,-0.0,225,2.0,203
1529,616,183,30.882539682539683,32.391836734693875,23.0,26.0,438,2.0,433
1530,616,363,30.882539682539683,32.36861678004535,23.0,21.0,261,1.0,253
1531,616,237,30.882539682539683,33.715374149659866,23.0,26.0,398,3.0,379
1532,616,480,30.882539682539683,32.46149659863946,23.0,25.0,152,2.0,136
1533,616,466,30.882539682539683,33.274195011337866,23.0,27.0,182,2.0,150
1534,616,615,30.882539682539683,33.274195011337866,23.0,26.0,103,2.0,1
1535,616,896,30.882539682539683,32.36861678004535,23.0,1.0,287,1.0,280
1536,616,887,30.882539682539683,33.274195011337866,23.0,-1.0,290,2.0,271
1537,627,237,31.579138321995465,33.715374149659866,21.0,26.0,401,2.0,390
1538,627,251,31.579138321995465,34.06367346938776,21.0,20.0,391,2.0,376
1539,627,466,31.579138321995465,33.274195011337866,21.0,27.0,177,2.0,161
1540,627,615,31.579138321995465,33.274195011337866,21.0,26.0,74,2.0,12
1541,627,617,31.579138321995465,34.06367346938776,21.0,25.0,107,2.0,10
1542,627,887,31.579138321995465,33.274195011337866,21.0,-1.0,270,2.0,260
1543,627,896,31.579138321995465,34.06367346938776,21.0,2.0,289,2.0,269
1544,616,237,32.46149659863946,33.715374149659866,24.0,26.0,383,1.0,379
1545,616,251,32.46149659863946,34.06367346938776,24.0,20.0,371,2.0,365
1546,616,476,32.46149659863946,34.87637188208617,24.0,25.0,174,2.0,140
1547,616,617,32.46149659863946,34.06367346938776,24.0,25.0,69,2.0,1
1548,616,896,32.46149659863946,34.06367346938776,24.0,2.0,288,2.0,280
1549,615,137,33.274195011337866,35.66585034013605,26.0,29.0,489,2.0,478
1550,615,188,33.274195011337866,36.19990929705215,26.0,31.0,445,3.0,427
1551,615,234,33.274195011337866,35.54975056689342,26.0,24.0,393,2.0,381
1552,615,476,33.274195011337866,34.87637188208617,26.0,25.0,155,2.0,139
1553,615,479,33.274195011337866,35.66585034013605,26.0,19.0,171,2.0,136
1554,615,623,33.274195011337866,35.68907029478458,26.0,17.0,104,2.0,8
1555,615,889,33.274195011337866,35.5265306122449,26.0,-4.0,291,2.0,274
1556,617,137,34.06367346938776,35.66585034013605,25.0,29.0,485,2.0,480
1557,617,188,34.06367346938776,36.19990929705215,25.0,31.0,439,2.0,429
1558,617,234,34.06367346938776,35.54975056689342,25.0,24.0,388,1.0,383
1559,617,237,34.06367346938776,36.94294784580499,25.0,28.0,400,3.0,380
1560,617,479,34.06367346938776,35.66585034013605,25.0,19.0,154,2.0,138
1561,617,470,34.06367346938776,36.45532879818594,25.0,22.0,179,2.0,147
1562,617,623,34.06367346938776,35.68907029478458,25.0,17.0,70,2.0,6
1563,617,624,34.06367346938776,36.47854875283447,25.0,24.0,104,2.0,7
1564,617,889,34.06367346938776,35.5265306122449,25.0,-4.0,279,1.0,272
1565,617,888,34.06367346938776,36.45532879818594,25.0,2.0,290,2.0,271
1566,623,125,35.68907029478458,37.29124716553288,17.0,28.0,503,2.0,498
1567,623,237,35.68907029478458,36.94294784580499,17.0,28.0,390,1.0,386
1568,623,246,35.68907029478458,37.268027210884355,17.0,26.0,383,2.0,377
1569,623,233,35.68907029478458,38.42902494331066,17.0,31.0,407,3.0,390
1570,623,613,35.68907029478458,37.268027210884355,17.0,24.0,69,2.0,10
1571,623,613,35.68907029478458,38.080725623582765,17.0,22.0,103,2.0,10
1572,623,620,35.68907029478458,37.268027210884355,17.0,24.0,68,2.0,3
1573,623,899,35.68907029478458,37.268027210884355,17.0,5.0,284,2.0,276
1574,623,905,35.68907029478458,38.40580498866213,17.0,-1.0,305,3.0,282
1575,624,137,36.47854875283447,38.800544217687076,24.0,30.0,497,2.0,487
1576,624,233,36.47854875283447,38.42902494331066,24.0,31.0,400,2.0,391
1577,624,613,36.47854875283447,38.080725623582765,24.0,22.0,70,2.0,11
1578,624,625,36.47854875283447,38.87020408163266,24.0,23.0,103,2.0,1
1579,624,905,36.47854875283447,38.40580498866213,24.0,-1.0,293,2.0,281
1580,620,137,37.268027210884355,38.800544217687076,24.0,30.0,487,2.0,483
1581,620,144,37.268027210884355,39.72934240362812,24.0,29.0,488,2.0,476
1582,620,138,37.268027210884355,40.170521541950116,24.0,31.0,498,3.0,482
1583,620,233,37.268027210884355,38.42902494331066,24.0,31.0,390,1.0,387
1584,620,243,37.268027210884355,39.72934240362812,24.0,22.0,392,2.0,377
1585,620,613,37.268027210884355,39.70612244897959,24.0,20.0,105,2.0,7
1586,620,625,37.268027210884355,38.87020408163266,24.0,23.0,69,2.0,5
1587,620,625,37.268027210884355,39.68290249433107,24.0,18.0,104,2.0,5
1588,620,905,37.268027210884355,38.40580498866213,24.0,-1.0,289,1.0,285
1589,620,888,37.268027210884355,39.68290249433107,24.0,-1.0,287,2.0,268
1590,625,138,38.87020408163266,40.170521541950116,23.0,31.0,490,1.0,487
1591,625,207,38.87020408163266,40.49560090702948,23.0,27.0,424,2.0,418
1592,625,467,38.87020408163266,40.49560090702948,23.0,26.0,173,2.0,158
1593,625,480,38.87020408163266,41.28507936507937,23.0,22.0,178,2.0,145
1594,625,624,38.87020408163266,40.49560090702948,23.0,23.0,70,2.0,1
1595,625,624,38.87020408163266,41.28507936507937,23.0,29.0,104,2.0,1
1596,625,901,38.87020408163266,40.47238095238095,23.0,2.0,284,2.0,276
1597,625,170,39.68290249433107,42.42285714285715,18.0,31.0,470,3.0,455
1598,625,228,39.68290249433107,41.95845804988662,18.0,25.0,409,2.0,397
1599,625,265,39.68290249433107,42.4692970521542,18.0,27.0,379,3.0,360
1600,625,480,39.68290249433107,41.28507936507937,18.0,22.0,161,2.0,145
1601,625,471,39.68290249433107,42.074557823129254,18.0,22.0,185,2.0,154
1602,625,624,39.68290249433107,41.28507936507937,18.0,29.0,69,2.0,1
1603,625,615,39.68290249433107,42.074557823129254,18.0,27.0,103,2.0,10
1604,625,891,39.68290249433107,42.4692970521542,18.0,0.0,292,3.0,266
1605,624,170,40.49560090702948,42.42285714285715,23.0,31.0,462,2.0,454
1606,624,228,40.49560090702948,41.95845804988662,23.0,25.0,401,1.0,396
1607,624,265,40.49560090702948,42.4692970521542,23.0,27.0,369,2.0,359
1608,624,245,40.49560090702948,43.281995464852606,23.0,28.0,398,3.0,379
1609,624,471,40.49560090702948,42.074557823129254,23.0,22.0,167,2.0,153
1610,624,615,40.49560090702948,42.074557823129254,23.0,27.0,69,2.0,9
1611,624,891,40.49560090702948,42.4692970521542,23.0,0.0,280,2.0,267
1612,624,170,41.28507936507937,42.42285714285715,29.0,31.0,457,1.0,454
1613,624,155,41.28507936507937,43.81605442176871,29.0,31.0,481,3.0,469
1614,624,265,41.28507936507937,42.4692970521542,29.0,27.0,363,1.0,359
1615,624,245,41.28507936507937,43.281995464852606,29.0,28.0,389,2.0,379
1616,624,479,41.28507936507937,43.653514739229024,29.0,20.0,177,2.0,145
1617,624,616,41.28507936507937,43.653514739229024,29.0,24.0,102,2.0,8
1618,624,891,41.28507936507937,42.4692970521542,29.0,0.0,272,1.0,267
1619,624,900,41.28507936507937,43.653514739229024,29.0,2.0,294,2.0,276
1620,615,155,42.074557823129254,43.81605442176871,27.0,31.0,466,2.0,460
1621,615,245,42.074557823129254,43.281995464852606,27.0,28.0,374,1.0,370
1622,615,247,42.074557823129254,44.76807256235828,27.0,23.0,386,3.0,368
1623,615,479,42.074557823129254,43.653514739229024,27.0,20.0,152,2.0,136
1624,615,466,42.074557823129254,44.373333333333335,27.0,23.0,179,2.0,149
1625,615,616,42.074557823129254,43.653514739229024,27.0,24.0,68,2.0,1
1626,615,616,42.074557823129254,44.46621315192744,27.0,25.0,103,2.0,1
1627,615,900,42.074557823129254,43.653514739229024,27.0,2.0,293,2.0,285
1628,615,888,42.074557823129254,44.44299319727891,27.0,-0.0,291,2.0,273
1629,616,148,43.653514739229024,45.743310657596375,24.0,28.0,477,2.0,468
1630,616,247,43.653514739229024,44.76807256235828,24.0,23.0,372,1.0,369
1631,616,259,43.653514739229024,45.743310657596375,24.0,25.0,368,2.0,357
1632,616,217,43.653514739229024,46.068390022675736,24.0,20.0,412,2.0,399
1633,616,464,43.653514739229024,45.255691609977326,24.0,22.0,167,2.0,152
1634,616,615,43.653514739229024,46.09160997732426,24.0,19.0,105,2.0,1
1635,616,887,43.653514739229024,45.743310657596375,24.0,-4.0,286,2.0,271
1636,616,148,44.46621315192744,45.743310657596375,25.0,28.0,471,1.0,468
1637,616,175,44.46621315192744,46.85786848072563,25.0,32.0,453,2.0,441
1638,616,259,44.46621315192744,45.743310657596375,25.0,25.0,361,1.0,357
1639,616,217,44.46621315192744,46.068390022675736,25.0,20.0,405,2.0,399
1640,616,469,44.46621315192744,46.85786848072563,25.0,21.0,179,2.0,147
1641,616,615,44.46621315192744,46.09160997732426,25.0,19.0,70,2.0,1
1642,616,887,44.46621315192744,45.743310657596375,25.0,-4.0,277,1.0,271
1643,616,820,44.46621315192744,46.834648526077096,25.0,-3.0,228,2.0,204
1644,616,175,45.27891156462585,46.85786848072563,19.0,32.0,446,2.0,441
1645,616,197,45.27891156462585,47.484807256235825,19.0,38.0,430,2.0,419
1646,616,395,45.27891156462585,47.50802721088436,19.0,16.0,241,2.0,221
1647,616,469,45.27891156462585,46.85786848072563,19.0,21.0,162,2.0,147
1648,616,478,45.27891156462585,47.64734693877551,19.0,19.0,172,2.0,138
1649,616,820,45.27891156462585,46.834648526077096,19.0,-3.0,215,2.0,204
1650,616,886,45.27891156462585,47.484807256235825,19.0,-2.0,286,2.0,270
1651,615,197,46.09160997732426,47.484807256235825,19.0,38.0,422,1.0,418
1652,615,395,46.09160997732426,47.50802721088436,19.0,16.0,228,1.0,220
1653,615,242,46.09160997732426,48.78512471655329,19.0,23.0,391,3.0,373
1654,615,478,46.09160997732426,47.64734693877551,19.0,19.0,153,2.0,137
1655,615,476,46.09160997732426,48.46004535147392,19.0,13.0,172,2.0,139
1656,615,616,46.09160997732426,47.64734693877551,19.0,21.0,67,2.0,1
1657,615,626,46.09160997732426,48.46004535147392,19.0,16.0,103,2.0,11
1658,615,886,46.09160997732426,47.484807256235825,19.0,-2.0,278,1.0,271
1659,615,900,46.09160997732426,48.87800453514739,19.0,-5.0,309,3.0,285
1660,616,129,47.64734693877551,50.062222222222225,21.0,35.0,498,2.0,487
1661,616,242,47.64734693877551,48.78512471655329,21.0,23.0,377,1.0,374
1662,616,280,47.64734693877551,49.20308390022676,21.0,27.0,343,2.0,336
1663,616,258,47.64734693877551,50.062222222222225,21.0,18.0,373,2.0,358
1664,616,491,47.64734693877551,49.179863945578234,21.0,23.0,141,2.0,125
1665,616,623,47.64734693877551,49.24952380952381,21.0,12.0,69,2.0,7
1666,616,624,47.64734693877551,50.0390022675737,21.0,18.0,103,2.0,8
1667,616,900,47.64734693877551,48.87800453514739,21.0,-5.0,289,1.0,284
1668,616,876,47.64734693877551,49.179863945578234,21.0,2.0,268,2.0,260
1669,616,900,47.64734693877551,50.062222222222225,21.0,-2.0,302,2.0,284
1670,626,129,48.46004535147392,50.062222222222225,16.0,35.0,502,2.0,497
1671,626,258,48.46004535147392,50.062222222222225,16.0,18.0,374,2.0,368
1672,626,479,48.46004535147392,50.758820861678004,16.0,23.0,177,2.0,147
1673,626,444,48.46004535147392,51.153560090702946,16.0,17.0,216,3.0,182
1674,626,624,48.46004535147392,50.0390022675737,16.0,18.0,68,2.0,2
1675,626,900,48.46004535147392,50.062222222222225,16.0,-2.0,283,2.0,274
1676,623,258,49.24952380952381,51.61795918367347,12.0,22.0,379,2.0,365
1677,623,479,49.24952380952381,50.758820861678004,12.0,23.0,158,2.0,144
1678,623,444,49.24952380952381,51.153560090702946,12.0,17.0,197,2.0,179
1679,623,624,49.24952380952381,51.61795918367347,12.0,20.0,102,2.0,1
1680,623,888,49.24952380952381,51.61795918367347,12.0,-2.0,284,2.0,265
1681,624,258,50.0390022675737,51.61795918367347,18.0,22.0,372,2.0,366
1682,624,372,50.0390022675737,52.33777777777778,18.0,22.0,271,2.0,252
1683,624,444,50.0390022675737,51.153560090702946,18.0,17.0,186,1.0,180
1684,624,455,50.0390022675737,52.33777777777778,18.0,14.0,196,2.0,169
1685,624,661,50.0390022675737,52.314557823129256,18.0,12.0,105,2.0,37
1686,624,888,50.0390022675737,51.61795918367347,18.0,-2.0,273,2.0,264
1687,624,237,51.61795918367347,53.91673469387755,20.0,36.0,399,2.0,387
1688,624,253,51.61795918367347,53.98639455782313,20.0,30.0,385,2.0,371
1689,624,477,51.61795918367347,53.893514739229026,20.0,18.0,177,2.0,147
1690,624,467,51.61795918367347,54.31147392290249,20.0,22.0,195,3.0,157
1691,624,773,51.61795918367347,53.893514739229026,20.0,12.0,178,2.0,149
1692,624,664,51.61795918367347,54.33469387755102,20.0,15.0,124,3.0,40
1693,624,822,51.61795918367347,53.91673469387755,20.0,11.0,221,2.0,198
1694,624,824,51.61795918367347,53.98639455782313,20.0,-0.0,225,2.0,200
1695,661,237,52.314557823129256,53.91673469387755,12.0,36.0,430,2.0,424
1696,661,253,52.314557823129256,53.98639455782313,12.0,30.0,414,2.0,408
1697,661,258,52.314557823129256,55.193832199546485,12.0,27.0,422,3.0,403
1698,661,477,52.314557823129256,53.893514739229026,12.0,18.0,196,2.0,184
1699,661,467,52.314557823129256,54.31147392290249,12.0,22.0,212,2.0,194
1700,661,773,52.314557823129256,53.893514739229026,12.0,12.0,131,2.0,112
1701,661,664,52.314557823129256,54.33469387755102,12.0,15.0,87,2.0,3
1702,661,822,52.314557823129256,53.91673469387755,12.0,11.0,175,2.0,161
1703,661,824,52.314557823129256,53.98639455782313,12.0,-0.0,178,2.0,163
1704,773,466,53.893514739229026,55.54213151927438,12.0,29.0,315,2.0,307
1705,773,410,53.893514739229026,56.37804988662132,12.0,12.0,378,2.0,363
1706,773,646,53.893514739229026,55.51891156462585,12.0,18.0,145,2.0,127
1707,773,645,53.893514739229026,56.37804988662132,12.0,-2.0,167,2.0,128
1708,773,888,53.893514739229026,55.51891156462585,12.0,6.0,135,2.0,115
1709,773,899,53.893514739229026,56.37804988662132,12.0,-4.0,165,2.0,126
1710,664,208,54.33469387755102,56.0065306122449,15.0,27.0,462,2.0,456
1711,664,259,54.33469387755102,57.19074829931973,15.0,29.0,423,3.0,405
1712,664,466,54.33469387755102,55.54213151927438,15.0,29.0,205,1.0,198
1713,664,410,54.33469387755102,56.37804988662132,15.0,12.0,269,2.0,254
1714,664,568,54.33469387755102,57.19074829931973,15.0,8.0,156,3.0,96
1715,664,646,54.33469387755102,55.51891156462585,15.0,18.0,54,1.0,18
1716,664,645,54.33469387755102,56.37804988662132,15.0,-2.0,90,2.0,19
1717,664,662,54.33469387755102,57.167528344671204,15.0,13.0,122,3.0,2
1718,664,888,54.33469387755102,55.51891156462585,15.0,6.0,230,1.0,224
1719,664,899,54.33469387755102,56.37804988662132,15.0,-4.0,251,2.0,235
1720,664,900,54.33469387755102,57.167528344671204,15.0,5.0,266,3.0,236
1721,646,259,55.51891156462585,57.19074829931973,18.0,29.0,394,2.0,387
1722,646,231,55.51891156462585,58.35174603174603,18.0,25.0,433,3.0,415
1723,646,568,55.51891156462585,57.19074829931973,18.0,8.0,106,2.0,78
1724,646,488,55.51891156462585,58.258866213151926,18.0,24.0,197,3.0,158
1725,646,662,55.51891156462585,57.167528344671204,18.0,13.0,73,2.0,16
1726,646,641,55.51891156462585,58.258866213151926,18.0,25.0,118,3.0,5
1727,646,900,55.51891156462585,57.167528344671204,18.0,5.0,264,2.0,254
1728,646,842,55.51891156462585,58.258866213151926,18.0,5.0,229,3.0,196
1729,645,231,56.37804988662132,58.35174603174603,-2.0,25.0,423,2.0,414
1730,645,488,56.37804988662132,58.258866213151926,-2.0,24.0,177,2.0,157
1731,645,595,56.37804988662132,59.025124716553286,-2.0,29.0,124,3.0,50
1732,645,641,56.37804988662132,58.258866213151926,-2.0,25.0,81,2.0,4
1733,645,644,56.37804988662132,59.025124716553286,-2.0,24.0,114,3.0,1
1734,645,842,56.37804988662132,58.258866213151926,-2.0,5.0,213,2.0,197
1735,645,887,56.37804988662132,59.025124716553286,-2.0,3.0,268,3.0,242
1736,662,231,57.167528344671204,58.35174603174603,13.0,25.0,434,1.0,431
1737,662,241,57.167528344671204,59.791383219954646,13.0,25.0,436,3.0,421
1738,662,488,57.167528344671204,58.258866213151926,13.0,24.0,180,1.0,174
1739,662,595,57.167528344671204,59.025124716553286,13.0,29.0,104,2.0,67
1740,662,641,57.167528344671204,58.258866213151926,13.0,25.0,51,1.0,21
1741,662,644,57.167528344671204,59.025124716553286,13.0,24.0,82,2.0,18
1742,662,842,57.167528344671204,58.258866213151926,13.0,5.0,186,1.0,180
1743,662,887,57.167528344671204,59.025124716553286,13.0,3.0,239,2.0,225
1744,641,241,58.258866213151926,59.791383219954646,25.0,25.0,405,2.0,400
1745,837,415,2.6006349206349206,3.784852607709751,-4.0,9.0,425,1.0,422
1746,837,505,2.6006349206349206,4.922630385487529,-4.0,14.0,347,2.0,332
1747,837,632,2.6006349206349206,3.784852607709751,-4.0,5.0,211,1.0,205
1748,837,621,2.6006349206349206,4.899410430839002,-4.0,17.0,238,2.0,216
1749,837,923,2.6006349206349206,3.784852607709751,-4.0,0.0,100,1.0,86
1750,837,820,2.6006349206349206,4.9458503401360545,-4.0,9.0,102,2.0,17
1751,837,839,2.6006349206349206,4.992290249433107,-4.0,0.0,103,2.0,2
1752,923,505,3.784852607709751,4.922630385487529,0.0,14.0,421,1.0,418
1753,923,517,3.784852607709751,6.548027210884354,0.0,9.0,423,3.0,406
1754,923,621,3.784852607709751,4.899410430839002,0.0,17.0,306,1.0,302
1755,923,676,3.784852607709751,5.758548752834467,0.0,8.0,261,2.0,247
1756,923,631,3.784852607709751,6.57124716553288,0.0,7.0,316,3.0,292
1757,923,820,3.784852607709751,4.9458503401360545,0.0,9.0,114,1.0,103
1758,923,839,3.784852607709751,4.992290249433107,0.0,0.0,99,1.0,84
1759,923,902,3.784852607709751,6.57124716553288,0.0,3.0,122,3.0,21
1760,820,517,4.9458503401360545,6.548027210884354,9.0,9.0,311,2.0,303
1761,820,467,4.9458503401360545,7.75546485260771,9.0,10.0,373,3.0,353
1762,820,631,4.9458503401360545,6.57124716553288,9.0,7.0,202,2.0,189
1763,820,636,4.9458503401360545,7.894784580498866,9.0,8.0,224,3.0,184
1764,820,902,4.9458503401360545,6.57124716553288,9.0,3.0,108,2.0,82
1765,839,517,4.992290249433107,6.548027210884354,0.0,9.0,329,2.0,322
1766,839,467,4.992290249433107,7.75546485260771,0.0,10.0,391,3.0,372
1767,839,631,4.992290249433107,6.57124716553288,0.0,7.0,219,2.0,208
1768,839,636,4.992290249433107,7.894784580498866,0.0,8.0,238,3.0,203
1769,839,902,4.992290249433107,6.57124716553288,0.0,3.0,93,2.0,63
1770,902,467,6.57124716553288,7.75546485260771,3.0,10.0,438,1.0,435
1771,902,545,6.57124716553288,8.40562358276644,3.0,22.0,366,2.0,357
1772,902,636,6.57124716553288,7.894784580498866,3.0,8.0,272,1.0,266
1773,902,629,6.57124716553288,8.359183673469389,3.0,20.0,284,2.0,273
1774,902,869,6.57124716553288,8.382403628117913,3.0,0.0,85,2.0,33
1775,869,595,8.382403628117913,9.7059410430839,0.0,21.0,280,1.0,274
1776,869,459,8.382403628117913,10.077460317460318,0.0,12.0,416,2.0,410
1777,869,513,8.382403628117913,11.261678004535147,0.0,6.0,377,3.0,356
1778,869,666,8.382403628117913,9.7059410430839,0.0,20.0,211,1.0,203
1779,869,836,8.382403628117913,9.7059410430839,0.0,1.0,66,1.0,33
1780,836,513,9.7059410430839,11.261678004535147,1.0,6.0,330,2.0,323
1781,836,515,9.7059410430839,12.07437641723356,1.0,17.0,337,2.0,321
1782,836,642,9.7059410430839,12.399455782312925,1.0,8.0,226,3.0,194
1783,836,888,9.7059410430839,12.445895691609978,1.0,-0.0,129,3.0,52
1784,888,458,12.445895691609978,14.210612244897959,-0.0,15.0,437,2.0,430
1785,888,643,12.445895691609978,14.419591836734694,-0.0,11.0,259,2.0,245
1786,888,681,12.445895691609978,15.209070294784581,-0.0,16.0,239,3.0,207
1787,888,878,12.445895691609978,15.185850340136055,-0.0,-2.0,118,3.0,10
1788,888,477,14.373151927437641,15.766349206349206,-3.0,18.0,415,1.0,411
1789,888,605,14.373151927437641,16.27718820861678,-3.0,19.0,295,2.0,283
1790,888,656,14.373151927437641,16.300408163265306,-3.0,19.0,246,2.0,232
1791,888,826,14.373151927437641,16.27718820861678,-3.0,-3.0,103,2.0,62
1792,888,821,14.373151927437641,17.11310657596372,-3.0,-1.0,136,3.0,67
1793,878,605,15.185850340136055,16.27718820861678,-2.0,19.0,277,1.0,273
1794,878,537,15.185850340136055,17.531065759637187,-2.0,16.0,356,2.0,341
1795,878,656,15.185850340136055,16.300408163265306,-2.0,19.0,227,1.0,222
1796,878,616,15.185850340136055,17.531065759637187,-2.0,18.0,281,2.0,262
1797,878,826,15.185850340136055,16.27718820861678,-2.0,-3.0,70,1.0,52
1798,878,821,15.185850340136055,17.11310657596372,-2.0,-1.0,101,2.0,57
1799,826,537,16.27718820861678,17.531065759637187,-3.0,16.0,294,1.0,289
1800,826,498,16.27718820861678,18.320544217687075,-3.0,20.0,340,2.0,328
1801,826,616,16.27718820861678,17.531065759637187,-3.0,18.0,217,1.0,210
1802,826,658,16.27718820861678,18.320544217687075,-3.0,24.0,190,2.0,168
1803,826,896,16.27718820861678,18.320544217687075,-3.0,-5.0,112,2.0,70
1804,826,888,16.27718820861678,19.086802721088436,-3.0,2.0,136,3.0,62
1805,821,498,17.11310657596372,18.320544217687075,-1.0,20.0,327,1.0,323
1806,821,478,17.11310657596372,19.922721088435374,-1.0,22.0,364,3.0,343
1807,821,658,17.11310657596372,18.320544217687075,-1.0,24.0,171,1.0,163
1808,821,655,17.11310657596372,19.945941043083902,-1.0,14.0,206,3.0,166
1809,821,655,17.11310657596372,19.99238095238095,-1.0,6.0,207,3.0,166
1810,821,896,17.11310657596372,18.320544217687075,-1.0,-5.0,91,1.0,75
1811,821,888,17.11310657596372,19.086802721088436,-1.0,2.0,108,2.0,67
1812,896,478,18.320544217687075,19.922721088435374,-5.0,22.0,424,2.0,418
1813,896,475,18.320544217687075,20.526439909297054,-5.0,15.0,432,2.0,421
1814,896,655,18.320544217687075,19.945941043083902,-5.0,14.0,251,2.0,241
1815,896,655,18.320544217687075,19.99238095238095,-5.0,6.0,252,2.0,241
1816,896,885,18.320544217687075,21.0140589569161,-5.0,-1.0,117,3.0,11
1817,888,475,19.086802721088436,20.526439909297054,2.0,15.0,418,1.0,413
1818,888,459,19.086802721088436,21.36235827664399,2.0,23.0,440,2.0,429
1819,888,661,19.086802721088436,21.478458049886623,2.0,24.0,249,2.0,227
1820,888,885,19.086802721088436,21.0140589569161,2.0,-1.0,83,2.0,3
1821,885,463,21.0140589569161,22.221496598639455,-1.0,9.0,425,1.0,422
1822,885,472,21.0140589569161,23.057414965986396,-1.0,20.0,422,2.0,413
1823,885,670,21.0140589569161,22.221496598639455,-1.0,6.0,221,1.0,215
1824,885,615,21.0140589569161,23.08063492063492,-1.0,19.0,284,2.0,270
1825,885,899,21.0140589569161,22.221496598639455,-1.0,-0.0,54,1.0,14
1826,885,886,21.0140589569161,22.98775510204082,-1.0,2.0,85,2.0,1
1827,899,499,22.221496598639455,24.961451247165535,-0.0,17.0,417,3.0,400
1828,899,670,22.221496598639455,24.961451247165535,-0.0,14.0,258,3.0,229
1829,899,681,22.221496598639455,25.007891156462584,-0.0,23.0,249,3.0,218
1830,899,889,22.221496598639455,24.961451247165535,-0.0,4.0,118,3.0,10
1831,899,889,22.221496598639455,24.98467120181406,-0.0,5.0,119,3.0,10
1832,886,499,22.98775510204082,24.961451247165535,2.0,17.0,396,2.0,387
1833,886,508,22.98775510204082,25.379410430839002,2.0,23.0,392,2.0,378
1834,886,670,22.98775510204082,24.961451247165535,2.0,14.0,232,2.0,216
1835,886,681,22.98775510204082,25.007891156462584,2.0,23.0,223,2.0,205
1836,886,889,22.98775510204082,24.961451247165535,2.0,4.0,85,2.0,3
1837,886,889,22.98775510204082,24.98467120181406,2.0,5.0,86,2.0,3
1838,889,524,24.961451247165535,26.122448979591837,4.0,20.0,368,1.0,365
1839,889,479,24.961451247165535,27.678185941043086,4.0,25.0,426,3.0,410
1840,889,625,24.961451247165535,26.888707482993198,4.0,26.0,277,2.0,264
1841,889,621,24.961451247165535,27.678185941043086,4.0,28.0,292,3.0,268
1842,889,900,24.961451247165535,26.122448979591837,4.0,-1.0,51,1.0,11
1843,889,896,24.961451247165535,27.678185941043086,4.0,1.0,117,3.0,7
1844,889,524,24.98467120181406,26.122448979591837,5.0,20.0,368,1.0,365
1845,889,479,24.98467120181406,27.678185941043086,5.0,25.0,426,3.0,410
1846,889,625,24.98467120181406,26.888707482993198,5.0,26.0,276,2.0,264
1847,889,621,24.98467120181406,27.678185941043086,5.0,28.0,292,3.0,268
1848,889,900,24.98467120181406,26.122448979591837,5.0,-1.0,50,1.0,11
1849,889,896,24.98467120181406,27.678185941043086,5.0,1.0,116,3.0,7
1850,900,479,26.122448979591837,27.678185941043086,-1.0,25.0,426,2.0,421
1851,900,465,26.122448979591837,28.490884353741496,-1.0,23.0,447,2.0,435
1852,900,621,26.122448979591837,27.678185941043086,-1.0,28.0,287,2.0,279
1853,900,623,26.122448979591837,28.490884353741496,-1.0,27.0,295,2.0,277
1854,900,896,26.122448979591837,27.678185941043086,-1.0,1.0,67,2.0,4
1855,900,876,26.122448979591837,28.46766439909297,-1.0,-3.0,104,2.0,24
1856,896,478,27.678185941043086,29.280362811791385,1.0,23.0,424,2.0,418
1857,896,618,27.678185941043086,29.30358276643991,1.0,18.0,287,2.0,278
1858,896,887,27.678185941043086,29.164263038548754,1.0,8.0,65,1.0,9
1859,876,466,28.46766439909297,30.859319727891158,-3.0,25.0,423,2.0,410
1860,876,616,28.46766439909297,30.882539682539683,-3.0,23.0,280,2.0,260
1861,876,887,28.46766439909297,30.859319727891158,-3.0,4.0,104,2.0,11
1862,887,466,29.164263038548754,30.859319727891158,8.0,25.0,427,2.0,421
1863,887,469,29.164263038548754,31.579138321995465,8.0,22.0,431,2.0,418
1864,887,616,29.164263038548754,30.882539682539683,8.0,23.0,281,2.0,271
1865,887,627,29.164263038548754,31.579138321995465,8.0,21.0,280,2.0,260
1866,887,821,29.164263038548754,31.579138321995465,8.0,-0.0,123,2.0,66
1867,887,480,30.859319727891158,32.46149659863946,4.0,25.0,413,2.0,407
1868,887,466,30.859319727891158,33.274195011337866,4.0,27.0,434,2.0,421
1869,887,616,30.859319727891158,32.46149659863946,4.0,24.0,280,2.0,271
1870,887,615,30.859319727891158,33.274195011337866,4.0,26.0,291,2.0,272
1871,887,896,30.859319727891158,32.36861678004535,4.0,1.0,66,2.0,9
1872,821,466,31.579138321995465,33.274195011337866,-0.0,27.0,362,2.0,355
1873,821,615,31.579138321995465,33.274195011337866,-0.0,26.0,219,2.0,206
1874,821,617,31.579138321995465,34.06367346938776,-0.0,25.0,230,2.0,204
1875,821,887,31.579138321995465,33.274195011337866,-0.0,-1.0,98,2.0,66
1876,821,896,31.579138321995465,34.06367346938776,-0.0,2.0,131,2.0,75
1877,896,476,32.36861678004535,34.87637188208617,1.0,25.0,434,3.0,420
1878,896,617,32.36861678004535,34.06367346938776,1.0,25.0,288,2.0,279
1879,887,476,33.274195011337866,34.87637188208617,-1.0,25.0,417,2.0,411
1880,887,479,33.274195011337866,35.66585034013605,-1.0,19.0,421,2.0,408
1881,887,623,33.274195011337866,35.68907029478458,-1.0,17.0,284,2.0,264
1882,887,889,33.274195011337866,35.5265306122449,-1.0,-4.0,97,2.0,2
1883,896,479,34.06367346938776,35.66585034013605,2.0,19.0,423,2.0,417
1884,896,470,34.06367346938776,36.45532879818594,2.0,22.0,438,2.0,426
1885,896,623,34.06367346938776,35.68907029478458,2.0,17.0,282,2.0,273
1886,896,624,34.06367346938776,36.47854875283447,2.0,24.0,291,2.0,272
1887,896,889,34.06367346938776,35.5265306122449,2.0,-4.0,63,1.0,7
1888,896,888,34.06367346938776,36.45532879818594,2.0,2.0,103,2.0,8
1889,889,613,35.5265306122449,37.268027210884355,-4.0,24.0,286,2.0,276
1890,889,613,35.5265306122449,38.080725623582765,-4.0,22.0,297,3.0,276
1891,889,620,35.5265306122449,37.268027210884355,-4.0,24.0,279,2.0,269
1892,889,899,35.5265306122449,37.268027210884355,-4.0,5.0,76,2.0,10
1893,889,905,35.5265306122449,38.40580498866213,-4.0,-1.0,125,3.0,16
1894,888,613,36.45532879818594,38.080725623582765,2.0,22.0,284,2.0,275
1895,888,625,36.45532879818594,38.87020408163266,2.0,23.0,283,2.0,263
1896,888,905,36.45532879818594,38.40580498866213,2.0,-1.0,86,2.0,17
1897,899,613,37.268027210884355,39.70612244897959,5.0,20.0,305,2.0,286
1898,899,625,37.268027210884355,38.87020408163266,5.0,23.0,283,2.0,274
1899,899,625,37.268027210884355,39.68290249433107,5.0,18.0,293,2.0,274
1900,899,905,37.268027210884355,38.40580498866213,5.0,-1.0,49,1.0,6
1901,899,888,37.268027210884355,39.68290249433107,5.0,-1.0,105,2.0,11
1902,905,613,38.40580498866213,39.70612244897959,-1.0,20.0,297,1.0,292
1903,905,467,38.40580498866213,40.49560090702948,-1.0,26.0,447,2.0,438
1904,905,480,38.40580498866213,41.28507936507937,-1.0,22.0,443,3.0,425
1905,905,625,38.40580498866213,39.68290249433107,-1.0,18.0,285,1.0,280
1906,905,624,38.40580498866213,40.49560090702948,-1.0,23.0,295,2.0,281
1907,905,624,38.40580498866213,41.28507936507937,-1.0,29.0,307,3.0,281
1908,905,888,38.40580498866213,39.68290249433107,-1.0,-1.0,58,1.0,17
1909,905,901,38.40580498866213,40.47238095238095,-1.0,2.0,89,2.0,4
1910,888,480,39.68290249433107,41.28507936507937,-1.0,22.0,414,2.0,408
1911,888,471,39.68290249433107,42.074557823129254,-1.0,22.0,430,2.0,417
1912,888,624,39.68290249433107,41.28507936507937,-1.0,29.0,273,2.0,264
1913,888,615,39.68290249433107,42.074557823129254,-1.0,27.0,292,2.0,273
1914,888,891,39.68290249433107,42.4692970521542,-1.0,0.0,120,3.0,3
1915,901,471,40.47238095238095,42.074557823129254,2.0,22.0,436,2.0,430
1916,901,615,40.47238095238095,42.074557823129254,2.0,27.0,294,2.0,286
1917,901,891,40.47238095238095,42.4692970521542,2.0,0.0,87,2.0,10
1918,891,479,42.4692970521542,43.653514739229024,0.0,20.0,415,1.0,412
1919,891,466,42.4692970521542,44.373333333333335,0.0,23.0,433,2.0,425
1920,891,464,42.4692970521542,45.255691609977326,0.0,22.0,444,3.0,427
1921,891,616,42.4692970521542,43.653514739229024,0.0,24.0,280,1.0,275
1922,891,616,42.4692970521542,44.46621315192744,0.0,25.0,288,2.0,275
1923,891,616,42.4692970521542,45.27891156462585,0.0,19.0,300,3.0,275
1924,891,900,42.4692970521542,43.653514739229024,0.0,2.0,52,1.0,9
1925,891,888,42.4692970521542,44.44299319727891,0.0,-0.0,85,2.0,3
1926,900,464,43.653514739229024,45.255691609977326,2.0,22.0,441,2.0,436
1927,900,616,43.653514739229024,45.27891156462585,2.0,19.0,292,2.0,284
1928,900,615,43.653514739229024,46.09160997732426,2.0,19.0,304,2.0,285
1929,900,887,43.653514739229024,45.743310657596375,2.0,-4.0,91,2.0,13
1930,888,469,44.44299319727891,46.85786848072563,-0.0,21.0,432,2.0,419
1931,888,615,44.44299319727891,46.09160997732426,-0.0,19.0,282,2.0,273
1932,888,887,44.44299319727891,45.743310657596375,-0.0,-4.0,56,1.0,1
1933,888,820,44.44299319727891,46.834648526077096,-0.0,-3.0,123,2.0,68
1934,887,395,45.743310657596375,47.50802721088436,-4.0,16.0,498,2.0,492
1935,887,469,45.743310657596375,46.85786848072563,-4.0,21.0,421,1.0,418
1936,887,478,45.743310657596375,47.64734693877551,-4.0,19.0,417,2.0,409
1937,887,476,45.743310657596375,48.46004535147392,-4.0,13.0,427,3.0,411
1938,887,616,45.743310657596375,47.64734693877551,-4.0,21.0,283,2.0,271
1939,887,626,45.743310657596375,48.46004535147392,-4.0,16.0,286,3.0,261
1940,887,820,45.743310657596375,46.834648526077096,-4.0,-3.0,82,1.0,67
1941,887,886,45.743310657596375,47.484807256235825,-4.0,-2.0,75,2.0,1
1942,820,476,46.834648526077096,48.46004535147392,-3.0,13.0,351,2.0,344
1943,820,491,46.834648526077096,49.179863945578234,-3.0,23.0,344,2.0,329
1944,820,626,46.834648526077096,48.46004535147392,-3.0,16.0,206,2.0,194
1945,820,623,46.834648526077096,49.24952380952381,-3.0,12.0,223,2.0,197
1946,820,900,46.834648526077096,48.87800453514739,-3.0,-5.0,119,2.0,80
1947,820,876,46.834648526077096,49.179863945578234,-3.0,2.0,115,2.0,56
1948,886,491,47.484807256235825,49.179863945578234,-2.0,23.0,402,2.0,395
1949,886,623,47.484807256235825,49.24952380952381,-2.0,12.0,274,2.0,263
1950,886,624,47.484807256235825,50.0390022675737,-2.0,18.0,284,3.0,262
1951,886,900,47.484807256235825,48.87800453514739,-2.0,-5.0,62,1.0,14
1952,886,876,47.484807256235825,49.179863945578234,-2.0,2.0,74,2.0,10
1953,886,900,47.484807256235825,50.062222222222225,-2.0,-2.0,112,3.0,14
1954,900,479,48.87800453514739,50.758820861678004,-5.0,23.0,429,2.0,421
1955,900,444,48.87800453514739,51.153560090702946,-5.0,17.0,466,2.0,456
1956,900,624,48.87800453514739,50.0390022675737,-5.0,18.0,280,1.0,276
1957,900,624,48.87800453514739,51.61795918367347,-5.0,20.0,300,3.0,276
1958,900,888,48.87800453514739,51.61795918367347,-5.0,-2.0,119,3.0,12
1959,876,479,49.179863945578234,50.758820861678004,2.0,23.0,403,2.0,397
1960,876,444,49.179863945578234,51.153560090702946,2.0,17.0,440,2.0,432
1961,876,624,49.179863945578234,51.61795918367347,2.0,20.0,273,2.0,252
1962,876,888,49.179863945578234,51.61795918367347,2.0,-2.0,106,2.0,12
1963,900,444,50.062222222222225,51.153560090702946,-2.0,17.0,458,1.0,456
1964,900,455,50.062222222222225,52.33777777777778,-2.0,14.0,456,2.0,445
1965,900,624,50.062222222222225,51.61795918367347,-2.0,20.0,284,2.0,276
1966,900,661,50.062222222222225,52.314557823129256,-2.0,12.0,258,2.0,239
1967,900,888,50.062222222222225,51.61795918367347,-2.0,-2.0,68,2.0,12
1968,888,477,51.61795918367347,53.893514739229026,-2.0,18.0,423,2.0,411
1969,888,467,51.61795918367347,54.31147392290249,-2.0,22.0,437,3.0,421
1970,888,773,51.61795918367347,53.893514739229026,-2.0,12.0,151,2.0,115
1971,888,664,51.61795918367347,54.33469387755102,-2.0,15.0,253,3.0,224
1972,888,822,51.61795918367347,53.91673469387755,-2.0,11.0,119,2.0,66
1973,888,824,51.61795918367347,53.98639455782313,-2.0,-0.0,120,2.0,64
1974,822,466,53.91673469387755,55.54213151927438,11.0,29.0,363,2.0,356
1975,822,410,53.91673469387755,56.37804988662132,11.0,12.0,425,2.0,412
1976,822,646,53.91673469387755,55.51891156462585,11.0,18.0,189,2.0,176
1977,822,645,53.91673469387755,56.37804988662132,11.0,-2.0,206,2.0,177
1978,822,888,53.91673469387755,55.51891156462585,11.0,6.0,95,2.0,66
1979,822,899,53.91673469387755,56.37804988662132,11.0,-4.0,131,2.0,77
1980,824,466,53.98639455782313,55.54213151927438,-0.0,29.0,364,2.0,358
1981,824,410,53.98639455782313,56.37804988662132,-0.0,12.0,427,2.0,414
1982,824,646,53.98639455782313,55.51891156462585,-0.0,18.0,190,2.0,178
1983,824,645,53.98639455782313,56.37804988662132,-0.0,-2.0,207,2.0,179
1984,824,888,53.98639455782313,55.51891156462585,-0.0,6.0,92,2.0,64
1985,824,899,53.98639455782313,56.37804988662132,-0.0,-4.0,127,2.0,75
1986,888,568,55.51891156462585,57.19074829931973,6.0,8.0,328,2.0,320
1987,888,488,55.51891156462585,58.258866213151926,6.0,24.0,417,3.0,400
1988,888,662,55.51891156462585,57.167528344671204,6.0,13.0,237,2.0,226
1989,888,641,55.51891156462585,58.258866213151926,6.0,25.0,274,3.0,247
1990,888,900,55.51891156462585,57.167528344671204,6.0,5.0,72,2.0,12
1991,888,842,55.51891156462585,58.258866213151926,6.0,5.0,127,3.0,46
1992,899,488,56.37804988662132,58.258866213151926,-4.0,24.0,419,2.0,411
1993,899,595,56.37804988662132,59.025124716553286,-4.0,29.0,325,3.0,304
1994,899,641,56.37804988662132,58.258866213151926,-4.0,25.0,270,2.0,258
1995,899,644,56.37804988662132,59.025124716553286,-4.0,24.0,279,3.0,255
1996,899,842,56.37804988662132,58.258866213151926,-4.0,5.0,99,2.0,57
1997,899,887,56.37804988662132,59.025124716553286,-4.0,3.0,115,3.0,12
1998,900,488,57.167528344671204,58.258866213151926,5.0,24.0,415,1.0,412
1999,900,595,57.167528344671204,59.025124716553286,5.0,29.0,315,2.0,305
2000,900,641,57.167528344671204,58.258866213151926,5.0,25.0,263,1.0,259
2001,900,644,57.167528344671204,59.025124716553286,5.0,24.0,268,2.0,256
2002,900,842,57.167528344671204,58.258866213151926,5.0,5.0,75,1.0,58
2003,900,887,57.167528344671204,59.025124716553286,5.0,3.0,81,2.0,13
