,f0,f1,t0,t1,dB0,dB1,dist,utime,ufreq
0,78,70,1.9736961451247166,3.0418140589569163,24.0,30.0,47,1.0,8
1,78,35,1.9736961451247166,4.806530612244898,24.0,29.0,129,3.0,43
2,78,209,1.9736961451247166,3.0650340136054424,24.0,19.0,139,1.0,131
3,78,209,1.9736961451247166,4.2260317460317465,24.0,5.0,163,2.0,131
4,78,419,1.9736961451247166,3.0418140589569163,24.0,6.0,344,1.0,341
5,46,35,2.8792743764172335,4.806530612244898,27.0,29.0,84,2.0,11
6,46,35,2.8792743764172335,5.015510204081632,27.0,26.0,93,2.0,11
7,46,209,2.8792743764172335,4.2260317460317465,27.0,5.0,173,1.0,163
8,46,209,2.8792743764172335,5.804988662131519,27.0,9.0,206,3.0,163
9,70,35,3.0418140589569163,4.806530612244898,30.0,29.0,84,2.0,35
10,70,35,3.0418140589569163,5.015510204081632,30.0,26.0,92,2.0,35
11,70,209,3.0418140589569163,4.2260317460317465,30.0,5.0,148,1.0,139
12,70,209,3.0418140589569163,5.804988662131519,30.0,9.0,183,3.0,139
13,35,78,4.806530612244898,6.965986394557823,29.0,25.0,102,2.0,43
14,35,22,4.806530612244898,7.337505668934241,29.0,25.0,110,3.0,13
15,35,209,4.806530612244898,7.75546485260771,29.0,7.0,215,3.0,174
16,35,78,5.015510204081632,6.965986394557823,26.0,25.0,94,2.0,43
17,35,22,5.015510204081632,7.337505668934241,26.0,25.0,101,2.0,13
18,35,209,5.015510204081632,7.75546485260771,26.0,7.0,210,3.0,174
19,78,35,6.965986394557823,8.312743764172335,25.0,24.0,72,1.0,43
20,78,52,6.965986394557823,9.7059410430839,25.0,30.0,121,3.0,26
21,78,209,6.965986394557823,8.103764172335602,25.0,11.0,140,1.0,131
22,22,52,7.337505668934241,9.7059410430839,25.0,30.0,106,2.0,30
23,22,234,7.337505668934241,10.216780045351474,25.0,12.0,246,3.0,212
24,35,52,8.312743764172335,9.7059410430839,24.0,30.0,62,1.0,17
25,35,78,8.312743764172335,10.634739229024943,24.0,25.0,109,2.0,43
26,35,154,8.312743764172335,11.215238095238096,24.0,35.0,173,3.0,119
27,35,234,8.312743764172335,10.216780045351474,24.0,12.0,215,2.0,199
28,35,232,8.312743764172335,11.23845804988662,24.0,38.0,234,3.0,197
29,52,154,9.7059410430839,11.215238095238096,30.0,35.0,121,2.0,102
30,52,139,9.7059410430839,12.051156462585034,30.0,32.0,133,2.0,87
31,52,232,9.7059410430839,11.23845804988662,30.0,38.0,192,2.0,180
32,52,254,9.7059410430839,12.004716553287983,30.0,31.0,225,2.0,202
33,52,507,9.7059410430839,11.331337868480725,30.0,21.0,460,2.0,455
34,52,485,9.7059410430839,12.07437641723356,30.0,24.0,445,2.0,433
35,78,139,10.634739229024943,12.051156462585034,25.0,32.0,86,1.0,61
36,78,159,10.634739229024943,13.467573696145125,25.0,27.0,146,3.0,81
37,78,254,10.634739229024943,12.004716553287983,25.0,31.0,186,1.0,176
38,78,231,10.634739229024943,13.467573696145125,25.0,31.0,196,3.0,153
39,78,485,10.634739229024943,12.07437641723356,25.0,24.0,412,1.0,407
40,78,443,10.634739229024943,13.467573696145125,25.0,21.0,385,3.0,365
41,154,159,11.215238095238096,13.467573696145125,35.0,27.0,97,2.0,5
42,154,231,11.215238095238096,13.467573696145125,35.0,31.0,124,2.0,77
43,154,231,11.215238095238096,14.02485260770975,35.0,31.0,143,3.0,77
44,154,443,11.215238095238096,13.467573696145125,35.0,21.0,305,2.0,289
45,154,617,11.215238095238096,12.654875283446712,35.0,18.0,467,1.0,463
46,154,630,11.215238095238096,13.467573696145125,35.0,14.0,486,2.0,476
47,139,159,12.051156462585034,13.467573696145125,32.0,27.0,64,1.0,20
48,139,63,12.051156462585034,14.257052154195012,32.0,30.0,122,2.0,76
49,139,63,12.051156462585034,15.000090702947846,32.0,29.0,148,3.0,76
50,139,231,12.051156462585034,13.467573696145125,32.0,31.0,110,1.0,92
51,139,231,12.051156462585034,14.02485260770975,32.0,31.0,125,2.0,92
52,139,443,12.051156462585034,13.467573696145125,32.0,21.0,310,1.0,304
53,139,420,12.051156462585034,14.907210884353741,32.0,23.0,307,3.0,281
54,139,630,12.051156462585034,13.467573696145125,32.0,14.0,495,1.0,491
55,139,616,12.051156462585034,14.512471655328799,32.0,18.0,489,2.0,477
56,159,63,13.467573696145125,15.000090702947846,27.0,29.0,116,2.0,96
57,159,160,13.467573696145125,16.416507936507937,27.0,27.0,127,3.0,1
58,159,236,13.467573696145125,15.789569160997733,27.0,30.0,126,2.0,77
59,159,231,13.467573696145125,16.416507936507937,27.0,31.0,146,3.0,72
60,159,420,13.467573696145125,14.907210884353741,27.0,23.0,268,1.0,261
61,159,410,13.467573696145125,15.928888888888888,27.0,24.0,272,2.0,251
62,159,489,13.467573696145125,15.998548752834468,27.0,20.0,348,3.0,330
63,159,616,13.467573696145125,14.512471655328799,27.0,18.0,459,1.0,457
64,159,618,13.467573696145125,15.418049886621315,27.0,17.0,467,2.0,459
65,159,626,13.467573696145125,16.416507936507937,27.0,12.0,484,3.0,467
66,63,160,14.257052154195012,16.416507936507937,30.0,27.0,134,2.0,97
67,63,236,14.257052154195012,15.789569160997733,30.0,30.0,185,2.0,173
68,63,231,14.257052154195012,16.416507936507937,30.0,31.0,192,2.0,168
69,63,247,14.257052154195012,17.22920634920635,30.0,31.0,224,3.0,184
70,63,410,14.257052154195012,15.928888888888888,30.0,24.0,354,2.0,347
71,63,489,14.257052154195012,15.998548752834468,30.0,20.0,433,2.0,426
72,63,160,15.000090702947846,16.416507936507937,29.0,27.0,115,1.0,97
73,63,70,15.000090702947846,17.57750566893424,29.0,37.0,111,3.0,7
74,63,231,15.000090702947846,16.416507936507937,29.0,31.0,179,1.0,168
75,63,247,15.000090702947846,17.22920634920635,29.0,31.0,208,2.0,184
76,63,431,15.000090702947846,17.76326530612245,29.0,22.0,387,3.0,368
77,160,70,16.416507936507937,17.57750566893424,27.0,37.0,103,1.0,90
78,160,71,16.416507936507937,18.29732426303855,27.0,34.0,120,2.0,89
79,160,236,16.416507936507937,18.715283446712018,27.0,35.0,125,2.0,76
80,160,231,16.416507936507937,19.365442176870747,27.0,31.0,145,3.0,71
81,160,431,16.416507936507937,17.76326530612245,27.0,22.0,277,1.0,271
82,160,476,16.416507936507937,18.901043083900227,27.0,24.0,334,2.0,316
83,160,631,16.416507936507937,17.740045351473924,27.0,12.0,474,1.0,471
84,160,616,16.416507936507937,18.83138321995465,27.0,13.0,468,2.0,456
85,160,630,16.416507936507937,19.342222222222222,27.0,13.0,487,3.0,470
86,70,67,17.57750566893424,19.760181405895693,37.0,33.0,94,2.0,3
87,70,194,17.57750566893424,20.154920634920636,37.0,33.0,166,3.0,124
88,70,236,17.57750566893424,18.715283446712018,37.0,35.0,173,1.0,166
89,70,231,17.57750566893424,19.365442176870747,37.0,31.0,178,2.0,161
90,70,260,17.57750566893424,20.17814058956916,37.0,32.0,221,3.0,190
91,70,476,17.57750566893424,18.901043083900227,37.0,24.0,410,1.0,406
92,70,423,17.57750566893424,19.89950113378685,37.0,21.0,367,2.0,353
93,70,446,17.57750566893424,20.24780045351474,37.0,22.0,393,3.0,376
94,71,67,18.29732426303855,19.760181405895693,34.0,33.0,63,1.0,4
95,71,194,18.29732426303855,20.154920634920636,34.0,33.0,147,2.0,123
96,71,231,18.29732426303855,19.365442176870747,34.0,31.0,166,1.0,160
97,71,260,18.29732426303855,20.17814058956916,34.0,32.0,206,2.0,189
98,71,251,18.29732426303855,21.106938775510205,34.0,32.0,217,3.0,180
99,71,423,18.29732426303855,19.89950113378685,34.0,21.0,359,2.0,352
100,71,446,18.29732426303855,20.24780045351474,34.0,22.0,384,2.0,375
101,67,199,19.760181405895693,21.61777777777778,33.0,23.0,154,2.0,132
102,67,251,19.760181405895693,21.106938775510205,33.0,32.0,193,1.0,184
103,67,231,19.760181405895693,22.291156462585036,33.0,31.0,197,3.0,164
104,67,499,19.760181405895693,21.43201814058957,33.0,22.0,438,2.0,432
105,194,199,20.154920634920636,21.61777777777778,33.0,23.0,63,1.0,5
106,194,67,20.154920634920636,22.709115646258503,33.0,28.0,168,3.0,127
107,194,231,20.154920634920636,22.291156462585036,33.0,31.0,99,2.0,37
108,194,499,20.154920634920636,21.43201814058957,33.0,22.0,310,1.0,305
109,194,443,20.154920634920636,22.84843537414966,33.0,21.0,275,3.0,249
110,194,465,20.154920634920636,22.98775510204082,33.0,20.0,297,3.0,271
111,194,617,20.154920634920636,21.292698412698414,33.0,18.0,426,1.0,423
112,194,615,20.154920634920636,22.871655328798187,33.0,14.0,437,3.0,421
113,199,67,21.61777777777778,22.709115646258503,23.0,28.0,140,1.0,132
114,199,158,21.61777777777778,23.45215419501134,23.0,30.0,89,2.0,41
115,199,71,21.61777777777778,24.543492063492064,23.0,24.0,180,3.0,128
116,199,231,21.61777777777778,23.777233560090703,23.0,31.0,98,2.0,32
117,199,245,21.61777777777778,24.171972789115646,23.0,30.0,119,3.0,46
118,199,443,21.61777777777778,22.84843537414966,23.0,21.0,250,1.0,244
119,199,465,21.61777777777778,22.98775510204082,23.0,20.0,272,1.0,266
120,199,615,21.61777777777778,22.871655328798187,23.0,14.0,419,1.0,416
121,199,629,21.61777777777778,23.75401360544218,23.0,13.0,440,2.0,430
122,67,71,22.709115646258503,24.543492063492064,28.0,24.0,79,2.0,4
123,67,160,22.709115646258503,25.240090702947846,28.0,26.0,143,3.0,93
124,67,231,22.709115646258503,23.777233560090703,28.0,31.0,170,1.0,164
125,67,245,22.709115646258503,24.171972789115646,28.0,30.0,189,1.0,178
126,67,231,22.709115646258503,25.240090702947846,28.0,33.0,197,3.0,164
127,67,412,22.709115646258503,24.961451247165535,28.0,18.0,358,2.0,345
128,67,443,22.709115646258503,25.240090702947846,28.0,20.0,391,3.0,376
129,158,71,23.45215419501134,24.543492063492064,30.0,24.0,99,1.0,87
130,158,160,23.45215419501134,25.240090702947846,30.0,26.0,77,2.0,2
131,158,66,23.45215419501134,26.076009070294784,30.0,29.0,146,3.0,92
132,158,231,23.45215419501134,25.240090702947846,30.0,33.0,106,2.0,73
133,158,412,23.45215419501134,24.961451247165535,30.0,18.0,262,2.0,254
134,158,443,23.45215419501134,25.240090702947846,30.0,20.0,295,2.0,285
135,158,625,23.45215419501134,24.86857142857143,30.0,10.0,471,1.0,467
136,158,630,23.45215419501134,25.240090702947846,30.0,13.0,478,2.0,472
137,71,66,24.543492063492064,26.076009070294784,24.0,29.0,66,2.0,5
138,71,231,24.543492063492064,26.70294784580499,24.0,30.0,185,2.0,160
139,71,467,24.543492063492064,26.563628117913833,24.0,24.0,405,2.0,396
140,160,158,25.240090702947846,27.608526077097505,26.0,28.0,102,2.0,2
141,160,231,25.240090702947846,26.70294784580499,26.0,30.0,95,1.0,71
142,160,278,25.240090702947846,27.933605442176873,26.0,23.0,165,3.0,118
143,160,232,25.240090702947846,28.18902494331066,26.0,31.0,146,3.0,72
144,160,467,25.240090702947846,26.563628117913833,26.0,24.0,312,1.0,307
145,160,458,25.240090702947846,27.58530612244898,26.0,18.0,315,2.0,298
146,160,423,25.240090702947846,28.18902494331066,26.0,21.0,292,3.0,263
147,160,617,25.240090702947846,26.540408163265308,26.0,15.0,460,1.0,457
148,160,625,25.240090702947846,27.16734693877551,26.0,10.0,472,2.0,465
149,160,626,25.240090702947846,28.18902494331066,26.0,12.0,483,3.0,466
150,66,158,26.076009070294784,27.608526077097505,29.0,28.0,113,2.0,92
151,66,78,26.076009070294784,28.95528344671202,29.0,26.0,125,3.0,12
152,66,278,26.076009070294784,27.933605442176873,29.0,23.0,227,2.0,212
153,66,232,26.076009070294784,28.18902494331066,29.0,31.0,189,2.0,166
154,66,458,26.076009070294784,27.58530612244898,29.0,18.0,397,2.0,392
155,66,423,26.076009070294784,28.18902494331066,29.0,21.0,368,2.0,357
156,158,78,27.608526077097505,28.95528344671202,28.0,26.0,99,1.0,80
157,158,78,27.608526077097505,29.744761904761905,28.0,31.0,122,2.0,80
158,158,231,27.608526077097505,29.651882086167802,28.0,30.0,114,2.0,73
159,158,454,27.608526077097505,29.489342403628118,28.0,24.0,307,2.0,296
160,158,465,27.608526077097505,30.534240362811794,28.0,24.0,332,3.0,307
161,158,616,27.608526077097505,29.512562358276643,28.0,15.0,465,2.0,458
162,158,631,27.608526077097505,30.511020408163265,28.0,18.0,489,3.0,473
163,78,175,28.95528344671202,30.859319727891158,26.0,27.0,127,2.0,97
164,78,160,28.95528344671202,31.67201814058957,26.0,25.0,143,3.0,82
165,78,266,28.95528344671202,30.78965986394558,26.0,30.0,204,2.0,188
166,78,250,28.95528344671202,31.532698412698412,26.0,31.0,205,3.0,172
167,78,465,28.95528344671202,30.534240362811794,26.0,24.0,393,2.0,387
168,78,455,28.95528344671202,31.02185941043084,26.0,26.0,387,2.0,377
169,78,175,29.744761904761905,30.859319727891158,31.0,27.0,108,1.0,97
170,78,160,29.744761904761905,31.67201814058957,31.0,25.0,117,2.0,82
171,78,70,29.744761904761905,32.27573696145125,31.0,30.0,109,3.0,8
172,78,266,29.744761904761905,30.78965986394558,31.0,30.0,193,1.0,188
173,78,250,29.744761904761905,31.532698412698412,31.0,31.0,188,2.0,172
174,78,232,29.744761904761905,32.60081632653061,31.0,32.0,197,3.0,154
175,78,455,29.744761904761905,31.02185941043084,31.0,26.0,381,1.0,377
176,78,463,29.744761904761905,32.48471655328798,31.0,24.0,403,3.0,385
177,175,70,30.859319727891158,32.27573696145125,27.0,30.0,121,1.0,105
178,175,193,30.859319727891158,33.3902947845805,27.0,25.0,110,3.0,18
179,175,232,30.859319727891158,32.60081632653061,27.0,32.0,94,2.0,57
180,175,220,30.859319727891158,33.50639455782313,27.0,26.0,123,3.0,45
181,175,463,30.859319727891158,32.48471655328798,27.0,24.0,296,2.0,288
182,175,618,30.859319727891158,32.46149659863946,27.0,16.0,448,2.0,443
183,160,193,31.67201814058957,33.3902947845805,25.0,25.0,81,2.0,33
184,160,70,31.67201814058957,34.13333333333333,25.0,30.0,139,2.0,90
185,160,220,31.67201814058957,33.50639455782313,25.0,26.0,99,2.0,60
186,160,231,31.67201814058957,34.06367346938776,25.0,30.0,125,2.0,71
187,160,482,31.67201814058957,33.97079365079365,25.0,22.0,337,2.0,322
188,160,482,31.67201814058957,33.99401360544218,25.0,22.0,337,2.0,322
189,160,615,31.67201814058957,33.97079365079365,25.0,11.0,466,2.0,455
190,160,627,31.67201814058957,33.99401360544218,25.0,11.0,478,2.0,467
191,70,193,32.27573696145125,33.3902947845805,30.0,25.0,132,1.0,123
192,70,220,32.27573696145125,33.50639455782313,30.0,26.0,159,1.0,150
193,70,231,32.27573696145125,34.06367346938776,30.0,30.0,178,2.0,161
194,70,482,32.27573696145125,33.97079365079365,30.0,22.0,418,2.0,412
195,70,482,32.27573696145125,33.99401360544218,30.0,22.0,419,2.0,412
196,193,67,33.3902947845805,35.54975056689342,25.0,26.0,157,2.0,126
197,193,316,33.3902947845805,35.68907029478458,25.0,27.0,158,2.0,123
198,193,451,33.3902947845805,35.68907029478458,25.0,25.0,276,2.0,258
199,193,626,33.3902947845805,35.68907029478458,25.0,17.0,444,2.0,433
200,70,67,34.13333333333333,35.54975056689342,30.0,26.0,61,1.0,3
201,70,191,34.13333333333333,36.385668934240364,30.0,31.0,155,2.0,121
202,70,316,34.13333333333333,35.68907029478458,30.0,27.0,255,2.0,246
203,70,234,34.13333333333333,36.89650793650794,30.0,28.0,203,3.0,164
204,70,231,34.13333333333333,37.01260770975057,30.0,32.0,203,3.0,161
205,70,451,34.13333333333333,35.68907029478458,30.0,25.0,387,2.0,381
206,70,508,34.13333333333333,36.57142857142857,30.0,25.0,450,2.0,438
207,70,423,34.13333333333333,37.01260770975057,30.0,20.0,374,3.0,353
208,67,71,35.54975056689342,37.430566893424036,26.0,30.0,81,2.0,4
209,67,174,35.54975056689342,38.47546485260771,26.0,27.0,165,3.0,107
210,67,234,35.54975056689342,36.89650793650794,26.0,28.0,177,1.0,167
211,67,231,35.54975056689342,37.01260770975057,26.0,32.0,176,1.0,164
212,67,231,35.54975056689342,38.47546485260771,26.0,31.0,207,3.0,164
213,67,508,35.54975056689342,36.57142857142857,26.0,25.0,443,1.0,441
214,67,423,35.54975056689342,37.01260770975057,26.0,20.0,362,1.0,356
215,191,71,36.385668934240364,37.430566893424036,31.0,30.0,128,1.0,120
216,191,174,36.385668934240364,38.47546485260771,31.0,27.0,92,2.0,17
217,191,231,36.385668934240364,38.47546485260771,31.0,31.0,98,2.0,40
218,191,481,36.385668934240364,38.59156462585034,31.0,21.0,305,2.0,290
219,191,617,36.385668934240364,38.59156462585034,31.0,14.0,436,2.0,426
220,191,625,36.385668934240364,39.19528344671202,31.0,14.0,451,3.0,434
221,71,174,37.430566893424036,38.47546485260771,30.0,27.0,112,1.0,103
222,71,160,37.430566893424036,39.938321995464854,30.0,26.0,140,3.0,89
223,71,231,37.430566893424036,38.47546485260771,30.0,31.0,166,1.0,160
224,71,231,37.430566893424036,39.938321995464854,30.0,30.0,193,3.0,160
225,71,481,37.430566893424036,38.59156462585034,30.0,21.0,413,1.0,410
226,71,503,37.430566893424036,39.938321995464854,30.0,19.0,445,3.0,432
227,71,503,37.430566893424036,40.24018140589569,30.0,22.0,449,3.0,432
228,174,160,38.47546485260771,39.938321995464854,27.0,26.0,65,1.0,14
229,174,138,38.47546485260771,40.4259410430839,27.0,23.0,91,2.0,36
230,174,231,38.47546485260771,39.938321995464854,27.0,30.0,85,1.0,57
231,174,232,38.47546485260771,40.49560090702948,27.0,26.0,105,2.0,58
232,174,254,38.47546485260771,41.40117913832199,27.0,29.0,149,3.0,80
233,174,503,38.47546485260771,39.938321995464854,27.0,19.0,335,1.0,329
234,174,503,38.47546485260771,40.24018140589569,27.0,22.0,338,2.0,329
235,174,424,38.47546485260771,41.40117913832199,27.0,19.0,280,3.0,250
236,174,630,38.47546485260771,40.24018140589569,27.0,16.0,462,2.0,456
237,174,631,38.47546485260771,41.40117913832199,27.0,12.0,474,3.0,457
238,160,66,39.938321995464854,41.84235827664399,26.0,29.0,125,2.0,94
239,160,254,39.938321995464854,41.40117913832199,26.0,29.0,113,1.0,94
240,160,254,39.938321995464854,42.887256235827664,26.0,29.0,158,3.0,94
241,160,424,39.938321995464854,41.40117913832199,26.0,19.0,271,1.0,264
242,160,419,39.938321995464854,42.887256235827664,26.0,18.0,288,3.0,259
243,160,631,39.938321995464854,41.40117913832199,26.0,12.0,475,1.0,471
244,160,627,39.938321995464854,42.887256235827664,26.0,12.0,484,3.0,467
245,138,66,40.4259410430839,41.84235827664399,23.0,29.0,94,1.0,72
246,138,160,40.4259410430839,42.887256235827664,23.0,28.0,108,2.0,22
247,138,254,40.4259410430839,42.887256235827664,23.0,29.0,157,2.0,116
248,138,326,40.4259410430839,43.18911564625851,23.0,29.0,222,3.0,188
249,138,419,40.4259410430839,42.887256235827664,23.0,18.0,300,2.0,281
250,138,472,40.4259410430839,43.21233560090703,23.0,25.0,355,3.0,334
251,138,627,40.4259410430839,42.887256235827664,23.0,12.0,500,2.0,489
252,138,630,40.4259410430839,43.21233560090703,23.0,17.0,506,3.0,492
253,66,160,41.84235827664399,42.887256235827664,29.0,28.0,104,1.0,94
254,66,160,41.84235827664399,43.444535147392294,29.0,25.0,117,2.0,94
255,66,160,41.84235827664399,44.373333333333335,29.0,25.0,144,3.0,94
256,66,254,41.84235827664399,42.887256235827664,29.0,29.0,193,1.0,188
257,66,326,41.84235827664399,43.18911564625851,29.0,29.0,266,1.0,260
258,66,231,41.84235827664399,44.35011337868481,29.0,29.0,197,3.0,165
259,66,419,41.84235827664399,42.887256235827664,29.0,18.0,356,1.0,353
260,66,472,41.84235827664399,43.21233560090703,29.0,25.0,410,1.0,406
261,66,487,41.84235827664399,44.0714739229025,29.0,25.0,432,2.0,421
262,160,231,42.887256235827664,44.35011337868481,28.0,29.0,95,1.0,71
263,160,232,42.887256235827664,45.836190476190474,28.0,30.0,146,3.0,72
264,160,487,42.887256235827664,44.0714739229025,28.0,25.0,331,1.0,327
265,160,489,42.887256235827664,45.069931972789114,28.0,26.0,342,2.0,329
266,160,629,42.887256235827664,44.0714739229025,28.0,16.0,472,1.0,469
267,160,625,42.887256235827664,45.069931972789114,28.0,17.0,474,2.0,465
268,160,232,43.444535147392294,45.836190476190474,25.0,30.0,126,2.0,72
269,160,231,43.444535147392294,46.37024943310658,25.0,26.0,145,3.0,71
270,160,489,43.444535147392294,45.069931972789114,25.0,26.0,336,2.0,329
271,160,423,43.444535147392294,46.37024943310658,25.0,20.0,292,3.0,263
272,160,625,43.444535147392294,45.069931972789114,25.0,17.0,470,2.0,465
273,160,628,43.444535147392294,46.37024943310658,25.0,11.0,485,3.0,468
274,160,232,44.373333333333335,45.836190476190474,25.0,30.0,96,1.0,72
275,160,231,44.373333333333335,46.37024943310658,25.0,26.0,112,2.0,71
276,160,252,44.373333333333335,47.02040816326531,25.0,31.0,146,3.0,92
277,160,423,44.373333333333335,46.37024943310658,25.0,20.0,277,2.0,263
278,160,628,44.373333333333335,46.37024943310658,25.0,11.0,476,2.0,468
279,160,79,45.836190476190474,47.69378684807256,26.0,29.0,114,2.0,81
280,160,192,45.836190476190474,48.15818594104309,26.0,28.0,105,2.0,32
281,160,252,45.836190476190474,47.02040816326531,26.0,31.0,105,1.0,92
282,160,236,45.836190476190474,48.15818594104309,26.0,30.0,126,2.0,76
283,160,596,45.836190476190474,47.4615873015873,26.0,21.0,442,2.0,436
284,160,440,45.836190476190474,48.36716553287982,26.0,22.0,300,3.0,280
285,160,632,45.836190476190474,47.438367346938776,26.0,17.0,477,2.0,472
286,160,625,45.836190476190474,48.39038548752835,26.0,12.0,478,3.0,465
287,160,79,46.393469387755104,47.69378684807256,22.0,29.0,98,1.0,81
288,160,192,46.393469387755104,48.15818594104309,22.0,28.0,82,2.0,32
289,160,236,46.393469387755104,48.15818594104309,22.0,30.0,107,2.0,76
290,160,234,46.393469387755104,49.04054421768708,22.0,32.0,136,3.0,74
291,160,596,46.393469387755104,47.4615873015873,22.0,21.0,438,1.0,436
292,160,440,46.393469387755104,48.36716553287982,22.0,22.0,293,2.0,280
293,160,632,46.393469387755104,47.438367346938776,22.0,17.0,474,1.0,472
294,160,625,46.393469387755104,48.39038548752835,22.0,12.0,473,2.0,465
295,79,139,47.69378684807256,49.96934240362812,29.0,32.0,115,2.0,60
296,79,69,47.69378684807256,49.99256235827664,29.0,31.0,100,2.0,10
297,79,234,47.69378684807256,49.04054421768708,29.0,32.0,165,1.0,155
298,79,240,47.69378684807256,50.29442176870749,29.0,29.0,196,3.0,161
299,79,458,47.69378684807256,49.96934240362812,29.0,18.0,391,2.0,379
300,79,484,47.69378684807256,50.41052154195012,29.0,20.0,422,3.0,405
301,192,139,48.15818594104309,49.96934240362812,28.0,32.0,94,2.0,53
302,192,69,48.15818594104309,49.99256235827664,28.0,31.0,146,2.0,123
303,192,155,48.15818594104309,51.08390022675737,28.0,30.0,131,3.0,37
304,192,240,48.15818594104309,50.29442176870749,28.0,29.0,104,2.0,48
305,192,243,48.15818594104309,51.06068027210885,28.0,27.0,135,3.0,51
306,192,458,48.15818594104309,49.96934240362812,28.0,18.0,277,2.0,266
307,192,484,48.15818594104309,50.41052154195012,28.0,20.0,308,2.0,292
308,192,578,48.15818594104309,50.991020408163266,28.0,21.0,405,3.0,386
309,192,616,48.15818594104309,49.946122448979594,28.0,3.0,431,2.0,424
310,192,620,48.15818594104309,50.96780045351474,28.0,13.0,445,3.0,428
311,192,617,48.15818594104309,50.991020408163266,28.0,15.0,442,3.0,425
312,139,155,49.96934240362812,51.08390022675737,32.0,30.0,51,1.0,16
313,139,70,49.96934240362812,52.87183673469388,32.0,33.0,143,3.0,69
314,139,243,49.96934240362812,51.06068027210885,32.0,27.0,114,1.0,104
315,139,235,49.96934240362812,52.87183673469388,32.0,32.0,158,3.0,96
316,139,578,49.96934240362812,50.991020408163266,32.0,21.0,441,1.0,439
317,139,470,49.96934240362812,52.87183673469388,32.0,22.0,354,3.0,331
318,139,617,49.96934240362812,50.991020408163266,32.0,15.0,480,1.0,478
319,69,155,49.99256235827664,51.08390022675737,31.0,30.0,98,1.0,86
320,69,70,49.99256235827664,52.87183673469388,31.0,33.0,124,3.0,1
321,69,243,49.99256235827664,51.06068027210885,31.0,27.0,180,1.0,174
322,69,235,49.99256235827664,52.87183673469388,31.0,32.0,207,3.0,166
323,69,470,49.99256235827664,52.87183673469388,31.0,22.0,420,3.0,401
324,155,70,51.08390022675737,52.87183673469388,30.0,33.0,115,2.0,85
325,155,171,51.08390022675737,53.614875283446715,30.0,31.0,110,3.0,16
326,155,162,51.08390022675737,53.98639455782313,30.0,29.0,125,3.0,7
327,155,235,51.08390022675737,52.87183673469388,30.0,32.0,111,2.0,80
328,155,236,51.08390022675737,53.26657596371882,30.0,31.0,124,2.0,81
329,155,247,51.08390022675737,54.05605442176871,30.0,23.0,158,3.0,92
330,155,470,51.08390022675737,52.87183673469388,30.0,22.0,324,2.0,315
331,155,500,51.08390022675737,53.4291156462585,30.0,24.0,359,2.0,345
332,155,631,51.08390022675737,53.40589569160998,30.0,18.0,486,2.0,476
333,70,162,52.87183673469388,53.98639455782313,33.0,29.0,104,1.0,92
334,70,192,52.87183673469388,55.797551020408164,33.0,34.0,175,3.0,122
335,70,247,52.87183673469388,54.05605442176871,33.0,23.0,184,1.0,177
336,70,208,52.87183673469388,55.843990929705214,33.0,32.0,188,3.0,138
337,70,442,52.87183673469388,54.96163265306122,33.0,20.0,383,2.0,372
338,171,192,53.614875283446715,55.797551020408164,31.0,34.0,96,2.0,21
339,171,79,53.614875283446715,56.58702947845805,31.0,29.0,158,3.0,92
340,171,208,53.614875283446715,55.843990929705214,31.0,32.0,103,2.0,37
341,171,209,53.614875283446715,56.401269841269844,31.0,31.0,126,3.0,38
342,171,442,53.614875283446715,54.96163265306122,31.0,20.0,277,1.0,271
343,171,457,53.614875283446715,55.867210884353746,31.0,27.0,302,2.0,286
344,171,456,53.614875283446715,56.16907029478458,31.0,24.0,305,3.0,285
345,171,617,53.614875283446715,54.96163265306122,31.0,12.0,450,1.0,446
346,171,625,53.614875283446715,55.00807256235828,31.0,12.0,458,1.0,454
347,171,630,53.614875283446715,56.447709750566894,31.0,9.0,475,3.0,459
348,162,192,53.98639455782313,55.797551020408164,29.0,34.0,84,2.0,30
349,162,79,53.98639455782313,56.58702947845805,29.0,29.0,139,3.0,83
350,162,208,53.98639455782313,55.843990929705214,29.0,32.0,92,2.0,46
351,162,209,53.98639455782313,56.401269841269844,29.0,31.0,114,2.0,47
352,162,457,53.98639455782313,55.867210884353746,29.0,27.0,306,2.0,295
353,162,456,53.98639455782313,56.16907029478458,29.0,24.0,309,2.0,294
354,162,625,53.98639455782313,55.00807256235828,29.0,12.0,465,1.0,463
355,162,630,53.98639455782313,56.447709750566894,29.0,9.0,480,2.0,468
356,192,175,55.797551020408164,57.283628117913835,34.0,32.0,66,1.0,17
357,192,158,55.797551020408164,58.746485260770974,34.0,31.0,131,3.0,34
358,192,233,55.797551020408164,57.42294784580499,34.0,26.0,81,2.0,41
359,192,246,55.797551020408164,58.32852607709751,34.0,29.0,122,3.0,54
360,192,484,55.797551020408164,57.330068027210885,34.0,24.0,299,2.0,292
361,192,465,55.797551020408164,58.28208616780046,34.0,25.0,293,2.0,273
362,192,617,55.797551020408164,57.330068027210885,34.0,8.0,430,2.0,425
363,192,625,55.797551020408164,58.212426303854876,34.0,16.0,445,2.0,433
364,79,158,56.58702947845805,58.746485260770974,29.0,31.0,122,2.0,79
365,79,175,56.58702947845805,59.16444444444445,29.0,28.0,147,3.0,96
366,79,246,56.58702947845805,58.32852607709751,29.0,29.0,183,2.0,167
367,79,246,56.58702947845805,59.303764172335605,29.0,31.0,204,3.0,167
368,79,465,56.58702947845805,58.28208616780046,29.0,25.0,393,2.0,386
369,175,158,57.283628117913835,58.746485260770974,32.0,31.0,65,1.0,17
370,175,246,57.283628117913835,58.32852607709751,32.0,29.0,84,1.0,71
371,175,246,57.283628117913835,59.303764172335605,32.0,31.0,112,2.0,71
372,175,428,57.283628117913835,59.65206349206349,32.0,18.0,273,2.0,253
373,175,624,57.283628117913835,59.97714285714286,32.0,11.0,464,3.0,449
374,158,624,58.746485260770974,59.97714285714286,31.0,11.0,469,1.0,466
375,232,46,1.7647165532879818,2.8792743764172335,14.0,27.0,192,1.0,186
376,232,70,1.7647165532879818,3.0418140589569163,14.0,30.0,171,1.0,162
377,232,209,1.7647165532879818,2.972154195011338,14.0,18.0,57,1.0,23
378,232,209,1.7647165532879818,3.0650340136054424,14.0,19.0,61,1.0,23
379,232,209,1.7647165532879818,4.2260317460317465,14.0,5.0,108,2.0,23
380,232,420,1.7647165532879818,2.948934240362812,14.0,5.0,195,1.0,188
381,232,419,1.7647165532879818,3.0418140589569163,14.0,6.0,195,1.0,187
382,209,35,2.972154195011338,4.806530612244898,18.0,29.0,191,2.0,174
383,209,35,2.972154195011338,5.015510204081632,18.0,26.0,195,2.0,174
384,209,35,3.0650340136054424,4.806530612244898,19.0,29.0,189,2.0,174
385,209,35,3.0650340136054424,5.015510204081632,19.0,26.0,193,2.0,174
386,209,78,4.2260317460317465,6.965986394557823,5.0,25.0,176,3.0,131
387,209,78,5.804988662131519,6.965986394557823,9.0,25.0,140,1.0,131
388,209,22,5.804988662131519,7.337505668934241,9.0,25.0,198,2.0,187
389,209,35,5.804988662131519,8.312743764172335,9.0,24.0,205,3.0,174
390,209,52,7.75546485260771,9.7059410430839,7.0,30.0,178,2.0,157
391,209,78,7.75546485260771,10.634739229024943,7.0,25.0,180,3.0,131
392,209,234,7.75546485260771,10.216780045351474,7.0,12.0,109,2.0,25
393,209,52,8.103764172335602,9.7059410430839,11.0,30.0,171,2.0,157
394,209,78,8.103764172335602,10.634739229024943,11.0,25.0,170,3.0,131
395,209,234,8.103764172335602,10.216780045351474,11.0,12.0,94,2.0,25
396,234,139,10.216780045351474,12.051156462585034,12.0,32.0,124,2.0,95
397,234,232,10.216780045351474,11.23845804988662,12.0,38.0,44,1.0,2
398,234,254,10.216780045351474,12.004716553287983,12.0,31.0,80,2.0,20
399,234,507,10.216780045351474,11.331337868480725,12.0,21.0,277,1.0,273
400,234,485,10.216780045351474,12.07437641723356,12.0,24.0,263,2.0,251
401,234,617,10.216780045351474,12.654875283446712,12.0,18.0,397,2.0,383
402,232,159,11.23845804988662,13.467573696145125,38.0,27.0,121,2.0,73
403,232,231,11.23845804988662,13.467573696145125,38.0,31.0,96,2.0,1
404,232,231,11.23845804988662,14.02485260770975,38.0,31.0,120,3.0,1
405,232,443,11.23845804988662,13.467573696145125,38.0,21.0,232,2.0,211
406,232,617,11.23845804988662,12.654875283446712,38.0,18.0,390,1.0,385
407,232,630,11.23845804988662,13.467573696145125,38.0,14.0,409,2.0,398
408,254,159,12.004716553287983,13.467573696145125,31.0,27.0,114,1.0,95
409,254,63,12.004716553287983,14.257052154195012,31.0,30.0,214,2.0,191
410,254,231,12.004716553287983,13.467573696145125,31.0,31.0,67,1.0,23
411,254,231,12.004716553287983,14.02485260770975,31.0,31.0,90,2.0,23
412,254,443,12.004716553287983,13.467573696145125,31.0,21.0,199,1.0,189
413,254,420,12.004716553287983,14.907210884353741,31.0,23.0,208,3.0,166
414,254,630,12.004716553287983,13.467573696145125,31.0,14.0,381,1.0,376
415,254,616,12.004716553287983,14.512471655328799,31.0,18.0,378,3.0,362
416,231,63,13.467573696145125,15.000090702947846,31.0,29.0,180,2.0,168
417,231,160,13.467573696145125,16.416507936507937,31.0,27.0,145,3.0,71
418,231,236,13.467573696145125,15.789569160997733,31.0,30.0,100,2.0,5
419,231,420,13.467573696145125,14.907210884353741,31.0,23.0,199,1.0,189
420,231,410,13.467573696145125,15.928888888888888,31.0,24.0,208,2.0,179
421,231,489,13.467573696145125,15.998548752834468,31.0,20.0,280,3.0,258
422,231,616,13.467573696145125,14.512471655328799,31.0,18.0,388,1.0,385
423,231,618,13.467573696145125,15.418049886621315,31.0,17.0,396,2.0,387
424,231,626,13.467573696145125,16.416507936507937,31.0,12.0,415,3.0,395
425,231,160,14.02485260770975,16.416507936507937,31.0,27.0,125,2.0,71
426,231,236,14.02485260770975,15.789569160997733,31.0,30.0,76,2.0,5
427,231,410,14.02485260770975,15.928888888888888,31.0,24.0,197,2.0,179
428,231,489,14.02485260770975,15.998548752834468,31.0,20.0,272,2.0,258
429,231,618,14.02485260770975,15.418049886621315,31.0,17.0,392,1.0,387
430,231,626,14.02485260770975,16.416507936507937,31.0,12.0,408,2.0,395
431,236,70,15.789569160997733,17.57750566893424,30.0,37.0,183,2.0,166
432,236,71,15.789569160997733,18.29732426303855,30.0,34.0,197,3.0,165
433,236,247,15.789569160997733,17.22920634920635,30.0,31.0,63,1.0,11
434,236,431,15.789569160997733,17.76326530612245,30.0,22.0,213,2.0,195
435,236,631,15.789569160997733,17.740045351473924,30.0,12.0,404,2.0,395
436,231,70,16.416507936507937,17.57750566893424,31.0,37.0,169,1.0,161
437,231,71,16.416507936507937,18.29732426303855,31.0,34.0,179,2.0,160
438,231,236,16.416507936507937,18.715283446712018,31.0,35.0,99,2.0,5
439,231,431,16.416507936507937,17.76326530612245,31.0,22.0,208,1.0,200
440,231,476,16.416507936507937,18.901043083900227,31.0,24.0,267,2.0,245
441,231,631,16.416507936507937,17.740045351473924,31.0,12.0,404,1.0,400
442,231,616,16.416507936507937,18.83138321995465,31.0,13.0,399,2.0,385
443,231,630,16.416507936507937,19.342222222222222,31.0,13.0,418,3.0,399
444,247,71,17.22920634920635,18.29732426303855,31.0,34.0,182,1.0,176
445,247,67,17.22920634920635,19.760181405895693,31.0,33.0,210,3.0,180
446,247,194,17.22920634920635,20.154920634920636,31.0,33.0,137,3.0,53
447,247,236,17.22920634920635,18.715283446712018,31.0,35.0,65,1.0,11
448,247,231,17.22920634920635,19.365442176870747,31.0,31.0,93,2.0,16
449,247,260,17.22920634920635,20.17814058956916,31.0,32.0,128,3.0,13
450,247,476,17.22920634920635,18.901043083900227,31.0,24.0,240,2.0,229
451,247,423,17.22920634920635,19.89950113378685,31.0,21.0,210,3.0,176
452,247,616,17.22920634920635,18.83138321995465,31.0,13.0,375,2.0,369
453,247,630,17.22920634920635,19.342222222222222,31.0,13.0,394,2.0,383
454,236,67,18.715283446712018,19.760181405895693,35.0,33.0,175,1.0,169
455,236,194,18.715283446712018,20.154920634920636,35.0,33.0,75,1.0,42
456,236,199,18.715283446712018,21.61777777777778,35.0,23.0,130,3.0,37
457,236,260,18.715283446712018,20.17814058956916,35.0,32.0,67,1.0,24
458,236,251,18.715283446712018,21.106938775510205,35.0,32.0,104,2.0,15
459,236,423,18.715283446712018,19.89950113378685,35.0,21.0,194,1.0,187
460,236,446,18.715283446712018,20.24780045351474,35.0,22.0,220,2.0,210
461,236,499,18.715283446712018,21.43201814058957,35.0,22.0,288,3.0,263
462,236,628,18.715283446712018,20.36390022675737,35.0,15.0,398,2.0,392
463,236,617,18.715283446712018,21.292698412698414,35.0,18.0,397,3.0,381
464,231,199,19.365442176870747,21.61777777777778,31.0,23.0,102,2.0,32
465,231,251,19.365442176870747,21.106938775510205,31.0,32.0,78,2.0,20
466,231,499,19.365442176870747,21.43201814058957,31.0,22.0,282,2.0,268
467,231,617,19.365442176870747,21.292698412698414,31.0,18.0,395,2.0,386
468,260,199,20.17814058956916,21.61777777777778,32.0,23.0,87,1.0,61
469,260,67,20.17814058956916,22.709115646258503,32.0,28.0,222,3.0,193
470,260,231,20.17814058956916,22.291156462585036,32.0,31.0,96,2.0,29
471,260,499,20.17814058956916,21.43201814058957,32.0,22.0,245,1.0,239
472,260,443,20.17814058956916,22.84843537414966,32.0,21.0,216,3.0,183
473,260,465,20.17814058956916,22.98775510204082,32.0,20.0,238,3.0,205
474,260,617,20.17814058956916,21.292698412698414,32.0,18.0,360,1.0,357
475,260,615,20.17814058956916,22.871655328798187,32.0,14.0,373,3.0,355
476,251,67,21.106938775510205,22.709115646258503,32.0,28.0,197,2.0,184
477,251,158,21.106938775510205,23.45215419501134,32.0,30.0,137,2.0,93
478,251,231,21.106938775510205,22.291156462585036,32.0,31.0,55,1.0,20
479,251,231,21.106938775510205,23.777233560090703,32.0,31.0,117,3.0,20
480,251,443,21.106938775510205,22.84843537414966,32.0,21.0,206,2.0,192
481,251,465,21.106938775510205,22.98775510204082,32.0,20.0,229,2.0,214
482,251,615,21.106938775510205,22.871655328798187,32.0,14.0,372,2.0,364
483,251,629,21.106938775510205,23.75401360544218,32.0,13.0,395,3.0,378
484,231,158,22.291156462585036,23.45215419501134,31.0,30.0,88,1.0,73
485,231,71,22.291156462585036,24.543492063492064,31.0,24.0,187,2.0,160
486,231,160,22.291156462585036,25.240090702947846,31.0,26.0,145,3.0,71
487,231,245,22.291156462585036,24.171972789115646,31.0,30.0,82,2.0,14
488,231,412,22.291156462585036,24.961451247165535,31.0,18.0,214,3.0,181
489,231,443,22.291156462585036,25.240090702947846,31.0,20.0,247,3.0,212
490,231,629,22.291156462585036,23.75401360544218,31.0,13.0,403,1.0,398
491,231,625,22.291156462585036,24.86857142857143,31.0,10.0,409,3.0,394
492,231,630,22.291156462585036,25.240090702947846,31.0,13.0,419,3.0,399
493,231,160,23.777233560090703,25.240090702947846,31.0,26.0,95,1.0,71
494,231,66,23.777233560090703,26.076009070294784,31.0,29.0,192,2.0,165
495,231,412,23.777233560090703,24.961451247165535,31.0,18.0,188,1.0,181
496,231,443,23.777233560090703,25.240090702947846,31.0,20.0,221,1.0,212
497,231,467,23.777233560090703,26.563628117913833,31.0,24.0,265,3.0,236
498,231,625,23.777233560090703,24.86857142857143,31.0,10.0,397,1.0,394
499,231,630,23.777233560090703,25.240090702947846,31.0,13.0,404,1.0,399
500,231,617,23.777233560090703,26.540408163265308,31.0,15.0,404,3.0,386
501,245,160,24.171972789115646,25.240090702947846,30.0,26.0,97,1.0,85
502,245,66,24.171972789115646,26.076009070294784,30.0,29.0,197,2.0,179
503,245,231,24.171972789115646,25.240090702947846,30.0,33.0,48,1.0,14
504,245,231,24.171972789115646,26.70294784580499,30.0,30.0,110,3.0,14
505,245,443,24.171972789115646,25.240090702947846,30.0,20.0,203,1.0,198
506,245,467,24.171972789115646,26.563628117913833,30.0,24.0,245,2.0,222
507,245,630,24.171972789115646,25.240090702947846,30.0,13.0,388,1.0,385
508,245,617,24.171972789115646,26.540408163265308,30.0,15.0,386,2.0,372
509,231,158,25.240090702947846,27.608526077097505,33.0,28.0,125,2.0,73
510,231,278,25.240090702947846,27.933605442176873,33.0,23.0,125,3.0,47
511,231,232,25.240090702947846,28.18902494331066,33.0,31.0,127,3.0,1
512,231,467,25.240090702947846,26.563628117913833,33.0,24.0,243,1.0,236
513,231,458,25.240090702947846,27.58530612244898,33.0,18.0,248,2.0,227
514,231,423,25.240090702947846,28.18902494331066,33.0,21.0,230,3.0,192
515,231,617,25.240090702947846,26.540408163265308,33.0,15.0,390,1.0,386
516,231,625,25.240090702947846,27.16734693877551,33.0,10.0,403,2.0,394
517,231,626,25.240090702947846,28.18902494331066,33.0,12.0,415,3.0,395
518,231,78,26.70294784580499,28.95528344671202,30.0,26.0,181,2.0,153
519,231,278,26.70294784580499,27.933605442176873,30.0,23.0,71,1.0,47
520,231,232,26.70294784580499,28.18902494331066,30.0,31.0,64,1.0,1
521,231,423,26.70294784580499,28.18902494331066,30.0,21.0,202,1.0,192
522,231,454,26.70294784580499,29.489342403628118,30.0,24.0,253,3.0,223
523,231,626,26.70294784580499,28.18902494331066,30.0,12.0,400,1.0,395
524,231,616,26.70294784580499,29.512562358276643,30.0,15.0,404,3.0,385
525,278,78,27.933605442176873,28.95528344671202,23.0,26.0,205,1.0,200
526,278,78,27.933605442176873,29.744761904761905,23.0,31.0,215,2.0,200
527,278,175,27.933605442176873,30.859319727891158,23.0,27.0,163,3.0,103
528,278,231,27.933605442176873,29.651882086167802,23.0,30.0,88,2.0,47
529,278,266,27.933605442176873,30.78965986394558,23.0,30.0,124,3.0,12
530,278,454,27.933605442176873,29.489342403628118,23.0,24.0,188,2.0,176
531,278,465,27.933605442176873,30.534240362811794,23.0,24.0,218,3.0,187
532,278,616,27.933605442176873,29.512562358276643,23.0,15.0,345,2.0,338
533,278,631,27.933605442176873,30.511020408163265,23.0,18.0,370,3.0,353
534,232,78,28.18902494331066,29.744761904761905,31.0,31.0,168,2.0,154
535,232,175,28.18902494331066,30.859319727891158,31.0,27.0,128,3.0,57
536,232,231,28.18902494331066,29.651882086167802,31.0,30.0,63,1.0,1
537,232,266,28.18902494331066,30.78965986394558,31.0,30.0,117,3.0,34
538,232,454,28.18902494331066,29.489342403628118,31.0,24.0,229,1.0,222
539,232,465,28.18902494331066,30.534240362811794,31.0,24.0,254,2.0,233
540,232,455,28.18902494331066,31.02185941043084,31.0,26.0,254,3.0,223
541,232,616,28.18902494331066,29.512562358276643,31.0,15.0,388,1.0,384
542,232,631,28.18902494331066,30.511020408163265,31.0,18.0,411,2.0,399
543,232,625,28.18902494331066,31.02185941043084,31.0,15.0,412,3.0,393
544,231,175,29.651882086167802,30.859319727891158,30.0,27.0,76,1.0,56
545,231,160,29.651882086167802,31.67201814058957,30.0,25.0,112,2.0,71
546,231,70,29.651882086167802,32.27573696145125,30.0,30.0,197,3.0,161
547,231,266,29.651882086167802,30.78965986394558,30.0,30.0,60,1.0,35
548,231,250,29.651882086167802,31.532698412698412,30.0,31.0,83,2.0,19
549,231,232,29.651882086167802,32.60081632653061,30.0,32.0,127,3.0,1
550,231,455,29.651882086167802,31.02185941043084,30.0,26.0,232,1.0,224
551,231,463,29.651882086167802,32.48471655328798,30.0,24.0,262,3.0,232
552,231,625,29.651882086167802,31.02185941043084,30.0,15.0,398,1.0,394
553,231,618,29.651882086167802,32.46149659863946,30.0,16.0,405,3.0,387
554,266,70,30.78965986394558,32.27573696145125,30.0,30.0,206,1.0,196
555,266,193,30.78965986394558,33.3902947845805,30.0,25.0,134,3.0,73
556,266,232,30.78965986394558,32.60081632653061,30.0,32.0,85,2.0,34
557,266,220,30.78965986394558,33.50639455782313,30.0,26.0,126,3.0,46
558,266,463,30.78965986394558,32.48471655328798,30.0,24.0,210,2.0,197
559,266,618,30.78965986394558,32.46149659863946,30.0,16.0,359,2.0,352
560,250,193,31.532698412698412,33.3902947845805,31.0,25.0,98,2.0,57
561,250,70,31.532698412698412,34.13333333333333,31.0,30.0,212,3.0,180
562,250,232,31.532698412698412,32.60081632653061,31.0,32.0,49,1.0,18
563,250,220,31.532698412698412,33.50639455782313,31.0,26.0,90,2.0,30
564,250,231,31.532698412698412,34.06367346938776,31.0,30.0,111,3.0,19
565,250,482,31.532698412698412,33.97079365079365,31.0,22.0,255,2.0,232
566,250,482,31.532698412698412,33.99401360544218,31.0,22.0,255,2.0,232
567,250,615,31.532698412698412,33.97079365079365,31.0,11.0,380,2.0,365
568,250,627,31.532698412698412,33.99401360544218,31.0,11.0,392,2.0,377
569,232,70,32.60081632653061,34.13333333333333,32.0,30.0,175,2.0,162
570,232,67,32.60081632653061,35.54975056689342,32.0,26.0,208,3.0,165
571,232,231,32.60081632653061,34.06367346938776,32.0,30.0,63,1.0,1
572,232,482,32.60081632653061,33.97079365079365,32.0,22.0,257,1.0,250
573,232,482,32.60081632653061,33.99401360544218,32.0,22.0,257,1.0,250
574,232,615,32.60081632653061,33.97079365079365,32.0,11.0,388,1.0,383
575,232,627,32.60081632653061,33.99401360544218,32.0,11.0,400,1.0,395
576,220,67,33.50639455782313,35.54975056689342,26.0,26.0,177,2.0,153
577,220,191,33.50639455782313,36.385668934240364,26.0,31.0,127,3.0,29
578,220,316,33.50639455782313,35.68907029478458,26.0,27.0,134,2.0,96
579,220,451,33.50639455782313,35.68907029478458,26.0,25.0,249,2.0,231
580,220,626,33.50639455782313,35.68907029478458,26.0,17.0,417,2.0,406
581,231,67,34.06367346938776,35.54975056689342,30.0,26.0,176,1.0,164
582,231,191,34.06367346938776,36.385668934240364,30.0,31.0,108,2.0,40
583,231,316,34.06367346938776,35.68907029478458,30.0,27.0,110,2.0,85
584,231,234,34.06367346938776,36.89650793650794,30.0,28.0,122,3.0,3
585,231,451,34.06367346938776,35.68907029478458,30.0,25.0,231,2.0,220
586,231,508,34.06367346938776,36.57142857142857,30.0,25.0,297,3.0,277
587,231,423,34.06367346938776,37.01260770975057,30.0,20.0,230,3.0,192
588,231,626,34.06367346938776,35.68907029478458,30.0,17.0,401,2.0,395
589,231,630,34.06367346938776,36.57142857142857,30.0,14.0,413,3.0,399
590,231,630,34.06367346938776,36.989387755102044,30.0,15.0,418,3.0,399
591,316,71,35.68907029478458,37.430566893424036,27.0,30.0,256,2.0,245
592,316,174,35.68907029478458,38.47546485260771,27.0,27.0,186,3.0,142
593,316,234,35.68907029478458,36.89650793650794,27.0,28.0,97,1.0,82
594,316,231,35.68907029478458,37.01260770975057,27.0,32.0,102,1.0,85
595,316,231,35.68907029478458,38.47546485260771,27.0,31.0,147,3.0,85
596,316,423,35.68907029478458,37.01260770975057,27.0,20.0,121,1.0,107
597,316,481,35.68907029478458,38.59156462585034,27.0,21.0,207,3.0,165
598,316,630,35.68907029478458,36.989387755102044,27.0,15.0,319,1.0,314
599,316,617,35.68907029478458,38.59156462585034,27.0,14.0,326,3.0,301
600,234,174,36.89650793650794,38.47546485260771,28.0,27.0,91,2.0,60
601,234,231,36.89650793650794,38.47546485260771,28.0,31.0,68,2.0,3
602,234,481,36.89650793650794,38.59156462585034,28.0,21.0,258,2.0,247
603,234,617,36.89650793650794,38.59156462585034,28.0,14.0,390,2.0,383
604,234,625,36.89650793650794,39.19528344671202,28.0,14.0,403,2.0,391
605,231,174,37.01260770975057,38.47546485260771,32.0,27.0,85,1.0,57
606,231,160,37.01260770975057,39.938321995464854,32.0,26.0,145,3.0,71
607,231,481,37.01260770975057,38.59156462585034,32.0,21.0,259,2.0,250
608,231,503,37.01260770975057,39.938321995464854,32.0,19.0,300,3.0,272
609,231,617,37.01260770975057,38.59156462585034,32.0,14.0,392,2.0,386
610,231,625,37.01260770975057,39.19528344671202,32.0,14.0,405,2.0,394
611,231,160,38.47546485260771,39.938321995464854,31.0,26.0,95,1.0,71
612,231,138,38.47546485260771,40.4259410430839,31.0,23.0,125,2.0,93
613,231,232,38.47546485260771,40.49560090702948,31.0,26.0,87,2.0,1
614,231,254,38.47546485260771,41.40117913832199,31.0,29.0,128,3.0,23
615,231,503,38.47546485260771,39.938321995464854,31.0,19.0,279,1.0,272
616,231,503,38.47546485260771,40.24018140589569,31.0,22.0,282,2.0,272
617,231,424,38.47546485260771,41.40117913832199,31.0,19.0,230,3.0,193
618,231,630,38.47546485260771,40.24018140589569,31.0,16.0,406,2.0,399
619,231,631,38.47546485260771,41.40117913832199,31.0,12.0,419,3.0,400
620,231,66,39.938321995464854,41.84235827664399,30.0,29.0,184,2.0,165
621,231,160,39.938321995464854,42.887256235827664,30.0,28.0,145,3.0,71
622,231,254,39.938321995464854,41.40117913832199,30.0,29.0,67,1.0,23
623,231,254,39.938321995464854,42.887256235827664,30.0,29.0,129,3.0,23
624,231,424,39.938321995464854,41.40117913832199,30.0,19.0,203,1.0,193
625,231,419,39.938321995464854,42.887256235827664,30.0,18.0,227,3.0,188
626,231,631,39.938321995464854,41.40117913832199,30.0,12.0,405,1.0,400
627,231,627,39.938321995464854,42.887256235827664,30.0,12.0,416,3.0,396
628,232,66,40.49560090702948,41.84235827664399,26.0,29.0,176,1.0,166
629,232,160,40.49560090702948,42.887256235827664,26.0,28.0,126,2.0,72
630,232,160,40.49560090702948,43.444535147392294,26.0,25.0,146,3.0,72
631,232,254,40.49560090702948,42.887256235827664,26.0,29.0,105,2.0,22
632,232,326,40.49560090702948,43.18911564625851,26.0,29.0,149,3.0,94
633,232,419,40.49560090702948,42.887256235827664,26.0,18.0,213,2.0,187
634,232,472,40.49560090702948,43.21233560090703,26.0,25.0,267,3.0,240
635,232,627,40.49560090702948,42.887256235827664,26.0,12.0,408,2.0,395
636,232,630,40.49560090702948,43.21233560090703,26.0,17.0,415,3.0,398
637,254,160,41.40117913832199,42.887256235827664,29.0,28.0,114,1.0,94
638,254,160,41.40117913832199,43.444535147392294,29.0,25.0,129,2.0,94
639,254,160,41.40117913832199,44.373333333333335,29.0,25.0,159,3.0,94
640,254,326,41.40117913832199,43.18911564625851,29.0,29.0,105,2.0,72
641,254,231,41.40117913832199,44.35011337868481,29.0,29.0,129,3.0,23
642,254,419,41.40117913832199,42.887256235827664,29.0,18.0,177,1.0,165
643,254,472,41.40117913832199,43.21233560090703,29.0,25.0,232,2.0,218
644,254,487,41.40117913832199,44.0714739229025,29.0,25.0,260,3.0,233
645,254,627,41.40117913832199,42.887256235827664,29.0,12.0,378,1.0,373
646,254,630,41.40117913832199,43.21233560090703,29.0,17.0,384,2.0,376
647,254,629,41.40117913832199,44.0714739229025,29.0,16.0,392,3.0,375
648,254,160,42.887256235827664,44.373333333333335,29.0,25.0,114,1.0,94
649,254,160,42.887256235827664,45.836190476190474,29.0,26.0,158,3.0,94
650,254,231,42.887256235827664,44.35011337868481,29.0,29.0,67,1.0,23
651,254,232,42.887256235827664,45.836190476190474,29.0,30.0,129,3.0,22
652,254,487,42.887256235827664,44.0714739229025,29.0,25.0,239,1.0,233
653,254,489,42.887256235827664,45.069931972789114,29.0,26.0,253,2.0,235
654,254,629,42.887256235827664,44.0714739229025,29.0,16.0,378,1.0,375
655,254,625,42.887256235827664,45.069931972789114,29.0,17.0,383,2.0,371
656,326,160,43.18911564625851,44.373333333333335,29.0,25.0,174,1.0,166
657,326,160,43.18911564625851,45.836190476190474,29.0,26.0,201,3.0,166
658,326,231,43.18911564625851,44.35011337868481,29.0,29.0,107,1.0,95
659,326,232,43.18911564625851,45.836190476190474,29.0,30.0,148,3.0,94
660,326,489,43.18911564625851,45.069931972789114,29.0,26.0,182,2.0,163
661,326,625,43.18911564625851,45.069931972789114,29.0,17.0,310,2.0,299
662,231,160,44.35011337868481,45.836190476190474,29.0,26.0,96,1.0,71
663,231,160,44.35011337868481,46.393469387755104,29.0,22.0,113,2.0,71
664,231,232,44.35011337868481,45.836190476190474,29.0,30.0,64,1.0,1
665,231,252,44.35011337868481,47.02040816326531,29.0,31.0,117,3.0,21
666,231,423,44.35011337868481,46.37024943310658,29.0,20.0,211,2.0,192
667,231,628,44.35011337868481,46.37024943310658,29.0,11.0,406,2.0,397
668,232,79,45.836190476190474,47.69378684807256,30.0,29.0,173,2.0,153
669,232,192,45.836190476190474,48.15818594104309,30.0,28.0,108,2.0,40
670,232,252,45.836190476190474,47.02040816326531,30.0,31.0,55,1.0,20
671,232,236,45.836190476190474,48.15818594104309,30.0,30.0,100,2.0,4
672,232,596,45.836190476190474,47.4615873015873,30.0,21.0,371,2.0,364
673,232,440,45.836190476190474,48.36716553287982,30.0,22.0,235,3.0,208
674,232,632,45.836190476190474,47.438367346938776,30.0,17.0,406,2.0,400
675,232,625,45.836190476190474,48.39038548752835,30.0,12.0,408,3.0,393
676,231,79,46.37024943310658,47.69378684807256,26.0,29.0,162,1.0,152
677,231,192,46.37024943310658,48.15818594104309,26.0,28.0,86,2.0,39
678,231,236,46.37024943310658,48.15818594104309,26.0,30.0,77,2.0,5
679,231,234,46.37024943310658,49.04054421768708,26.0,32.0,115,3.0,3
680,231,596,46.37024943310658,47.4615873015873,26.0,21.0,368,1.0,365
681,231,440,46.37024943310658,48.36716553287982,26.0,22.0,226,2.0,209
682,231,632,46.37024943310658,47.438367346938776,26.0,17.0,404,1.0,401
683,231,625,46.37024943310658,48.39038548752835,26.0,12.0,403,2.0,394
684,252,192,47.02040816326531,48.15818594104309,31.0,28.0,77,1.0,60
685,252,139,47.02040816326531,49.96934240362812,31.0,32.0,170,3.0,113
686,252,69,47.02040816326531,49.99256235827664,31.0,31.0,223,3.0,183
687,252,236,47.02040816326531,48.15818594104309,31.0,30.0,52,1.0,16
688,252,234,47.02040816326531,49.04054421768708,31.0,32.0,89,2.0,18
689,252,440,47.02040816326531,48.36716553287982,31.0,22.0,197,1.0,188
690,252,458,47.02040816326531,49.96934240362812,31.0,18.0,242,3.0,206
691,252,625,47.02040816326531,48.39038548752835,31.0,12.0,378,1.0,373
692,252,616,47.02040816326531,49.946122448979594,31.0,3.0,385,3.0,364
693,236,139,48.15818594104309,49.96934240362812,30.0,32.0,124,2.0,97
694,236,69,48.15818594104309,49.99256235827664,30.0,31.0,185,2.0,167
695,236,155,48.15818594104309,51.08390022675737,30.0,30.0,150,3.0,81
696,236,240,48.15818594104309,50.29442176870749,30.0,29.0,92,2.0,4
697,236,243,48.15818594104309,51.06068027210885,30.0,27.0,125,3.0,7
698,236,458,48.15818594104309,49.96934240362812,30.0,18.0,235,2.0,222
699,236,484,48.15818594104309,50.41052154195012,30.0,20.0,266,2.0,248
700,236,578,48.15818594104309,50.991020408163266,30.0,21.0,363,3.0,342
701,236,616,48.15818594104309,49.946122448979594,30.0,3.0,388,2.0,380
702,236,620,48.15818594104309,50.96780045351474,30.0,13.0,403,3.0,384
703,236,617,48.15818594104309,50.991020408163266,30.0,15.0,400,3.0,381
704,234,155,49.04054421768708,51.08390022675737,32.0,30.0,118,2.0,79
705,234,240,49.04054421768708,50.29442176870749,32.0,29.0,54,1.0,6
706,234,243,49.04054421768708,51.06068027210885,32.0,27.0,87,2.0,9
707,234,484,49.04054421768708,50.41052154195012,32.0,20.0,257,1.0,250
708,234,578,49.04054421768708,50.991020408163266,32.0,21.0,354,2.0,344
709,234,620,49.04054421768708,50.96780045351474,32.0,13.0,395,2.0,386
710,234,617,49.04054421768708,50.991020408163266,32.0,15.0,392,2.0,383
711,234,639,49.04054421768708,52.01269841269841,32.0,15.0,425,3.0,405
712,240,70,50.29442176870749,52.87183673469388,29.0,33.0,203,3.0,170
713,240,235,50.29442176870749,52.87183673469388,29.0,32.0,111,3.0,5
714,240,236,50.29442176870749,53.26657596371882,29.0,31.0,128,3.0,4
715,240,470,50.29442176870749,52.87183673469388,29.0,22.0,255,3.0,230
716,240,639,50.29442176870749,52.01269841269841,29.0,15.0,406,2.0,399
717,243,70,51.06068027210885,52.87183673469388,27.0,33.0,190,2.0,173
718,243,171,51.06068027210885,53.614875283446715,27.0,31.0,131,3.0,72
719,243,162,51.06068027210885,53.98639455782313,27.0,29.0,150,3.0,81
720,243,235,51.06068027210885,52.87183673469388,27.0,32.0,78,2.0,8
721,243,236,51.06068027210885,53.26657596371882,27.0,31.0,95,2.0,7
722,243,470,51.06068027210885,52.87183673469388,27.0,22.0,240,2.0,227
723,243,500,51.06068027210885,53.4291156462585,27.0,24.0,277,2.0,257
724,243,631,51.06068027210885,53.40589569160998,27.0,18.0,401,2.0,388
725,235,162,52.87183673469388,53.98639455782313,32.0,29.0,87,1.0,73
726,235,192,52.87183673469388,55.797551020408164,32.0,34.0,133,3.0,43
727,235,247,52.87183673469388,54.05605442176871,32.0,23.0,52,1.0,12
728,235,208,52.87183673469388,55.843990929705214,32.0,32.0,131,3.0,27
729,235,442,52.87183673469388,54.96163265306122,32.0,20.0,226,2.0,207
730,235,617,52.87183673469388,54.96163265306122,32.0,12.0,392,2.0,382
731,235,625,52.87183673469388,55.00807256235828,32.0,12.0,401,2.0,390
732,236,192,53.26657596371882,55.797551020408164,31.0,34.0,118,3.0,44
733,236,208,53.26657596371882,55.843990929705214,31.0,32.0,114,3.0,28
734,236,442,53.26657596371882,54.96163265306122,31.0,20.0,219,2.0,206
735,236,457,53.26657596371882,55.867210884353746,31.0,27.0,248,3.0,221
736,236,456,53.26657596371882,56.16907029478458,31.0,24.0,253,3.0,220
737,236,617,53.26657596371882,54.96163265306122,31.0,12.0,388,2.0,381
738,236,625,53.26657596371882,55.00807256235828,31.0,12.0,396,2.0,389
739,247,192,54.05605442176871,55.797551020408164,23.0,34.0,93,2.0,55
740,247,79,54.05605442176871,56.58702947845805,23.0,29.0,200,3.0,168
741,247,208,54.05605442176871,55.843990929705214,23.0,32.0,86,2.0,39
742,247,209,54.05605442176871,56.401269841269844,23.0,31.0,108,2.0,38
743,247,457,54.05605442176871,55.867210884353746,23.0,27.0,224,2.0,210
744,247,456,54.05605442176871,56.16907029478458,23.0,24.0,228,2.0,209
745,247,630,54.05605442176871,56.447709750566894,23.0,9.0,397,2.0,383
746,208,175,55.843990929705214,57.283628117913835,32.0,32.0,70,1.0,33
747,208,158,55.843990929705214,58.746485260770974,32.0,31.0,135,3.0,50
748,208,233,55.843990929705214,57.42294784580499,32.0,26.0,72,2.0,25
749,208,246,55.843990929705214,58.32852607709751,32.0,29.0,114,2.0,38
750,208,484,55.843990929705214,57.330068027210885,32.0,24.0,283,1.0,276
751,208,465,55.843990929705214,58.28208616780046,32.0,25.0,278,2.0,257
752,208,617,55.843990929705214,57.330068027210885,32.0,8.0,414,1.0,409
753,208,625,55.843990929705214,58.212426303854876,32.0,16.0,429,2.0,417
754,209,158,56.401269841269844,58.746485260770974,31.0,31.0,113,2.0,51
755,209,175,56.401269841269844,59.16444444444445,31.0,28.0,124,3.0,34
756,209,233,56.401269841269844,57.42294784580499,31.0,26.0,50,1.0,24
757,209,246,56.401269841269844,58.32852607709751,31.0,29.0,91,2.0,37
758,209,246,56.401269841269844,59.303764172335605,31.0,31.0,130,3.0,37
759,209,465,56.401269841269844,58.28208616780046,31.0,25.0,269,2.0,256
760,209,625,56.401269841269844,58.212426303854876,31.0,16.0,423,2.0,416
761,233,158,57.42294784580499,58.746485260770974,26.0,31.0,94,1.0,75
762,233,175,57.42294784580499,59.16444444444445,26.0,28.0,95,2.0,58
763,233,246,57.42294784580499,59.303764172335605,26.0,31.0,82,2.0,13
764,233,428,57.42294784580499,59.65206349206349,26.0,18.0,217,2.0,195
765,233,624,57.42294784580499,59.97714285714286,26.0,11.0,406,3.0,391
766,246,428,58.32852607709751,59.65206349206349,29.0,18.0,191,1.0,182
767,246,624,58.32852607709751,59.97714285714286,29.0,11.0,385,2.0,378
768,420,35,2.948934240362812,4.806530612244898,5.0,29.0,393,2.0,385
769,420,35,2.948934240362812,5.015510204081632,5.0,26.0,395,2.0,385
770,420,209,2.948934240362812,4.2260317460317465,5.0,5.0,218,1.0,211
771,420,209,2.948934240362812,5.804988662131519,5.0,9.0,244,3.0,211
772,419,35,3.0418140589569163,4.806530612244898,6.0,29.0,391,2.0,384
773,419,35,3.0418140589569163,5.015510204081632,6.0,26.0,393,2.0,384
774,419,209,3.0418140589569163,4.2260317460317465,6.0,5.0,216,1.0,210
775,419,209,3.0418140589569163,5.804988662131519,6.0,9.0,241,3.0,210
776,507,159,11.331337868480725,13.467573696145125,21.0,27.0,360,2.0,348
777,507,63,11.331337868480725,14.257052154195012,21.0,30.0,462,3.0,444
778,507,231,11.331337868480725,13.467573696145125,21.0,31.0,291,2.0,276
779,507,231,11.331337868480725,14.02485260770975,21.0,31.0,299,3.0,276
780,507,443,11.331337868480725,13.467573696145125,21.0,21.0,112,2.0,64
781,507,617,11.331337868480725,12.654875283446712,21.0,18.0,124,1.0,110
782,507,630,11.331337868480725,13.467573696145125,21.0,14.0,154,2.0,123
783,507,868,11.331337868480725,12.585215419501134,21.0,15.0,365,1.0,361
784,507,847,11.331337868480725,13.467573696145125,21.0,9.0,352,2.0,340
785,485,159,12.07437641723356,13.467573696145125,24.0,27.0,331,1.0,326
786,485,63,12.07437641723356,14.257052154195012,24.0,30.0,432,2.0,422
787,485,63,12.07437641723356,15.000090702947846,24.0,29.0,440,3.0,422
788,485,231,12.07437641723356,13.467573696145125,24.0,31.0,261,1.0,254
789,485,231,12.07437641723356,14.02485260770975,24.0,31.0,268,2.0,254
790,485,443,12.07437641723356,13.467573696145125,24.0,21.0,73,1.0,42
791,485,420,12.07437641723356,14.907210884353741,24.0,23.0,138,3.0,65
792,485,630,12.07437641723356,13.467573696145125,24.0,14.0,157,1.0,145
793,485,616,12.07437641723356,14.512471655328799,24.0,18.0,168,2.0,131
794,485,847,12.07437641723356,13.467573696145125,24.0,9.0,367,1.0,362
795,485,846,12.07437641723356,14.489251700680272,24.0,11.0,376,2.0,361
796,443,63,13.467573696145125,15.000090702947846,21.0,29.0,386,2.0,380
797,443,160,13.467573696145125,16.416507936507937,21.0,27.0,310,3.0,283
798,443,236,13.467573696145125,15.789569160997733,21.0,30.0,230,2.0,207
799,443,231,13.467573696145125,16.416507936507937,21.0,31.0,247,3.0,212
800,443,420,13.467573696145125,14.907210884353741,21.0,23.0,66,1.0,23
801,443,410,13.467573696145125,15.928888888888888,21.0,24.0,111,2.0,33
802,443,489,13.467573696145125,15.998548752834468,21.0,20.0,118,3.0,46
803,443,616,13.467573696145125,14.512471655328799,21.0,18.0,179,1.0,173
804,443,618,13.467573696145125,15.418049886621315,21.0,17.0,194,2.0,175
805,443,626,13.467573696145125,16.416507936507937,21.0,12.0,223,3.0,183
806,443,846,13.467573696145125,14.489251700680272,21.0,11.0,405,1.0,403
807,443,867,13.467573696145125,15.464489795918368,21.0,6.0,433,2.0,424
808,443,868,13.467573696145125,16.416507936507937,21.0,8.0,444,3.0,425
809,420,160,14.907210884353741,16.416507936507937,23.0,27.0,268,2.0,260
810,420,70,14.907210884353741,17.57750566893424,23.0,37.0,368,3.0,350
811,420,231,14.907210884353741,16.416507936507937,23.0,31.0,200,2.0,189
812,420,247,14.907210884353741,17.22920634920635,23.0,31.0,200,2.0,173
813,420,410,14.907210884353741,15.928888888888888,23.0,24.0,45,1.0,10
814,420,489,14.907210884353741,15.998548752834468,23.0,20.0,83,1.0,69
815,420,431,14.907210884353741,17.76326530612245,23.0,22.0,123,3.0,11
816,420,626,14.907210884353741,16.416507936507937,23.0,12.0,216,2.0,206
817,420,631,14.907210884353741,17.740045351473924,23.0,12.0,244,3.0,211
818,420,868,14.907210884353741,16.416507936507937,23.0,8.0,453,2.0,448
819,420,856,14.907210884353741,17.740045351473924,23.0,9.0,453,3.0,436
820,410,70,15.928888888888888,17.57750566893424,24.0,37.0,347,2.0,340
821,410,71,15.928888888888888,18.29732426303855,24.0,34.0,354,2.0,339
822,410,247,15.928888888888888,17.22920634920635,24.0,31.0,172,1.0,163
823,410,236,15.928888888888888,18.715283446712018,24.0,35.0,211,3.0,174
824,410,431,15.928888888888888,17.76326530612245,24.0,22.0,82,2.0,21
825,410,476,15.928888888888888,18.901043083900227,24.0,24.0,144,3.0,66
826,410,631,15.928888888888888,17.740045351473924,24.0,12.0,234,2.0,221
827,410,616,15.928888888888888,18.83138321995465,24.0,13.0,241,3.0,206
828,410,856,15.928888888888888,17.740045351473924,24.0,9.0,453,2.0,446
829,410,869,15.928888888888888,18.29732426303855,24.0,6.0,470,2.0,459
830,489,70,15.998548752834468,17.57750566893424,20.0,37.0,424,2.0,419
831,489,71,15.998548752834468,18.29732426303855,20.0,34.0,430,2.0,418
832,489,247,15.998548752834468,17.22920634920635,20.0,31.0,248,1.0,242
833,489,236,15.998548752834468,18.715283446712018,20.0,35.0,279,3.0,253
834,489,431,15.998548752834468,17.76326530612245,20.0,22.0,96,2.0,58
835,489,476,15.998548752834468,18.901043083900227,20.0,24.0,126,3.0,13
836,489,631,15.998548752834468,17.740045351473924,20.0,12.0,161,2.0,142
837,489,616,15.998548752834468,18.83138321995465,20.0,13.0,176,3.0,127
838,489,856,15.998548752834468,17.740045351473924,20.0,9.0,375,2.0,367
839,489,869,15.998548752834468,18.29732426303855,20.0,6.0,393,2.0,380
840,431,67,17.76326530612245,19.760181405895693,22.0,33.0,374,2.0,364
841,431,194,17.76326530612245,20.154920634920636,22.0,33.0,258,2.0,237
842,431,231,17.76326530612245,19.365442176870747,22.0,31.0,212,2.0,200
843,431,260,17.76326530612245,20.17814058956916,22.0,32.0,200,2.0,171
844,431,476,17.76326530612245,18.901043083900227,22.0,24.0,67,1.0,45
845,431,423,17.76326530612245,19.89950113378685,22.0,21.0,92,2.0,8
846,431,446,17.76326530612245,20.24780045351474,22.0,22.0,108,2.0,15
847,431,616,17.76326530612245,18.83138321995465,22.0,13.0,191,1.0,185
848,431,630,17.76326530612245,19.342222222222222,22.0,13.0,210,2.0,199
849,431,628,17.76326530612245,20.36390022675737,22.0,15.0,227,3.0,197
850,431,847,17.76326530612245,19.89950113378685,22.0,6.0,426,2.0,416
851,431,861,17.76326530612245,20.712199546485262,22.0,7.0,448,3.0,430
852,476,194,18.901043083900227,20.154920634920636,24.0,33.0,287,1.0,282
853,476,199,18.901043083900227,21.61777777777778,24.0,23.0,301,3.0,277
854,476,260,18.901043083900227,20.17814058956916,24.0,32.0,223,1.0,216
855,476,251,18.901043083900227,21.106938775510205,24.0,32.0,244,2.0,225
856,476,446,18.901043083900227,20.24780045351474,24.0,22.0,65,1.0,30
857,476,499,18.901043083900227,21.43201814058957,24.0,22.0,111,3.0,23
858,476,628,18.901043083900227,20.36390022675737,24.0,15.0,165,1.0,152
859,476,617,18.901043083900227,21.292698412698414,24.0,18.0,175,2.0,141
860,476,861,18.901043083900227,20.712199546485262,24.0,7.0,393,2.0,385
861,476,844,18.901043083900227,21.292698412698414,24.0,10.0,382,2.0,368
862,423,199,19.89950113378685,21.61777777777778,21.0,23.0,236,2.0,224
863,423,67,19.89950113378685,22.709115646258503,21.0,28.0,376,3.0,356
864,423,251,19.89950113378685,21.106938775510205,21.0,32.0,180,1.0,172
865,423,231,19.89950113378685,22.291156462585036,21.0,31.0,218,2.0,192
866,423,499,19.89950113378685,21.43201814058957,21.0,22.0,101,2.0,76
867,423,443,19.89950113378685,22.84843537414966,21.0,21.0,129,3.0,20
868,423,617,19.89950113378685,21.292698412698414,21.0,18.0,203,1.0,194
869,423,615,19.89950113378685,22.871655328798187,21.0,14.0,231,3.0,192
870,423,844,19.89950113378685,21.292698412698414,21.0,10.0,425,1.0,421
871,423,879,19.89950113378685,22.291156462585036,21.0,7.0,467,2.0,456
872,446,199,20.24780045351474,21.61777777777778,22.0,23.0,254,1.0,247
873,446,67,20.24780045351474,22.709115646258503,22.0,28.0,394,2.0,379
874,446,231,20.24780045351474,22.291156462585036,22.0,31.0,232,2.0,215
875,446,499,20.24780045351474,21.43201814058957,22.0,22.0,74,1.0,53
876,446,443,20.24780045351474,22.84843537414966,22.0,21.0,112,3.0,3
877,446,465,20.24780045351474,22.98775510204082,22.0,20.0,120,3.0,19
878,446,617,20.24780045351474,21.292698412698414,22.0,18.0,177,1.0,171
879,446,615,20.24780045351474,22.871655328798187,22.0,14.0,203,3.0,169
880,446,844,20.24780045351474,21.292698412698414,22.0,10.0,401,1.0,398
881,446,879,20.24780045351474,22.291156462585036,22.0,7.0,442,2.0,433
882,499,67,21.43201814058957,22.709115646258503,22.0,28.0,435,1.0,432
883,499,158,21.43201814058957,23.45215419501134,22.0,30.0,352,2.0,341
884,499,231,21.43201814058957,23.777233560090703,22.0,31.0,286,2.0,268
885,499,245,21.43201814058957,24.171972789115646,22.0,30.0,280,3.0,254
886,499,443,21.43201814058957,22.84843537414966,22.0,21.0,83,1.0,56
887,499,465,21.43201814058957,22.98775510204082,22.0,20.0,75,2.0,34
888,499,615,21.43201814058957,22.871655328798187,22.0,14.0,132,1.0,116
889,499,629,21.43201814058957,23.75401360544218,22.0,13.0,164,2.0,130
890,499,847,21.43201814058957,23.75401360544218,22.0,6.0,362,2.0,348
891,443,71,22.84843537414966,24.543492063492064,21.0,24.0,379,2.0,372
892,443,160,22.84843537414966,25.240090702947846,21.0,26.0,301,2.0,283
893,443,245,22.84843537414966,24.171972789115646,21.0,30.0,206,1.0,198
894,443,231,22.84843537414966,25.240090702947846,21.0,33.0,236,2.0,212
895,443,412,22.84843537414966,24.961451247165535,21.0,18.0,96,2.0,31
896,443,625,22.84843537414966,24.86857142857143,21.0,10.0,202,2.0,182
897,443,630,22.84843537414966,25.240090702947846,21.0,13.0,213,2.0,187
898,443,868,22.84843537414966,24.86857142857143,21.0,6.0,434,2.0,425
899,443,848,22.84843537414966,25.240090702947846,21.0,6.0,418,2.0,405
900,465,71,22.98775510204082,24.543492063492064,20.0,24.0,400,2.0,394
901,465,160,22.98775510204082,25.240090702947846,20.0,26.0,320,2.0,305
902,465,245,22.98775510204082,24.171972789115646,20.0,30.0,226,1.0,220
903,465,231,22.98775510204082,25.240090702947846,20.0,33.0,253,2.0,234
904,465,412,22.98775510204082,24.961451247165535,20.0,18.0,100,2.0,53
905,465,443,22.98775510204082,25.240090702947846,20.0,20.0,99,2.0,22
906,465,625,22.98775510204082,24.86857142857143,20.0,10.0,179,2.0,160
907,465,630,22.98775510204082,25.240090702947846,20.0,13.0,191,2.0,165
908,465,868,22.98775510204082,24.86857142857143,20.0,6.0,411,2.0,403
909,465,848,22.98775510204082,25.240090702947846,20.0,6.0,395,2.0,383
910,412,66,24.961451247165535,26.076009070294784,18.0,29.0,349,1.0,346
911,412,158,24.961451247165535,27.608526077097505,18.0,28.0,278,3.0,254
912,412,231,24.961451247165535,26.70294784580499,18.0,30.0,196,2.0,181
913,412,278,24.961451247165535,27.933605442176873,18.0,23.0,185,3.0,134
914,412,467,24.961451247165535,26.563628117913833,18.0,24.0,88,2.0,55
915,412,458,24.961451247165535,27.58530612244898,18.0,18.0,122,3.0,46
916,412,617,24.961451247165535,26.540408163265308,18.0,15.0,216,2.0,205
917,412,625,24.961451247165535,27.16734693877551,18.0,10.0,233,2.0,213
918,412,869,24.961451247165535,26.51718820861678,18.0,5.0,462,2.0,457
919,412,869,24.961451247165535,27.12090702947846,18.0,7.0,466,2.0,457
920,443,158,25.240090702947846,27.608526077097505,20.0,28.0,303,2.0,285
921,443,231,25.240090702947846,26.70294784580499,20.0,30.0,221,1.0,212
922,443,278,25.240090702947846,27.933605442176873,20.0,23.0,202,3.0,165
923,443,232,25.240090702947846,28.18902494331066,20.0,31.0,246,3.0,211
924,443,467,25.240090702947846,26.563628117913833,20.0,24.0,62,1.0,24
925,443,458,25.240090702947846,27.58530612244898,20.0,18.0,102,2.0,15
926,443,423,25.240090702947846,28.18902494331066,20.0,21.0,129,3.0,20
927,443,617,25.240090702947846,26.540408163265308,20.0,15.0,183,1.0,174
928,443,625,25.240090702947846,27.16734693877551,20.0,10.0,200,2.0,182
929,443,626,25.240090702947846,28.18902494331066,20.0,12.0,223,3.0,183
930,443,869,25.240090702947846,26.51718820861678,20.0,5.0,430,1.0,426
931,443,869,25.240090702947846,27.12090702947846,20.0,7.0,434,2.0,426
932,443,846,25.240090702947846,28.16580498866213,20.0,7.0,422,3.0,403
933,467,158,26.563628117913833,27.608526077097505,24.0,28.0,312,1.0,309
934,467,78,26.563628117913833,28.95528344671202,24.0,26.0,402,2.0,389
935,467,278,26.563628117913833,27.933605442176873,24.0,23.0,198,1.0,189
936,467,232,26.563628117913833,28.18902494331066,24.0,31.0,245,2.0,235
937,467,458,26.563628117913833,27.58530612244898,24.0,18.0,45,1.0,9
938,467,423,26.563628117913833,28.18902494331066,24.0,21.0,83,2.0,44
939,467,454,26.563628117913833,29.489342403628118,24.0,24.0,127,3.0,13
940,467,626,26.563628117913833,28.18902494331066,24.0,12.0,174,2.0,159
941,467,616,26.563628117913833,29.512562358276643,24.0,15.0,196,3.0,149
942,467,846,26.563628117913833,28.16580498866213,24.0,7.0,385,2.0,379
943,467,867,26.563628117913833,29.466122448979593,24.0,6.0,419,3.0,400
944,458,78,27.58530612244898,28.95528344671202,18.0,26.0,385,1.0,380
945,458,78,27.58530612244898,29.744761904761905,18.0,31.0,391,2.0,380
946,458,231,27.58530612244898,29.651882086167802,18.0,30.0,244,2.0,227
947,458,454,27.58530612244898,29.489342403628118,18.0,24.0,82,2.0,4
948,458,465,27.58530612244898,30.534240362811794,18.0,24.0,127,3.0,7
949,458,616,27.58530612244898,29.512562358276643,18.0,15.0,178,2.0,158
950,458,631,27.58530612244898,30.511020408163265,18.0,18.0,214,3.0,173
951,458,867,27.58530612244898,29.466122448979593,18.0,6.0,417,2.0,409
952,458,851,27.58530612244898,30.534240362811794,18.0,9.0,413,3.0,393
953,423,78,28.18902494331066,29.744761904761905,21.0,31.0,351,2.0,345
954,423,175,28.18902494331066,30.859319727891158,21.0,27.0,273,3.0,248
955,423,231,28.18902494331066,29.651882086167802,21.0,30.0,202,1.0,192
956,423,266,28.18902494331066,30.78965986394558,21.0,30.0,193,3.0,157
957,423,454,28.18902494331066,29.489342403628118,21.0,24.0,64,1.0,31
958,423,465,28.18902494331066,30.534240362811794,21.0,24.0,109,2.0,42
959,423,455,28.18902494331066,31.02185941043084,21.0,26.0,126,3.0,32
960,423,616,28.18902494331066,29.512562358276643,21.0,15.0,201,1.0,193
961,423,631,28.18902494331066,30.511020408163265,21.0,18.0,231,2.0,208
962,423,625,28.18902494331066,31.02185941043084,21.0,15.0,236,3.0,202
963,423,867,28.18902494331066,29.466122448979593,21.0,6.0,447,1.0,444
964,423,851,28.18902494331066,30.534240362811794,21.0,9.0,440,2.0,428
965,454,175,29.489342403628118,30.859319727891158,24.0,27.0,285,1.0,279
966,454,160,29.489342403628118,31.67201814058957,24.0,25.0,309,2.0,294
967,454,70,29.489342403628118,32.27573696145125,24.0,30.0,402,3.0,384
968,454,266,29.489342403628118,30.78965986394558,24.0,30.0,196,1.0,188
969,454,250,29.489342403628118,31.532698412698412,24.0,31.0,222,2.0,204
970,454,465,29.489342403628118,30.534240362811794,24.0,24.0,46,1.0,11
971,454,455,29.489342403628118,31.02185941043084,24.0,26.0,66,2.0,1
972,454,631,29.489342403628118,30.511020408163265,24.0,18.0,182,1.0,177
973,454,625,29.489342403628118,31.02185941043084,24.0,15.0,183,2.0,171
974,454,618,29.489342403628118,32.46149659863946,24.0,16.0,208,3.0,164
975,454,851,29.489342403628118,30.534240362811794,24.0,9.0,400,1.0,397
976,454,848,29.489342403628118,31.67201814058957,24.0,6.0,405,2.0,394
977,465,160,30.534240362811794,31.67201814058957,24.0,25.0,309,1.0,305
978,465,70,30.534240362811794,32.27573696145125,24.0,30.0,402,2.0,395
979,465,193,30.534240362811794,33.3902947845805,24.0,25.0,299,3.0,272
980,465,232,30.534240362811794,32.60081632653061,24.0,32.0,249,2.0,233
981,465,220,30.534240362811794,33.50639455782313,24.0,26.0,276,3.0,245
982,465,463,30.534240362811794,32.48471655328798,24.0,24.0,84,2.0,2
983,465,618,30.534240362811794,32.46149659863946,24.0,16.0,174,2.0,153
984,465,848,30.534240362811794,31.67201814058957,24.0,6.0,386,1.0,383
985,465,861,30.534240362811794,32.507936507936506,24.0,6.0,405,2.0,396
986,455,70,31.02185941043084,32.27573696145125,26.0,30.0,389,1.0,385
987,455,193,31.02185941043084,33.3902947845805,26.0,25.0,281,2.0,262
988,455,232,31.02185941043084,32.60081632653061,26.0,32.0,233,2.0,223
989,455,220,31.02185941043084,33.50639455782313,26.0,26.0,258,2.0,235
990,455,463,31.02185941043084,32.48471655328798,26.0,24.0,64,1.0,8
991,455,482,31.02185941043084,33.97079365079365,26.0,22.0,130,3.0,27
992,455,482,31.02185941043084,33.99401360544218,26.0,22.0,131,3.0,27
993,455,618,31.02185941043084,32.46149659863946,26.0,16.0,174,1.0,163
994,455,615,31.02185941043084,33.97079365079365,26.0,11.0,204,3.0,160
995,455,627,31.02185941043084,33.99401360544218,26.0,11.0,214,3.0,172
996,455,861,31.02185941043084,32.507936507936506,26.0,6.0,411,1.0,406
997,455,856,31.02185941043084,33.761814058956915,26.0,9.0,418,3.0,401
998,455,848,31.02185941043084,33.99401360544218,26.0,8.0,413,3.0,393
999,463,70,32.48471655328798,34.13333333333333,24.0,30.0,399,2.0,393
1000,463,220,32.48471655328798,33.50639455782313,24.0,26.0,247,1.0,243
1001,463,231,32.48471655328798,34.06367346938776,24.0,30.0,242,2.0,232
1002,463,482,32.48471655328798,33.97079365079365,24.0,22.0,67,1.0,19
1003,463,482,32.48471655328798,33.99401360544218,24.0,22.0,68,2.0,19
1004,463,615,32.48471655328798,33.97079365079365,24.0,11.0,165,1.0,152
1005,463,627,32.48471655328798,33.99401360544218,24.0,11.0,176,2.0,164
1006,463,856,32.48471655328798,33.761814058956915,24.0,9.0,397,1.0,393
1007,463,848,32.48471655328798,33.99401360544218,24.0,8.0,390,2.0,385
1008,482,67,33.97079365079365,35.54975056689342,22.0,26.0,421,2.0,415
1009,482,191,33.97079365079365,36.385668934240364,22.0,31.0,309,2.0,291
1010,482,316,33.97079365079365,35.68907029478458,22.0,27.0,182,2.0,166
1011,482,234,33.97079365079365,36.89650793650794,22.0,28.0,278,3.0,248
1012,482,451,33.97079365079365,35.68907029478458,22.0,25.0,80,2.0,31
1013,482,508,33.97079365079365,36.57142857142857,22.0,25.0,115,3.0,26
1014,482,626,33.97079365079365,35.68907029478458,22.0,17.0,162,2.0,144
1015,482,630,33.97079365079365,36.57142857142857,22.0,14.0,186,3.0,148
1016,482,838,33.97079365079365,35.68907029478458,22.0,9.0,364,2.0,356
1017,482,860,33.97079365079365,36.57142857142857,22.0,12.0,394,3.0,378
1018,482,67,33.99401360544218,35.54975056689342,22.0,26.0,420,2.0,415
1019,482,191,33.99401360544218,36.385668934240364,22.0,31.0,309,2.0,291
1020,482,316,33.99401360544218,35.68907029478458,22.0,27.0,181,2.0,166
1021,482,234,33.99401360544218,36.89650793650794,22.0,28.0,278,3.0,248
1022,482,451,33.99401360544218,35.68907029478458,22.0,25.0,79,2.0,31
1023,482,508,33.99401360544218,36.57142857142857,22.0,25.0,114,3.0,26
1024,482,626,33.99401360544218,35.68907029478458,22.0,17.0,161,2.0,144
1025,482,630,33.99401360544218,36.57142857142857,22.0,14.0,185,3.0,148
1026,482,838,33.99401360544218,35.68907029478458,22.0,9.0,363,2.0,356
1027,482,860,33.99401360544218,36.57142857142857,22.0,12.0,394,3.0,378
1028,451,71,35.68907029478458,37.430566893424036,25.0,30.0,387,2.0,380
1029,451,174,35.68907029478458,38.47546485260771,25.0,27.0,302,3.0,277
1030,451,234,35.68907029478458,36.89650793650794,25.0,28.0,223,1.0,217
1031,451,231,35.68907029478458,37.01260770975057,25.0,32.0,227,1.0,220
1032,451,231,35.68907029478458,38.47546485260771,25.0,31.0,251,3.0,220
1033,451,423,35.68907029478458,37.01260770975057,25.0,20.0,64,1.0,28
1034,451,481,35.68907029478458,38.59156462585034,25.0,21.0,129,3.0,30
1035,451,630,35.68907029478458,36.989387755102044,25.0,15.0,188,1.0,179
1036,451,617,35.68907029478458,38.59156462585034,25.0,14.0,208,3.0,166
1037,451,846,35.68907029478458,37.54666666666667,25.0,7.0,403,2.0,395
1038,451,879,35.68907029478458,38.47546485260771,25.0,5.0,445,3.0,428
1039,508,174,36.57142857142857,38.47546485260771,25.0,27.0,344,2.0,334
1040,508,231,36.57142857142857,38.47546485260771,25.0,31.0,289,2.0,277
1041,508,481,36.57142857142857,38.59156462585034,25.0,21.0,91,2.0,27
1042,508,617,36.57142857142857,38.59156462585034,25.0,14.0,139,2.0,109
1043,508,625,36.57142857142857,39.19528344671202,25.0,14.0,163,3.0,117
1044,508,879,36.57142857142857,38.47546485260771,25.0,5.0,380,2.0,371
1045,423,174,37.01260770975057,38.47546485260771,20.0,27.0,257,1.0,249
1046,423,160,37.01260770975057,39.938321995464854,20.0,26.0,292,3.0,263
1047,423,231,37.01260770975057,38.47546485260771,20.0,31.0,202,1.0,192
1048,423,231,37.01260770975057,39.938321995464854,20.0,30.0,230,3.0,192
1049,423,481,37.01260770975057,38.59156462585034,20.0,21.0,89,2.0,58
1050,423,503,37.01260770975057,39.938321995464854,20.0,19.0,149,3.0,80
1051,423,617,37.01260770975057,38.59156462585034,20.0,14.0,206,2.0,194
1052,423,625,37.01260770975057,39.19528344671202,20.0,14.0,223,2.0,202
1053,423,879,37.01260770975057,38.47546485260771,20.0,5.0,460,1.0,456
1054,423,848,37.01260770975057,39.938321995464854,20.0,7.0,443,3.0,425
1055,481,160,38.59156462585034,39.938321995464854,21.0,26.0,326,1.0,321
1056,481,138,38.59156462585034,40.4259410430839,21.0,23.0,352,2.0,343
1057,481,231,38.59156462585034,39.938321995464854,21.0,30.0,257,1.0,250
1058,481,232,38.59156462585034,40.49560090702948,21.0,26.0,262,2.0,249
1059,481,254,38.59156462585034,41.40117913832199,21.0,29.0,257,3.0,227
1060,481,503,38.59156462585034,39.938321995464854,21.0,19.0,62,1.0,22
1061,481,503,38.59156462585034,40.24018140589569,21.0,22.0,74,2.0,22
1062,481,424,38.59156462585034,41.40117913832199,21.0,19.0,134,3.0,57
1063,481,630,38.59156462585034,40.24018140589569,21.0,16.0,165,2.0,149
1064,481,631,38.59156462585034,41.40117913832199,21.0,12.0,193,3.0,150
1065,481,848,38.59156462585034,39.938321995464854,21.0,7.0,372,1.0,367
1066,481,845,38.59156462585034,40.216961451247165,21.0,4.0,371,2.0,364
1067,481,849,38.59156462585034,41.424399092970525,21.0,6.0,388,3.0,368
1068,503,66,39.938321995464854,41.84235827664399,19.0,29.0,445,2.0,437
1069,503,160,39.938321995464854,42.887256235827664,19.0,28.0,366,3.0,343
1070,503,254,39.938321995464854,41.40117913832199,19.0,29.0,257,1.0,249
1071,503,254,39.938321995464854,42.887256235827664,19.0,29.0,280,3.0,249
1072,503,424,39.938321995464854,41.40117913832199,19.0,19.0,101,1.0,79
1073,503,419,39.938321995464854,42.887256235827664,19.0,18.0,152,3.0,84
1074,503,631,39.938321995464854,41.40117913832199,19.0,12.0,143,1.0,128
1075,503,627,39.938321995464854,42.887256235827664,19.0,12.0,177,3.0,124
1076,503,849,39.938321995464854,41.424399092970525,19.0,6.0,352,1.0,346
1077,503,868,39.938321995464854,42.887256235827664,19.0,6.0,386,3.0,365
1078,503,66,40.24018140589569,41.84235827664399,22.0,29.0,442,2.0,437
1079,503,160,40.24018140589569,42.887256235827664,22.0,28.0,361,3.0,343
1080,503,254,40.24018140589569,41.40117913832199,22.0,29.0,254,1.0,249
1081,503,254,40.24018140589569,42.887256235827664,22.0,29.0,274,3.0,249
1082,503,326,40.24018140589569,43.18911564625851,22.0,29.0,218,3.0,177
1083,503,424,40.24018140589569,41.40117913832199,22.0,19.0,93,1.0,79
1084,503,419,40.24018140589569,42.887256235827664,22.0,18.0,142,3.0,84
1085,503,472,40.24018140589569,43.21233560090703,22.0,25.0,132,3.0,31
1086,503,631,40.24018140589569,41.40117913832199,22.0,12.0,137,1.0,128
1087,503,627,40.24018140589569,42.887256235827664,22.0,12.0,168,3.0,124
1088,503,630,40.24018140589569,43.21233560090703,22.0,17.0,180,3.0,127
1089,503,849,40.24018140589569,41.424399092970525,22.0,6.0,350,1.0,346
1090,503,868,40.24018140589569,42.887256235827664,22.0,6.0,382,3.0,365
1091,424,160,41.40117913832199,42.887256235827664,19.0,28.0,272,1.0,264
1092,424,160,41.40117913832199,43.444535147392294,19.0,25.0,278,2.0,264
1093,424,160,41.40117913832199,44.373333333333335,19.0,25.0,293,3.0,264
1094,424,254,41.40117913832199,42.887256235827664,19.0,29.0,182,1.0,170
1095,424,326,41.40117913832199,43.18911564625851,19.0,29.0,125,2.0,98
1096,424,231,41.40117913832199,44.35011337868481,19.0,29.0,231,3.0,193
1097,424,419,41.40117913832199,42.887256235827664,19.0,18.0,64,1.0,5
1098,424,472,41.40117913832199,43.21233560090703,19.0,25.0,92,2.0,48
1099,424,487,41.40117913832199,44.0714739229025,19.0,25.0,131,3.0,63
1100,424,627,41.40117913832199,42.887256235827664,19.0,12.0,213,1.0,203
1101,424,630,41.40117913832199,43.21233560090703,19.0,17.0,220,2.0,206
1102,424,629,41.40117913832199,44.0714739229025,19.0,16.0,235,3.0,205
1103,424,868,41.40117913832199,42.887256235827664,19.0,6.0,449,1.0,444
1104,424,868,41.40117913832199,43.79283446712018,19.0,5.0,456,2.0,444
1105,424,851,41.40117913832199,44.09469387755102,19.0,8.0,442,3.0,427
1106,419,160,42.887256235827664,44.373333333333335,18.0,25.0,267,1.0,259
1107,419,160,42.887256235827664,45.836190476190474,18.0,26.0,288,3.0,259
1108,419,231,42.887256235827664,44.35011337868481,18.0,29.0,198,1.0,188
1109,419,232,42.887256235827664,45.836190476190474,18.0,30.0,226,3.0,187
1110,419,487,42.887256235827664,44.0714739229025,18.0,25.0,85,1.0,68
1111,419,489,42.887256235827664,45.069931972789114,18.0,26.0,117,2.0,70
1112,419,629,42.887256235827664,44.0714739229025,18.0,16.0,216,1.0,210
1113,419,625,42.887256235827664,45.069931972789114,18.0,17.0,226,2.0,206
1114,419,851,42.887256235827664,44.09469387755102,18.0,8.0,435,1.0,432
1115,419,868,42.887256235827664,45.46467120181406,18.0,5.0,463,3.0,449
1116,472,160,43.21233560090703,44.373333333333335,25.0,25.0,316,1.0,312
1117,472,160,43.21233560090703,45.836190476190474,25.0,26.0,332,3.0,312
1118,472,231,43.21233560090703,44.35011337868481,25.0,29.0,246,1.0,241
1119,472,232,43.21233560090703,45.836190476190474,25.0,30.0,265,3.0,240
1120,472,489,43.21233560090703,45.069931972789114,25.0,26.0,82,2.0,17
1121,472,625,43.21233560090703,45.069931972789114,25.0,17.0,173,2.0,153
1122,472,868,43.21233560090703,45.46467120181406,25.0,5.0,408,2.0,396
1123,472,868,43.21233560090703,46.18448979591837,25.0,5.0,416,3.0,396
1124,487,160,44.0714739229025,45.836190476190474,25.0,26.0,336,2.0,327
1125,487,160,44.0714739229025,46.393469387755104,25.0,22.0,342,2.0,327
1126,487,232,44.0714739229025,45.836190476190474,25.0,30.0,266,2.0,255
1127,487,231,44.0714739229025,46.37024943310658,25.0,26.0,274,2.0,256
1128,487,252,44.0714739229025,47.02040816326531,25.0,31.0,267,3.0,235
1129,487,423,44.0714739229025,46.37024943310658,25.0,20.0,118,2.0,64
1130,487,628,44.0714739229025,46.37024943310658,25.0,11.0,172,2.0,141
1131,487,868,44.0714739229025,45.46467120181406,25.0,5.0,386,1.0,381
1132,487,868,44.0714739229025,46.18448979591837,25.0,5.0,392,2.0,381
1133,489,160,45.069931972789114,46.393469387755104,26.0,22.0,334,1.0,329
1134,489,79,45.069931972789114,47.69378684807256,26.0,29.0,425,3.0,410
1135,489,231,45.069931972789114,46.37024943310658,26.0,26.0,264,1.0,258
1136,489,252,45.069931972789114,47.02040816326531,26.0,31.0,251,2.0,237
1137,489,423,45.069931972789114,46.37024943310658,26.0,20.0,87,1.0,66
1138,489,596,45.069931972789114,47.4615873015873,26.0,21.0,149,2.0,107
1139,489,628,45.069931972789114,46.37024943310658,26.0,11.0,150,1.0,139
1140,489,632,45.069931972789114,47.438367346938776,26.0,17.0,176,2.0,143
1141,489,868,45.069931972789114,46.18448979591837,26.0,5.0,382,1.0,379
1142,489,878,45.069931972789114,47.275827664399095,26.0,5.0,400,2.0,389
1143,423,79,46.37024943310658,47.69378684807256,20.0,29.0,349,1.0,344
1144,423,192,46.37024943310658,48.15818594104309,20.0,28.0,243,2.0,231
1145,423,236,46.37024943310658,48.15818594104309,20.0,30.0,202,2.0,187
1146,423,234,46.37024943310658,49.04054421768708,20.0,32.0,221,3.0,189
1147,423,596,46.37024943310658,47.4615873015873,20.0,21.0,179,1.0,173
1148,423,440,46.37024943310658,48.36716553287982,20.0,22.0,88,2.0,17
1149,423,632,46.37024943310658,47.438367346938776,20.0,17.0,214,1.0,209
1150,423,625,46.37024943310658,48.39038548752835,20.0,12.0,220,2.0,202
1151,423,852,46.37024943310658,48.36716553287982,20.0,14.0,438,2.0,429
1152,596,139,47.4615873015873,49.96934240362812,21.0,32.0,470,3.0,457
1153,596,234,47.4615873015873,49.04054421768708,21.0,32.0,368,2.0,362
1154,596,240,47.4615873015873,50.29442176870749,21.0,29.0,376,3.0,356
1155,596,458,47.4615873015873,49.96934240362812,21.0,18.0,175,3.0,138
1156,596,484,47.4615873015873,50.41052154195012,21.0,20.0,169,3.0,112
1157,596,616,47.4615873015873,49.946122448979594,21.0,3.0,109,2.0,20
1158,596,848,47.4615873015873,50.41052154195012,21.0,7.0,282,3.0,252
1159,440,139,48.36716553287982,49.96934240362812,22.0,32.0,309,2.0,301
1160,440,69,48.36716553287982,49.99256235827664,22.0,31.0,378,2.0,371
1161,440,155,48.36716553287982,51.08390022675737,22.0,30.0,308,3.0,285
1162,440,240,48.36716553287982,50.29442176870749,22.0,29.0,217,2.0,200
1163,440,243,48.36716553287982,51.06068027210885,22.0,27.0,229,3.0,197
1164,440,458,48.36716553287982,49.96934240362812,22.0,18.0,71,2.0,18
1165,440,484,48.36716553287982,50.41052154195012,22.0,20.0,98,2.0,44
1166,440,578,48.36716553287982,50.991020408163266,22.0,21.0,178,3.0,138
1167,440,616,48.36716553287982,49.946122448979594,22.0,3.0,189,2.0,176
1168,440,620,48.36716553287982,50.96780045351474,22.0,13.0,212,3.0,180
1169,440,617,48.36716553287982,50.991020408163266,22.0,15.0,210,3.0,177
1170,440,848,48.36716553287982,50.41052154195012,22.0,7.0,417,2.0,408
1171,458,155,49.96934240362812,51.08390022675737,18.0,30.0,307,1.0,303
1172,458,70,49.96934240362812,52.87183673469388,18.0,33.0,408,3.0,388
1173,458,243,49.96934240362812,51.06068027210885,18.0,27.0,220,1.0,215
1174,458,235,49.96934240362812,52.87183673469388,18.0,32.0,256,3.0,223
1175,458,578,49.96934240362812,50.991020408163266,18.0,21.0,128,1.0,120
1176,458,470,49.96934240362812,52.87183673469388,18.0,22.0,126,3.0,12
1177,458,617,49.96934240362812,50.991020408163266,18.0,15.0,165,1.0,159
1178,458,639,49.96934240362812,52.01269841269841,18.0,15.0,201,2.0,181
1179,458,822,49.96934240362812,52.03591836734694,18.0,4.0,375,2.0,364
1180,484,70,50.41052154195012,52.87183673469388,20.0,33.0,427,2.0,414
1181,484,235,50.41052154195012,52.87183673469388,20.0,32.0,271,2.0,249
1182,484,236,50.41052154195012,53.26657596371882,20.0,31.0,277,3.0,248
1183,484,470,50.41052154195012,52.87183673469388,20.0,22.0,107,2.0,14
1184,484,639,50.41052154195012,52.01269841269841,20.0,15.0,170,2.0,155
1185,484,822,50.41052154195012,52.03591836734694,20.0,4.0,345,2.0,338
1186,578,171,50.991020408163266,53.614875283446715,21.0,31.0,422,3.0,407
1187,578,235,50.991020408163266,52.87183673469388,21.0,32.0,352,2.0,343
1188,578,236,50.991020408163266,53.26657596371882,21.0,31.0,356,2.0,342
1189,578,470,50.991020408163266,52.87183673469388,21.0,22.0,135,2.0,108
1190,578,500,50.991020408163266,53.4291156462585,21.0,24.0,131,2.0,78
1191,578,639,50.991020408163266,52.01269841269841,21.0,15.0,75,1.0,61
1192,578,631,50.991020408163266,53.40589569160998,21.0,18.0,117,2.0,53
1193,578,822,50.991020408163266,52.03591836734694,21.0,4.0,248,1.0,244
1194,578,827,50.991020408163266,53.80063492063492,21.0,9.0,277,3.0,249
1195,470,162,52.87183673469388,53.98639455782313,22.0,29.0,312,1.0,308
1196,470,192,52.87183673469388,55.797551020408164,22.0,34.0,305,3.0,278
1197,470,247,52.87183673469388,54.05605442176871,22.0,23.0,229,1.0,223
1198,470,208,52.87183673469388,55.843990929705214,22.0,32.0,292,3.0,262
1199,470,442,52.87183673469388,54.96163265306122,22.0,20.0,94,2.0,28
1200,470,617,52.87183673469388,54.96163265306122,22.0,12.0,172,2.0,147
1201,470,625,52.87183673469388,55.00807256235828,22.0,12.0,180,2.0,155
1202,470,822,52.87183673469388,55.797551020408164,22.0,4.0,374,3.0,352
1203,500,192,53.4291156462585,55.797551020408164,24.0,34.0,324,2.0,308
1204,500,208,53.4291156462585,55.843990929705214,24.0,32.0,310,2.0,292
1205,500,209,53.4291156462585,56.401269841269844,24.0,31.0,318,3.0,291
1206,500,442,53.4291156462585,54.96163265306122,24.0,20.0,88,2.0,58
1207,500,457,53.4291156462585,55.867210884353746,24.0,27.0,113,2.0,43
1208,500,456,53.4291156462585,56.16907029478458,24.0,24.0,126,3.0,44
1209,500,617,53.4291156462585,54.96163265306122,24.0,12.0,134,2.0,117
1210,500,625,53.4291156462585,55.00807256235828,24.0,12.0,142,2.0,125
1211,500,822,53.4291156462585,55.797551020408164,24.0,4.0,338,2.0,322
1212,442,79,54.96163265306122,56.58702947845805,20.0,29.0,370,2.0,363
1213,442,175,54.96163265306122,57.283628117913835,20.0,32.0,285,2.0,267
1214,442,209,54.96163265306122,56.401269841269844,20.0,31.0,241,1.0,233
1215,442,233,54.96163265306122,57.42294784580499,20.0,26.0,234,2.0,209
1216,442,456,54.96163265306122,56.16907029478458,20.0,24.0,54,1.0,14
1217,442,484,54.96163265306122,57.330068027210885,20.0,24.0,110,2.0,42
1218,442,630,54.96163265306122,56.447709750566894,20.0,9.0,199,1.0,188
1219,442,617,54.96163265306122,57.330068027210885,20.0,8.0,203,2.0,175
1220,442,826,54.96163265306122,57.283628117913835,20.0,6.0,397,2.0,384
1221,457,175,55.867210884353746,57.283628117913835,27.0,32.0,289,1.0,282
1222,457,158,55.867210884353746,58.746485260770974,27.0,31.0,324,3.0,299
1223,457,233,55.867210884353746,57.42294784580499,27.0,26.0,234,2.0,224
1224,457,246,55.867210884353746,58.32852607709751,27.0,29.0,236,2.0,211
1225,457,484,55.867210884353746,57.330068027210885,27.0,24.0,69,1.0,27
1226,457,465,55.867210884353746,58.28208616780046,27.0,25.0,104,2.0,8
1227,457,617,55.867210884353746,57.330068027210885,27.0,8.0,172,1.0,160
1228,457,625,55.867210884353746,58.212426303854876,27.0,16.0,196,2.0,168
1229,457,826,55.867210884353746,57.283628117913835,27.0,6.0,374,1.0,369
1230,456,175,56.16907029478458,57.283628117913835,24.0,32.0,285,1.0,281
1231,456,158,56.16907029478458,58.746485260770974,24.0,31.0,318,3.0,298
1232,456,233,56.16907029478458,57.42294784580499,24.0,26.0,229,1.0,223
1233,456,246,56.16907029478458,58.32852607709751,24.0,29.0,230,2.0,210
1234,456,484,56.16907029478458,57.330068027210885,24.0,24.0,57,1.0,28
1235,456,465,56.16907029478458,58.28208616780046,24.0,25.0,91,2.0,9
1236,456,617,56.16907029478458,57.330068027210885,24.0,8.0,169,1.0,161
1237,456,625,56.16907029478458,58.212426303854876,24.0,16.0,191,2.0,169
1238,456,826,56.16907029478458,57.283628117913835,24.0,6.0,373,1.0,370
1239,484,158,57.330068027210885,58.746485260770974,24.0,31.0,332,1.0,326
1240,484,175,57.330068027210885,59.16444444444445,24.0,28.0,319,2.0,309
1241,484,246,57.330068027210885,59.303764172335605,24.0,31.0,253,2.0,238
1242,484,428,57.330068027210885,59.65206349206349,24.0,18.0,115,2.0,56
1243,484,624,57.330068027210885,59.97714285714286,24.0,11.0,181,3.0,140
1244,484,868,57.330068027210885,59.97714285714286,24.0,4.0,401,3.0,384
1245,465,246,58.28208616780046,59.303764172335605,25.0,31.0,223,1.0,219
1246,465,428,58.28208616780046,59.65206349206349,25.0,18.0,70,1.0,37
1247,465,624,58.28208616780046,59.97714285714286,25.0,11.0,175,2.0,159
1248,465,868,58.28208616780046,59.97714285714286,25.0,4.0,410,2.0,403
1249,615,159,11.19201814058957,13.467573696145125,17.0,27.0,466,2.0,456
1250,615,231,11.19201814058957,13.467573696145125,17.0,31.0,396,2.0,384
1251,615,231,11.19201814058957,14.02485260770975,17.0,31.0,403,3.0,384
1252,615,443,11.19201814058957,13.467573696145125,17.0,21.0,198,2.0,172
1253,615,617,11.19201814058957,12.654875283446712,17.0,18.0,63,1.0,2
1254,615,630,11.19201814058957,13.467573696145125,17.0,14.0,99,2.0,15
1255,615,868,11.19201814058957,12.585215419501134,17.0,15.0,260,1.0,253
1256,615,847,11.19201814058957,13.467573696145125,17.0,9.0,252,2.0,232
1257,617,231,12.654875283446712,14.02485260770975,18.0,31.0,390,1.0,386
1258,617,420,12.654875283446712,14.907210884353741,18.0,23.0,220,2.0,197
1259,617,616,12.654875283446712,14.512471655328799,18.0,18.0,80,2.0,1
1260,617,618,12.654875283446712,15.418049886621315,18.0,17.0,119,3.0,1
1261,617,846,12.654875283446712,14.489251700680272,18.0,11.0,242,2.0,229
1262,617,867,12.654875283446712,15.464489795918368,18.0,6.0,278,3.0,250
1263,630,160,13.467573696145125,16.416507936507937,14.0,27.0,487,3.0,470
1264,630,236,13.467573696145125,15.789569160997733,14.0,30.0,406,2.0,394
1265,630,231,13.467573696145125,16.416507936507937,14.0,31.0,419,3.0,399
1266,630,420,13.467573696145125,14.907210884353741,14.0,23.0,219,1.0,210
1267,630,410,13.467573696145125,15.928888888888888,14.0,24.0,244,2.0,220
1268,630,489,13.467573696145125,15.998548752834468,14.0,20.0,178,3.0,141
1269,630,616,13.467573696145125,14.512471655328799,14.0,18.0,47,1.0,14
1270,630,618,13.467573696145125,15.418049886621315,14.0,17.0,85,2.0,12
1271,630,626,13.467573696145125,16.416507936507937,14.0,12.0,127,3.0,4
1272,630,846,13.467573696145125,14.489251700680272,14.0,11.0,220,1.0,216
1273,630,867,13.467573696145125,15.464489795918368,14.0,6.0,252,2.0,237
1274,630,868,13.467573696145125,16.416507936507937,14.0,8.0,270,3.0,238
1275,616,160,14.512471655328799,16.416507936507937,18.0,27.0,463,2.0,456
1276,616,236,14.512471655328799,15.789569160997733,18.0,30.0,384,1.0,380
1277,616,231,14.512471655328799,16.416507936507937,18.0,31.0,394,2.0,385
1278,616,247,14.512471655328799,17.22920634920635,18.0,31.0,387,3.0,369
1279,616,410,14.512471655328799,15.928888888888888,18.0,24.0,215,1.0,206
1280,616,489,14.512471655328799,15.998548752834468,18.0,20.0,142,1.0,127
1281,616,626,14.512471655328799,16.416507936507937,18.0,12.0,83,2.0,10
1282,616,868,14.512471655328799,16.416507936507937,18.0,8.0,265,2.0,252
1283,618,247,15.418049886621315,17.22920634920635,17.0,31.0,379,2.0,371
1284,618,431,15.418049886621315,17.76326530612245,17.0,22.0,213,2.0,187
1285,618,631,15.418049886621315,17.740045351473924,17.0,12.0,101,2.0,13
1286,618,856,15.418049886621315,17.740045351473924,17.0,9.0,258,2.0,238
1287,618,869,15.418049886621315,18.29732426303855,17.0,6.0,280,3.0,251
1288,626,236,16.416507936507937,18.715283446712018,12.0,35.0,402,2.0,390
1289,626,231,16.416507936507937,19.365442176870747,12.0,31.0,415,3.0,395
1290,626,431,16.416507936507937,17.76326530612245,12.0,22.0,203,1.0,195
1291,626,476,16.416507936507937,18.901043083900227,12.0,24.0,184,2.0,150
1292,626,631,16.416507936507937,17.740045351473924,12.0,12.0,57,1.0,5
1293,626,616,16.416507936507937,18.83138321995465,12.0,13.0,104,2.0,10
1294,626,630,16.416507936507937,19.342222222222222,12.0,13.0,126,3.0,4
1295,626,856,16.416507936507937,17.740045351473924,12.0,9.0,237,1.0,230
1296,626,869,16.416507936507937,18.29732426303855,12.0,6.0,256,2.0,243
1297,631,194,17.740045351473924,20.154920634920636,12.0,33.0,449,2.0,437
1298,631,231,17.740045351473924,19.365442176870747,12.0,31.0,406,2.0,400
1299,631,260,17.740045351473924,20.17814058956916,12.0,32.0,386,2.0,371
1300,631,476,17.740045351473924,18.901043083900227,12.0,24.0,163,1.0,155
1301,631,423,17.740045351473924,19.89950113378685,12.0,21.0,228,2.0,208
1302,631,446,17.740045351473924,20.24780045351474,12.0,22.0,214,3.0,185
1303,631,616,17.740045351473924,18.83138321995465,12.0,13.0,49,1.0,15
1304,631,630,17.740045351473924,19.342222222222222,12.0,13.0,69,2.0,1
1305,631,628,17.740045351473924,20.36390022675737,12.0,15.0,113,3.0,3
1306,631,847,17.740045351473924,19.89950113378685,12.0,6.0,235,2.0,216
1307,631,861,17.740045351473924,20.712199546485262,12.0,7.0,263,3.0,230
1308,616,194,18.83138321995465,20.154920634920636,13.0,33.0,426,1.0,422
1309,616,199,18.83138321995465,21.61777777777778,13.0,23.0,434,3.0,417
1310,616,260,18.83138321995465,20.17814058956916,13.0,32.0,361,1.0,356
1311,616,251,18.83138321995465,21.106938775510205,13.0,32.0,378,2.0,365
1312,616,423,18.83138321995465,19.89950113378685,13.0,21.0,198,1.0,193
1313,616,446,18.83138321995465,20.24780045351474,13.0,22.0,181,1.0,170
1314,616,499,18.83138321995465,21.43201814058957,13.0,22.0,162,3.0,117
1315,616,628,18.83138321995465,20.36390022675737,13.0,15.0,67,2.0,12
1316,616,617,18.83138321995465,21.292698412698414,13.0,18.0,106,2.0,1
1317,616,847,18.83138321995465,19.89950113378685,13.0,6.0,236,1.0,231
1318,616,861,18.83138321995465,20.712199546485262,13.0,7.0,258,2.0,245
1319,616,844,18.83138321995465,21.292698412698414,13.0,10.0,251,2.0,228
1320,630,199,19.342222222222222,21.61777777777778,13.0,23.0,442,2.0,431
1321,630,251,19.342222222222222,21.106938775510205,13.0,32.0,387,2.0,379
1322,630,231,19.342222222222222,22.291156462585036,13.0,31.0,419,3.0,399
1323,630,499,19.342222222222222,21.43201814058957,13.0,22.0,159,2.0,131
1324,630,628,19.342222222222222,20.36390022675737,13.0,15.0,44,1.0,2
1325,630,617,19.342222222222222,21.292698412698414,13.0,18.0,85,2.0,13
1326,630,861,19.342222222222222,20.712199546485262,13.0,7.0,238,1.0,231
1327,630,844,19.342222222222222,21.292698412698414,13.0,10.0,230,2.0,214
1328,630,879,19.342222222222222,22.291156462585036,13.0,7.0,280,3.0,249
1329,628,199,20.36390022675737,21.61777777777778,15.0,23.0,432,1.0,429
1330,628,231,20.36390022675737,22.291156462585036,15.0,31.0,406,2.0,397
1331,628,499,20.36390022675737,21.43201814058957,15.0,22.0,137,1.0,129
1332,628,443,20.36390022675737,22.84843537414966,15.0,21.0,214,2.0,185
1333,628,465,20.36390022675737,22.98775510204082,15.0,20.0,198,3.0,163
1334,628,615,20.36390022675737,22.871655328798187,15.0,14.0,109,3.0,13
1335,628,879,20.36390022675737,22.291156462585036,15.0,7.0,264,2.0,251
1336,617,158,21.292698412698414,23.45215419501134,18.0,30.0,468,2.0,459
1337,617,231,21.292698412698414,23.777233560090703,18.0,31.0,401,2.0,386
1338,617,245,21.292698412698414,24.171972789115646,18.0,30.0,392,3.0,372
1339,617,443,21.292698412698414,22.84843537414966,18.0,21.0,186,2.0,174
1340,617,465,21.292698412698414,22.98775510204082,18.0,20.0,169,2.0,152
1341,617,615,21.292698412698414,22.871655328798187,18.0,14.0,68,2.0,2
1342,617,629,21.292698412698414,23.75401360544218,18.0,13.0,107,2.0,12
1343,617,847,21.292698412698414,23.75401360544218,18.0,6.0,253,2.0,230
1344,615,160,22.871655328798187,25.240090702947846,14.0,26.0,466,2.0,455
1345,615,245,22.871655328798187,24.171972789115646,14.0,30.0,374,1.0,370
1346,615,231,22.871655328798187,25.240090702947846,14.0,33.0,397,2.0,384
1347,615,412,22.871655328798187,24.961451247165535,14.0,18.0,222,2.0,203
1348,615,443,22.871655328798187,25.240090702947846,14.0,20.0,200,2.0,172
1349,615,625,22.871655328798187,24.86857142857143,14.0,10.0,87,2.0,10
1350,615,630,22.871655328798187,25.240090702947846,14.0,13.0,103,2.0,15
1351,615,868,22.871655328798187,24.86857142857143,14.0,6.0,267,2.0,253
1352,615,848,22.871655328798187,25.240090702947846,14.0,6.0,254,2.0,233
1353,629,160,23.75401360544218,25.240090702947846,13.0,26.0,473,1.0,469
1354,629,231,23.75401360544218,25.240090702947846,13.0,33.0,403,1.0,398
1355,629,231,23.75401360544218,26.70294784580499,13.0,30.0,418,3.0,398
1356,629,412,23.75401360544218,24.961451247165535,13.0,18.0,223,1.0,217
1357,629,443,23.75401360544218,25.240090702947846,13.0,20.0,197,1.0,186
1358,629,467,23.75401360544218,26.563628117913833,13.0,24.0,202,3.0,162
1359,629,625,23.75401360544218,24.86857142857143,13.0,10.0,48,1.0,4
1360,629,630,23.75401360544218,25.240090702947846,13.0,13.0,64,1.0,1
1361,629,617,23.75401360544218,26.540408163265308,13.0,15.0,121,3.0,12
1362,629,868,23.75401360544218,24.86857142857143,13.0,6.0,244,1.0,239
1363,629,848,23.75401360544218,25.240090702947846,13.0,6.0,228,1.0,219
1364,629,869,23.75401360544218,26.51718820861678,13.0,5.0,268,3.0,240
1365,625,158,24.86857142857143,27.608526077097505,10.0,28.0,482,3.0,467
1366,625,231,24.86857142857143,26.70294784580499,10.0,30.0,402,2.0,394
1367,625,467,24.86857142857143,26.563628117913833,10.0,24.0,174,2.0,158
1368,625,458,24.86857142857143,27.58530612244898,10.0,18.0,204,3.0,167
1369,625,617,24.86857142857143,26.540408163265308,10.0,15.0,72,2.0,8
1370,625,869,24.86857142857143,26.51718820861678,10.0,5.0,254,2.0,244
1371,625,869,24.86857142857143,27.12090702947846,10.0,7.0,263,2.0,244
1372,630,158,25.240090702947846,27.608526077097505,13.0,28.0,483,2.0,472
1373,630,231,25.240090702947846,26.70294784580499,13.0,30.0,404,1.0,399
1374,630,278,25.240090702947846,27.933605442176873,13.0,23.0,371,3.0,352
1375,630,232,25.240090702947846,28.18902494331066,13.0,31.0,418,3.0,398
1376,630,467,25.240090702947846,26.563628117913833,13.0,24.0,173,1.0,163
1377,630,458,25.240090702947846,27.58530612244898,13.0,18.0,199,2.0,172
1378,630,423,25.240090702947846,28.18902494331066,13.0,21.0,243,3.0,207
1379,630,617,25.240090702947846,26.540408163265308,13.0,15.0,57,1.0,13
1380,630,625,25.240090702947846,27.16734693877551,13.0,10.0,83,2.0,5
1381,630,626,25.240090702947846,28.18902494331066,13.0,12.0,127,3.0,4
1382,630,869,25.240090702947846,26.51718820861678,13.0,5.0,245,1.0,239
1383,630,869,25.240090702947846,27.12090702947846,13.0,7.0,252,2.0,239
1384,630,846,25.240090702947846,28.16580498866213,13.0,7.0,250,3.0,216
1385,617,158,26.540408163265308,27.608526077097505,15.0,28.0,461,1.0,459
1386,617,278,26.540408163265308,27.933605442176873,15.0,23.0,344,1.0,339
1387,617,232,26.540408163265308,28.18902494331066,15.0,31.0,391,2.0,385
1388,617,458,26.540408163265308,27.58530612244898,15.0,18.0,165,1.0,159
1389,617,423,26.540408163265308,28.18902494331066,15.0,21.0,207,2.0,194
1390,617,454,26.540408163265308,29.489342403628118,15.0,24.0,207,3.0,163
1391,617,626,26.540408163265308,28.18902494331066,15.0,12.0,72,2.0,9
1392,617,616,26.540408163265308,29.512562358276643,15.0,15.0,128,3.0,1
1393,617,846,26.540408163265308,28.16580498866213,15.0,7.0,239,2.0,229
1394,617,867,26.540408163265308,29.466122448979593,15.0,6.0,280,3.0,250
1395,625,232,27.16734693877551,28.18902494331066,10.0,31.0,395,1.0,393
1396,625,231,27.16734693877551,29.651882086167802,10.0,30.0,408,2.0,394
1397,625,423,27.16734693877551,28.18902494331066,10.0,21.0,207,1.0,202
1398,625,454,27.16734693877551,29.489342403628118,10.0,24.0,198,2.0,171
1399,625,626,27.16734693877551,28.18902494331066,10.0,12.0,44,1.0,1
1400,625,616,27.16734693877551,29.512562358276643,10.0,15.0,101,2.0,9
1401,625,867,27.16734693877551,29.466122448979593,10.0,6.0,261,2.0,242
1402,626,175,28.18902494331066,30.859319727891158,12.0,27.0,465,3.0,451
1403,626,231,28.18902494331066,29.651882086167802,12.0,30.0,400,1.0,395
1404,626,266,28.18902494331066,30.78965986394558,12.0,30.0,377,3.0,360
1405,626,454,28.18902494331066,29.489342403628118,12.0,24.0,181,1.0,172
1406,626,465,28.18902494331066,30.534240362811794,12.0,24.0,190,2.0,161
1407,626,455,28.18902494331066,31.02185941043084,12.0,26.0,210,3.0,171
1408,626,616,28.18902494331066,29.512562358276643,12.0,15.0,58,1.0,10
1409,626,631,28.18902494331066,30.511020408163265,12.0,18.0,100,2.0,5
1410,626,625,28.18902494331066,31.02185941043084,12.0,15.0,122,3.0,1
1411,626,867,28.18902494331066,29.466122448979593,12.0,6.0,247,1.0,241
1412,626,851,28.18902494331066,30.534240362811794,12.0,9.0,247,2.0,225
1413,616,175,29.512562358276643,30.859319727891158,15.0,27.0,445,1.0,441
1414,616,160,29.512562358276643,31.67201814058957,15.0,25.0,465,2.0,456
1415,616,266,29.512562358276643,30.78965986394558,15.0,30.0,354,1.0,350
1416,616,250,29.512562358276643,31.532698412698412,15.0,31.0,376,2.0,366
1417,616,465,29.512562358276643,30.534240362811794,15.0,24.0,157,1.0,151
1418,616,455,29.512562358276643,31.02185941043084,15.0,26.0,174,2.0,161
1419,616,463,29.512562358276643,32.48471655328798,15.0,24.0,199,3.0,153
1420,616,625,29.512562358276643,31.02185941043084,15.0,15.0,66,2.0,9
1421,616,618,29.512562358276643,32.46149659863946,15.0,16.0,127,3.0,2
1422,616,851,29.512562358276643,30.534240362811794,15.0,9.0,239,1.0,235
1423,616,848,29.512562358276643,31.67201814058957,15.0,6.0,250,2.0,232
1424,631,160,30.511020408163265,31.67201814058957,18.0,25.0,474,1.0,471
1425,631,193,30.511020408163265,33.3902947845805,18.0,25.0,455,3.0,438
1426,631,250,30.511020408163265,31.532698412698412,18.0,31.0,384,1.0,381
1427,631,232,30.511020408163265,32.60081632653061,18.0,32.0,409,2.0,399
1428,631,463,30.511020408163265,32.48471655328798,18.0,24.0,188,2.0,168
1429,631,618,30.511020408163265,32.46149659863946,18.0,16.0,85,2.0,13
1430,631,848,30.511020408163265,31.67201814058957,18.0,6.0,223,1.0,217
1431,631,861,30.511020408163265,32.507936507936506,18.0,6.0,246,2.0,230
1432,625,193,31.02185941043084,33.3902947845805,15.0,25.0,444,2.0,432
1433,625,232,31.02185941043084,32.60081632653061,15.0,32.0,399,2.0,393
1434,625,220,31.02185941043084,33.50639455782313,15.0,26.0,419,2.0,405
1435,625,463,31.02185941043084,32.48471655328798,15.0,24.0,174,1.0,162
1436,625,482,31.02185941043084,33.97079365079365,15.0,22.0,191,3.0,143
1437,625,482,31.02185941043084,33.99401360544218,15.0,22.0,192,3.0,143
1438,625,618,31.02185941043084,32.46149659863946,15.0,16.0,62,1.0,7
1439,625,615,31.02185941043084,33.97079365079365,15.0,11.0,127,3.0,10
1440,625,627,31.02185941043084,33.99401360544218,15.0,11.0,128,3.0,2
1441,625,861,31.02185941043084,32.507936507936506,15.0,6.0,245,1.0,236
1442,625,856,31.02185941043084,33.761814058956915,15.0,9.0,259,3.0,231
1443,625,848,31.02185941043084,33.99401360544218,15.0,8.0,257,3.0,223
1444,618,220,32.46149659863946,33.50639455782313,16.0,26.0,401,1.0,398
1445,618,231,32.46149659863946,34.06367346938776,16.0,30.0,393,2.0,387
1446,618,482,32.46149659863946,33.97079365079365,16.0,22.0,151,2.0,136
1447,618,482,32.46149659863946,33.99401360544218,16.0,22.0,151,2.0,136
1448,618,615,32.46149659863946,33.97079365079365,16.0,11.0,65,2.0,3
1449,618,627,32.46149659863946,33.99401360544218,16.0,11.0,67,2.0,9
1450,618,856,32.46149659863946,33.761814058956915,16.0,9.0,244,1.0,238
1451,618,848,32.46149659863946,33.99401360544218,16.0,8.0,239,2.0,230
1452,615,191,33.97079365079365,36.385668934240364,11.0,31.0,437,2.0,424
1453,615,316,33.97079365079365,35.68907029478458,11.0,27.0,308,2.0,299
1454,615,234,33.97079365079365,36.89650793650794,11.0,28.0,401,3.0,381
1455,615,451,33.97079365079365,35.68907029478458,11.0,25.0,180,2.0,164
1456,615,508,33.97079365079365,36.57142857142857,11.0,25.0,155,3.0,107
1457,615,626,33.97079365079365,35.68907029478458,11.0,17.0,75,2.0,11
1458,615,630,33.97079365079365,36.57142857142857,11.0,14.0,113,3.0,15
1459,615,838,33.97079365079365,35.68907029478458,11.0,9.0,235,2.0,223
1460,615,860,33.97079365079365,36.57142857142857,11.0,12.0,269,3.0,245
1461,627,191,33.99401360544218,36.385668934240364,11.0,31.0,448,2.0,436
1462,627,316,33.99401360544218,35.68907029478458,11.0,27.0,319,2.0,311
1463,627,234,33.99401360544218,36.89650793650794,11.0,28.0,412,3.0,393
1464,627,451,33.99401360544218,35.68907029478458,11.0,25.0,191,2.0,176
1465,627,508,33.99401360544218,36.57142857142857,11.0,25.0,163,3.0,119
1466,627,626,33.99401360544218,35.68907029478458,11.0,17.0,73,2.0,1
1467,627,630,33.99401360544218,36.57142857142857,11.0,14.0,111,3.0,3
1468,627,838,33.99401360544218,35.68907029478458,11.0,9.0,223,2.0,211
1469,627,860,33.99401360544218,36.57142857142857,11.0,12.0,258,3.0,233
1470,626,174,35.68907029478458,38.47546485260771,17.0,27.0,468,3.0,452
1471,626,234,35.68907029478458,36.89650793650794,17.0,28.0,395,1.0,392
1472,626,231,35.68907029478458,37.01260770975057,17.0,32.0,399,1.0,395
1473,626,231,35.68907029478458,38.47546485260771,17.0,31.0,413,3.0,395
1474,626,423,35.68907029478458,37.01260770975057,17.0,20.0,211,1.0,203
1475,626,481,35.68907029478458,38.59156462585034,17.0,21.0,191,3.0,145
1476,626,630,35.68907029478458,36.989387755102044,17.0,15.0,56,1.0,4
1477,626,617,35.68907029478458,38.59156462585034,17.0,14.0,125,3.0,9
1478,626,846,35.68907029478458,37.54666666666667,17.0,7.0,234,2.0,220
1479,626,879,35.68907029478458,38.47546485260771,17.0,5.0,280,3.0,253
1480,630,174,36.57142857142857,38.47546485260771,14.0,27.0,463,2.0,456
1481,630,231,36.57142857142857,38.47546485260771,14.0,31.0,407,2.0,399
1482,630,481,36.57142857142857,38.59156462585034,14.0,21.0,173,2.0,149
1483,630,617,36.57142857142857,38.59156462585034,14.0,14.0,88,2.0,13
1484,630,625,36.57142857142857,39.19528344671202,14.0,14.0,113,3.0,5
1485,630,879,36.57142857142857,38.47546485260771,14.0,5.0,262,2.0,249
1486,630,174,36.989387755102044,38.47546485260771,15.0,27.0,460,1.0,456
1487,630,160,36.989387755102044,39.938321995464854,15.0,26.0,487,3.0,470
1488,630,231,36.989387755102044,38.47546485260771,15.0,31.0,404,1.0,399
1489,630,231,36.989387755102044,39.938321995464854,15.0,30.0,419,3.0,399
1490,630,481,36.989387755102044,38.59156462585034,15.0,21.0,164,2.0,149
1491,630,503,36.989387755102044,39.938321995464854,15.0,19.0,180,3.0,127
1492,630,617,36.989387755102044,38.59156462585034,15.0,14.0,70,2.0,13
1493,630,625,36.989387755102044,39.19528344671202,15.0,14.0,95,2.0,5
1494,630,879,36.989387755102044,38.47546485260771,15.0,5.0,257,1.0,249
1495,630,848,36.989387755102044,39.938321995464854,15.0,7.0,252,3.0,218
1496,617,160,38.59156462585034,39.938321995464854,14.0,26.0,461,1.0,457
1497,617,138,38.59156462585034,40.4259410430839,14.0,23.0,485,2.0,479
1498,617,231,38.59156462585034,39.938321995464854,14.0,30.0,390,1.0,386
1499,617,232,38.59156462585034,40.49560090702948,14.0,26.0,394,2.0,385
1500,617,254,38.59156462585034,41.40117913832199,14.0,29.0,383,3.0,363
1501,617,503,38.59156462585034,39.938321995464854,14.0,19.0,128,1.0,114
1502,617,503,38.59156462585034,40.24018140589569,14.0,22.0,134,2.0,114
1503,617,424,38.59156462585034,41.40117913832199,14.0,19.0,228,3.0,193
1504,617,630,38.59156462585034,40.24018140589569,14.0,16.0,72,2.0,13
1505,617,631,38.59156462585034,41.40117913832199,14.0,12.0,122,3.0,14
1506,617,848,38.59156462585034,39.938321995464854,14.0,7.0,238,1.0,231
1507,617,845,38.59156462585034,40.216961451247165,14.0,4.0,239,2.0,228
1508,617,849,38.59156462585034,41.424399092970525,14.0,6.0,262,3.0,232
1509,625,138,39.19528344671202,40.4259410430839,14.0,23.0,490,1.0,487
1510,625,232,39.19528344671202,40.49560090702948,14.0,26.0,397,1.0,393
1511,625,254,39.19528344671202,41.40117913832199,14.0,29.0,383,2.0,371
1512,625,503,39.19528344671202,40.24018140589569,14.0,22.0,130,1.0,122
1513,625,424,39.19528344671202,41.40117913832199,14.0,19.0,222,2.0,201
1514,625,630,39.19528344671202,40.24018140589569,14.0,16.0,45,1.0,5
1515,625,631,39.19528344671202,41.40117913832199,14.0,12.0,95,2.0,6
1516,625,845,39.19528344671202,40.216961451247165,14.0,4.0,224,1.0,220
1517,625,849,39.19528344671202,41.424399092970525,14.0,6.0,244,2.0,224
1518,630,160,40.24018140589569,42.887256235827664,16.0,28.0,484,3.0,470
1519,630,254,40.24018140589569,41.40117913832199,16.0,29.0,379,1.0,376
1520,630,254,40.24018140589569,42.887256235827664,16.0,29.0,393,3.0,376
1521,630,326,40.24018140589569,43.18911564625851,16.0,29.0,329,3.0,304
1522,630,424,40.24018140589569,41.40117913832199,16.0,19.0,212,1.0,206
1523,630,419,40.24018140589569,42.887256235827664,16.0,18.0,240,3.0,211
1524,630,472,40.24018140589569,43.21233560090703,16.0,25.0,203,3.0,158
1525,630,631,40.24018140589569,41.40117913832199,16.0,12.0,50,1.0,1
1526,630,627,40.24018140589569,42.887256235827664,16.0,12.0,114,3.0,3
1527,630,849,40.24018140589569,41.424399092970525,16.0,6.0,225,1.0,219
1528,630,868,40.24018140589569,42.887256235827664,16.0,6.0,264,3.0,238
1529,631,160,41.40117913832199,42.887256235827664,12.0,28.0,475,1.0,471
1530,631,160,41.40117913832199,43.444535147392294,12.0,25.0,479,2.0,471
1531,631,160,41.40117913832199,44.373333333333335,12.0,25.0,488,3.0,471
1532,631,254,41.40117913832199,42.887256235827664,12.0,29.0,382,1.0,377
1533,631,326,41.40117913832199,43.18911564625851,12.0,29.0,315,2.0,305
1534,631,231,41.40117913832199,44.35011337868481,12.0,29.0,420,3.0,400
1535,631,419,41.40117913832199,42.887256235827664,12.0,18.0,221,1.0,212
1536,631,472,41.40117913832199,43.21233560090703,12.0,25.0,177,2.0,159
1537,631,487,41.40117913832199,44.0714739229025,12.0,25.0,184,3.0,144
1538,631,627,41.40117913832199,42.887256235827664,12.0,12.0,64,1.0,4
1539,631,630,41.40117913832199,43.21233560090703,12.0,17.0,78,2.0,1
1540,631,629,41.40117913832199,44.0714739229025,12.0,16.0,115,3.0,2
1541,631,868,41.40117913832199,42.887256235827664,12.0,6.0,245,1.0,237
1542,631,868,41.40117913832199,43.79283446712018,12.0,5.0,258,2.0,237
1543,631,851,41.40117913832199,44.09469387755102,12.0,8.0,249,3.0,220
1544,627,160,42.887256235827664,44.373333333333335,12.0,25.0,471,1.0,467
1545,627,160,42.887256235827664,45.836190476190474,12.0,26.0,484,3.0,467
1546,627,231,42.887256235827664,44.35011337868481,12.0,29.0,401,1.0,396
1547,627,232,42.887256235827664,45.836190476190474,12.0,30.0,415,3.0,395
1548,627,487,42.887256235827664,44.0714739229025,12.0,25.0,149,1.0,140
1549,627,489,42.887256235827664,45.069931972789114,12.0,26.0,167,2.0,138
1550,627,629,42.887256235827664,44.0714739229025,12.0,16.0,51,1.0,2
1551,627,625,42.887256235827664,45.069931972789114,12.0,17.0,94,2.0,2
1552,627,851,42.887256235827664,44.09469387755102,12.0,8.0,230,1.0,224
1553,627,868,42.887256235827664,45.46467120181406,12.0,5.0,265,3.0,241
1554,630,160,43.21233560090703,44.373333333333335,17.0,25.0,473,1.0,470
1555,630,160,43.21233560090703,45.836190476190474,17.0,26.0,483,3.0,470
1556,630,231,43.21233560090703,44.35011337868481,17.0,29.0,402,1.0,399
1557,630,232,43.21233560090703,45.836190476190474,17.0,30.0,414,3.0,398
1558,630,489,43.21233560090703,45.069931972789114,17.0,26.0,162,2.0,141
1559,630,625,43.21233560090703,45.069931972789114,17.0,17.0,80,2.0,5
1560,630,868,43.21233560090703,45.46467120181406,17.0,5.0,257,2.0,238
1561,630,868,43.21233560090703,46.18448979591837,17.0,5.0,270,3.0,238
1562,629,160,44.0714739229025,45.836190476190474,16.0,26.0,475,2.0,469
1563,629,160,44.0714739229025,46.393469387755104,16.0,22.0,480,2.0,469
1564,629,232,44.0714739229025,45.836190476190474,16.0,30.0,404,2.0,397
1565,629,231,44.0714739229025,46.37024943310658,16.0,26.0,410,2.0,398
1566,629,252,44.0714739229025,47.02040816326531,16.0,31.0,398,3.0,377
1567,629,423,44.0714739229025,46.37024943310658,16.0,20.0,229,2.0,206
1568,629,628,44.0714739229025,46.37024943310658,16.0,11.0,99,2.0,1
1569,629,868,44.0714739229025,45.46467120181406,16.0,5.0,246,1.0,239
1570,629,868,44.0714739229025,46.18448979591837,16.0,5.0,256,2.0,239
1571,625,160,45.069931972789114,46.393469387755104,17.0,22.0,468,1.0,465
1572,625,231,45.069931972789114,46.37024943310658,17.0,26.0,398,1.0,394
1573,625,252,45.069931972789114,47.02040816326531,17.0,31.0,382,2.0,373
1574,625,423,45.069931972789114,46.37024943310658,17.0,20.0,210,1.0,202
1575,625,596,45.069931972789114,47.4615873015873,17.0,21.0,107,2.0,29
1576,625,628,45.069931972789114,46.37024943310658,17.0,11.0,56,1.0,3
1577,625,632,45.069931972789114,47.438367346938776,17.0,17.0,102,2.0,7
1578,625,868,45.069931972789114,46.18448979591837,17.0,5.0,248,1.0,243
1579,625,878,45.069931972789114,47.275827664399095,17.0,5.0,270,2.0,253
1580,628,192,46.37024943310658,48.15818594104309,11.0,28.0,443,2.0,436
1581,628,236,46.37024943310658,48.15818594104309,11.0,30.0,399,2.0,392
1582,628,234,46.37024943310658,49.04054421768708,11.0,32.0,410,3.0,394
1583,628,596,46.37024943310658,47.4615873015873,11.0,21.0,57,1.0,32
1584,628,440,46.37024943310658,48.36716553287982,11.0,22.0,207,2.0,188
1585,628,632,46.37024943310658,47.438367346938776,11.0,17.0,46,1.0,4
1586,628,625,46.37024943310658,48.39038548752835,11.0,12.0,87,2.0,3
1587,628,852,46.37024943310658,48.36716553287982,11.0,14.0,240,2.0,224
1588,632,139,47.438367346938776,49.96934240362812,17.0,32.0,505,3.0,493
1589,632,234,47.438367346938776,49.04054421768708,17.0,32.0,404,2.0,398
1590,632,240,47.438367346938776,50.29442176870749,17.0,29.0,411,3.0,392
1591,632,458,47.438367346938776,49.96934240362812,17.0,18.0,205,3.0,174
1592,632,484,47.438367346938776,50.41052154195012,17.0,20.0,196,3.0,148
1593,632,616,47.438367346938776,49.946122448979594,17.0,3.0,109,3.0,16
1594,632,848,47.438367346938776,50.41052154195012,17.0,7.0,251,3.0,216
1595,625,139,48.39038548752835,49.96934240362812,12.0,32.0,491,2.0,486
1596,625,155,48.39038548752835,51.08390022675737,12.0,30.0,484,3.0,470
1597,625,240,48.39038548752835,50.29442176870749,12.0,29.0,394,2.0,385
1598,625,243,48.39038548752835,51.06068027210885,12.0,27.0,399,3.0,382
1599,625,458,48.39038548752835,49.96934240362812,12.0,18.0,180,2.0,167
1600,625,484,48.39038548752835,50.41052154195012,12.0,20.0,166,2.0,141
1601,625,578,48.39038548752835,50.991020408163266,12.0,21.0,121,3.0,47
1602,625,616,48.39038548752835,49.946122448979594,12.0,3.0,68,2.0,9
1603,625,620,48.39038548752835,50.96780045351474,12.0,13.0,111,3.0,5
1604,625,617,48.39038548752835,50.991020408163266,12.0,15.0,112,3.0,8
1605,625,848,48.39038548752835,50.41052154195012,12.0,7.0,239,2.0,223
1606,616,155,49.946122448979594,51.08390022675737,3.0,30.0,464,1.0,461
1607,616,243,49.946122448979594,51.06068027210885,3.0,27.0,376,1.0,373
1608,616,235,49.946122448979594,52.87183673469388,3.0,32.0,401,3.0,381
1609,616,578,49.946122448979594,50.991020408163266,3.0,21.0,59,1.0,38
1610,616,470,49.946122448979594,52.87183673469388,3.0,22.0,193,3.0,146
1611,616,620,49.946122448979594,50.96780045351474,3.0,13.0,44,1.0,4
1612,616,617,49.946122448979594,50.991020408163266,3.0,15.0,45,1.0,1
1613,616,639,49.946122448979594,52.01269841269841,3.0,15.0,92,2.0,23
1614,616,822,49.946122448979594,52.03591836734694,3.0,4.0,225,2.0,206
1615,620,171,50.96780045351474,53.614875283446715,13.0,31.0,463,3.0,449
1616,620,235,50.96780045351474,52.87183673469388,13.0,32.0,394,2.0,385
1617,620,236,50.96780045351474,53.26657596371882,13.0,31.0,397,2.0,384
1618,620,470,50.96780045351474,52.87183673469388,13.0,22.0,171,2.0,150
1619,620,500,50.96780045351474,53.4291156462585,13.0,24.0,160,2.0,120
1620,620,639,50.96780045351474,52.01269841269841,13.0,15.0,49,1.0,19
1621,620,631,50.96780045351474,53.40589569160998,13.0,18.0,106,2.0,11
1622,620,822,50.96780045351474,52.03591836734694,13.0,4.0,207,1.0,202
1623,620,827,50.96780045351474,53.80063492063492,13.0,9.0,240,3.0,207
1624,617,171,50.991020408163266,53.614875283446715,15.0,31.0,460,3.0,446
1625,617,235,50.991020408163266,52.87183673469388,15.0,32.0,390,2.0,382
1626,617,236,50.991020408163266,53.26657596371882,15.0,31.0,393,2.0,381
1627,617,470,50.991020408163266,52.87183673469388,15.0,22.0,168,2.0,147
1628,617,500,50.991020408163266,53.4291156462585,15.0,24.0,157,2.0,117
1629,617,639,50.991020408163266,52.01269841269841,15.0,15.0,49,1.0,22
1630,617,631,50.991020408163266,53.40589569160998,15.0,18.0,105,2.0,14
1631,617,822,50.991020408163266,52.03591836734694,15.0,4.0,210,1.0,205
1632,617,827,50.991020408163266,53.80063492063492,15.0,9.0,242,3.0,210
1633,639,171,52.01269841269841,53.614875283446715,15.0,31.0,473,2.0,468
1634,639,162,52.01269841269841,53.98639455782313,15.0,29.0,485,2.0,477
1635,639,236,52.01269841269841,53.26657596371882,15.0,31.0,407,1.0,403
1636,639,247,52.01269841269841,54.05605442176871,15.0,23.0,402,2.0,392
1637,639,500,52.01269841269841,53.4291156462585,15.0,24.0,152,1.0,139
1638,639,442,52.01269841269841,54.96163265306122,15.0,20.0,234,3.0,197
1639,639,631,52.01269841269841,53.40589569160998,15.0,18.0,61,1.0,8
1640,639,617,52.01269841269841,54.96163265306122,15.0,12.0,129,3.0,22
1641,639,827,52.01269841269841,53.80063492063492,15.0,9.0,203,2.0,188
1642,631,192,53.40589569160998,55.797551020408164,18.0,34.0,451,2.0,439
1643,631,208,53.40589569160998,55.843990929705214,18.0,32.0,436,2.0,423
1644,631,442,53.40589569160998,54.96163265306122,18.0,20.0,201,2.0,189
1645,631,457,53.40589569160998,55.867210884353746,18.0,27.0,204,2.0,174
1646,631,456,53.40589569160998,56.16907029478458,18.0,24.0,212,3.0,175
1647,631,617,53.40589569160998,54.96163265306122,18.0,12.0,68,2.0,14
1648,631,625,53.40589569160998,55.00807256235828,18.0,12.0,69,2.0,6
1649,631,822,53.40589569160998,55.797551020408164,18.0,4.0,217,2.0,191
1650,617,175,54.96163265306122,57.283628117913835,12.0,32.0,453,2.0,442
1651,617,209,54.96163265306122,56.401269841269844,12.0,31.0,413,1.0,408
1652,617,233,54.96163265306122,57.42294784580499,12.0,26.0,398,2.0,384
1653,617,456,54.96163265306122,56.16907029478458,12.0,24.0,169,1.0,161
1654,617,484,54.96163265306122,57.330068027210885,12.0,24.0,168,2.0,133
1655,617,630,54.96163265306122,56.447709750566894,12.0,9.0,65,1.0,13
1656,617,826,54.96163265306122,57.283628117913835,12.0,6.0,232,2.0,209
1657,625,175,55.00807256235828,57.283628117913835,12.0,32.0,461,2.0,450
1658,625,209,55.00807256235828,56.401269841269844,12.0,31.0,420,1.0,416
1659,625,233,55.00807256235828,57.42294784580499,12.0,26.0,406,2.0,392
1660,625,456,55.00807256235828,56.16907029478458,12.0,24.0,176,1.0,169
1661,625,484,55.00807256235828,57.330068027210885,12.0,24.0,173,2.0,141
1662,625,630,55.00807256235828,56.447709750566894,12.0,9.0,62,1.0,5
1663,625,617,55.00807256235828,57.330068027210885,12.0,8.0,100,2.0,8
1664,625,826,55.00807256235828,57.283628117913835,12.0,6.0,224,2.0,201
1665,630,158,56.447709750566894,58.746485260770974,9.0,31.0,482,2.0,472
1666,630,175,56.447709750566894,59.16444444444445,9.0,28.0,470,3.0,455
1667,630,246,56.447709750566894,58.32852607709751,9.0,29.0,392,2.0,384
1668,630,246,56.447709750566894,59.303764172335605,9.0,31.0,403,3.0,384
1669,630,465,56.447709750566894,58.28208616780046,9.0,25.0,183,2.0,165
1670,630,625,56.447709750566894,58.212426303854876,9.0,16.0,76,2.0,5
1671,617,158,57.330068027210885,58.746485260770974,8.0,31.0,463,1.0,459
1672,617,175,57.330068027210885,59.16444444444445,8.0,28.0,449,2.0,442
1673,617,246,57.330068027210885,59.303764172335605,8.0,31.0,381,2.0,371
1674,617,428,57.330068027210885,59.65206349206349,8.0,18.0,214,2.0,189
1675,617,624,57.330068027210885,59.97714285714286,8.0,11.0,114,3.0,7
1676,617,868,57.330068027210885,59.97714285714286,8.0,4.0,276,3.0,251
1677,625,246,58.212426303854876,59.303764172335605,16.0,31.0,382,1.0,379
1678,625,428,58.212426303854876,59.65206349206349,16.0,18.0,207,1.0,197
1679,625,624,58.212426303854876,59.97714285714286,16.0,11.0,76,2.0,1
1680,625,868,58.212426303854876,59.97714285714286,16.0,4.0,255,2.0,243
1681,869,443,11.215238095238096,13.467573696145125,4.0,21.0,437,2.0,426
1682,869,617,11.215238095238096,12.654875283446712,4.0,18.0,260,1.0,252
1683,869,630,11.215238095238096,13.467573696145125,4.0,14.0,258,2.0,239
1684,869,868,11.215238095238096,12.585215419501134,4.0,15.0,59,1.0,1
1685,869,847,11.215238095238096,13.467573696145125,4.0,9.0,99,2.0,22
1686,868,420,12.585215419501134,14.907210884353741,15.0,23.0,459,2.0,448
1687,868,616,12.585215419501134,14.512471655328799,15.0,18.0,265,2.0,252
1688,868,618,12.585215419501134,15.418049886621315,15.0,17.0,278,3.0,250
1689,868,846,12.585215419501134,14.489251700680272,15.0,11.0,85,2.0,22
1690,868,867,12.585215419501134,15.464489795918368,15.0,6.0,124,3.0,1
1691,847,420,13.467573696145125,14.907210884353741,9.0,23.0,431,1.0,427
1692,847,410,13.467573696145125,15.928888888888888,9.0,24.0,450,2.0,437
1693,847,489,13.467573696145125,15.998548752834468,9.0,20.0,374,3.0,358
1694,847,616,13.467573696145125,14.512471655328799,9.0,18.0,235,1.0,231
1695,847,618,13.467573696145125,15.418049886621315,9.0,17.0,244,2.0,229
1696,847,626,13.467573696145125,16.416507936507937,9.0,12.0,255,3.0,221
1697,847,846,13.467573696145125,14.489251700680272,9.0,11.0,44,1.0,1
1698,847,867,13.467573696145125,15.464489795918368,9.0,6.0,88,2.0,20
1699,847,868,13.467573696145125,16.416507936507937,9.0,8.0,129,3.0,21
1700,846,410,14.489251700680272,15.928888888888888,11.0,24.0,440,1.0,436
1701,846,489,14.489251700680272,15.998548752834468,11.0,20.0,363,2.0,357
1702,846,626,14.489251700680272,16.416507936507937,11.0,12.0,235,2.0,220
1703,846,868,14.489251700680272,16.416507936507937,11.0,8.0,86,2.0,22
1704,867,431,15.464489795918368,17.76326530612245,6.0,22.0,447,2.0,436
1705,867,631,15.464489795918368,17.740045351473924,6.0,12.0,256,2.0,236
1706,867,856,15.464489795918368,17.740045351473924,6.0,9.0,99,2.0,11
1707,867,869,15.464489795918368,18.29732426303855,6.0,6.0,122,3.0,2
1708,868,431,16.416507936507937,17.76326530612245,8.0,22.0,441,1.0,437
1709,868,476,16.416507936507937,18.901043083900227,8.0,24.0,406,2.0,392
1710,868,631,16.416507936507937,17.740045351473924,8.0,12.0,244,1.0,237
1711,868,616,16.416507936507937,18.83138321995465,8.0,13.0,273,2.0,252
1712,868,630,16.416507936507937,19.342222222222222,8.0,13.0,269,3.0,238
1713,868,856,16.416507936507937,17.740045351473924,8.0,9.0,58,1.0,12
1714,868,869,16.416507936507937,18.29732426303855,8.0,6.0,81,2.0,1
1715,856,476,17.740045351473924,18.901043083900227,9.0,24.0,383,1.0,380
1716,856,423,17.740045351473924,19.89950113378685,9.0,21.0,443,2.0,433
1717,856,446,17.740045351473924,20.24780045351474,9.0,22.0,424,3.0,410
1718,856,616,17.740045351473924,18.83138321995465,9.0,13.0,245,1.0,240
1719,856,630,17.740045351473924,19.342222222222222,9.0,13.0,236,2.0,226
1720,856,628,17.740045351473924,20.36390022675737,9.0,15.0,254,3.0,228
1721,856,847,17.740045351473924,19.89950113378685,9.0,6.0,93,2.0,9
1722,856,861,17.740045351473924,20.712199546485262,9.0,7.0,128,3.0,5
1723,869,423,18.29732426303855,19.89950113378685,6.0,21.0,451,2.0,446
1724,869,446,18.29732426303855,20.24780045351474,6.0,22.0,431,2.0,423
1725,869,630,18.29732426303855,19.342222222222222,6.0,13.0,243,1.0,239
1726,869,628,18.29732426303855,20.36390022675737,6.0,15.0,257,2.0,241
1727,869,847,18.29732426303855,19.89950113378685,6.0,6.0,72,2.0,22
1728,869,861,18.29732426303855,20.712199546485262,6.0,7.0,104,2.0,8
1729,847,499,19.89950113378685,21.43201814058957,6.0,22.0,354,2.0,348
1730,847,443,19.89950113378685,22.84843537414966,6.0,21.0,423,3.0,404
1731,847,617,19.89950113378685,21.292698412698414,6.0,18.0,238,1.0,230
1732,847,615,19.89950113378685,22.871655328798187,6.0,14.0,265,3.0,232
1733,847,844,19.89950113378685,21.292698412698414,6.0,10.0,60,1.0,3
1734,847,879,19.89950113378685,22.291156462585036,6.0,7.0,108,2.0,32
1735,861,443,20.712199546485262,22.84843537414966,7.0,21.0,428,2.0,418
1736,861,465,20.712199546485262,22.98775510204082,7.0,20.0,408,2.0,396
1737,861,615,20.712199546485262,22.871655328798187,7.0,14.0,263,2.0,246
1738,861,879,20.712199546485262,22.291156462585036,7.0,7.0,70,2.0,18
1739,844,443,21.292698412698414,22.84843537414966,10.0,21.0,407,2.0,401
1740,844,465,21.292698412698414,22.98775510204082,10.0,20.0,386,2.0,379
1741,844,615,21.292698412698414,22.871655328798187,10.0,14.0,239,2.0,229
1742,844,629,21.292698412698414,23.75401360544218,10.0,13.0,240,2.0,215
1743,844,847,21.292698412698414,23.75401360544218,10.0,6.0,106,2.0,3
1744,879,412,22.291156462585036,24.961451247165535,7.0,18.0,481,3.0,467
1745,879,443,22.291156462585036,25.240090702947846,7.0,20.0,454,3.0,436
1746,879,629,22.291156462585036,23.75401360544218,7.0,13.0,258,1.0,250
1747,879,625,22.291156462585036,24.86857142857143,7.0,10.0,277,3.0,254
1748,879,630,22.291156462585036,25.240090702947846,7.0,13.0,280,3.0,249
1749,879,847,22.291156462585036,23.75401360544218,7.0,6.0,71,1.0,32
1750,879,868,22.291156462585036,24.86857142857143,7.0,6.0,112,3.0,11
1751,879,848,22.291156462585036,25.240090702947846,7.0,6.0,131,3.0,31
1752,847,412,23.75401360544218,24.961451247165535,6.0,18.0,438,1.0,435
1753,847,443,23.75401360544218,25.240090702947846,6.0,20.0,409,1.0,404
1754,847,467,23.75401360544218,26.563628117913833,6.0,24.0,399,3.0,380
1755,847,625,23.75401360544218,24.86857142857143,6.0,10.0,227,1.0,222
1756,847,630,23.75401360544218,25.240090702947846,6.0,13.0,226,1.0,217
1757,847,617,23.75401360544218,26.540408163265308,6.0,15.0,259,3.0,230
1758,847,868,23.75401360544218,24.86857142857143,6.0,6.0,52,1.0,21
1759,847,848,23.75401360544218,25.240090702947846,6.0,6.0,64,1.0,1
1760,847,869,23.75401360544218,26.51718820861678,6.0,5.0,121,3.0,22
1761,868,467,24.86857142857143,26.563628117913833,6.0,24.0,408,2.0,401
1762,868,458,24.86857142857143,27.58530612244898,6.0,18.0,426,3.0,410
1763,868,617,24.86857142857143,26.540408163265308,6.0,15.0,261,2.0,251
1764,868,625,24.86857142857143,27.16734693877551,6.0,10.0,262,2.0,243
1765,868,869,24.86857142857143,26.51718820861678,6.0,5.0,71,2.0,1
1766,868,869,24.86857142857143,27.12090702947846,6.0,7.0,97,2.0,1
1767,848,467,25.240090702947846,26.563628117913833,6.0,24.0,385,1.0,381
1768,848,458,25.240090702947846,27.58530612244898,6.0,18.0,403,2.0,390
1769,848,423,25.240090702947846,28.18902494331066,6.0,21.0,444,3.0,425
1770,848,617,25.240090702947846,26.540408163265308,6.0,15.0,238,1.0,231
1771,848,625,25.240090702947846,27.16734693877551,6.0,10.0,238,2.0,223
1772,848,626,25.240090702947846,28.18902494331066,6.0,12.0,256,3.0,222
1773,848,869,25.240090702947846,26.51718820861678,6.0,5.0,59,1.0,21
1774,848,869,25.240090702947846,27.12090702947846,6.0,7.0,84,2.0,21
1775,848,846,25.240090702947846,28.16580498866213,6.0,7.0,126,3.0,2
1776,869,458,26.51718820861678,27.58530612244898,5.0,18.0,414,1.0,411
1777,869,423,26.51718820861678,28.18902494331066,5.0,21.0,452,2.0,446
1778,869,454,26.51718820861678,29.489342403628118,5.0,24.0,434,3.0,415
1779,869,626,26.51718820861678,28.18902494331066,5.0,12.0,253,2.0,243
1780,869,846,26.51718820861678,28.16580498866213,5.0,7.0,75,2.0,23
1781,869,867,26.51718820861678,29.466122448979593,5.0,6.0,127,3.0,2
1782,869,423,27.12090702947846,28.18902494331066,7.0,21.0,448,1.0,446
1783,869,454,27.12090702947846,29.489342403628118,7.0,24.0,427,2.0,415
1784,869,626,27.12090702947846,28.18902494331066,7.0,12.0,247,1.0,243
1785,869,616,27.12090702947846,29.512562358276643,7.0,15.0,273,2.0,253
1786,869,846,27.12090702947846,28.16580498866213,7.0,7.0,51,1.0,23
1787,869,867,27.12090702947846,29.466122448979593,7.0,6.0,101,2.0,2
1788,846,454,28.16580498866213,29.489342403628118,7.0,24.0,396,1.0,392
1789,846,465,28.16580498866213,30.534240362811794,7.0,24.0,394,2.0,381
1790,846,455,28.16580498866213,31.02185941043084,7.0,26.0,410,3.0,391
1791,846,616,28.16580498866213,29.512562358276643,7.0,15.0,237,1.0,230
1792,846,631,28.16580498866213,30.511020408163265,7.0,18.0,238,2.0,215
1793,846,625,28.16580498866213,31.02185941043084,7.0,15.0,253,3.0,221
1794,846,867,28.16580498866213,29.466122448979593,7.0,6.0,60,1.0,21
1795,846,851,28.16580498866213,30.534240362811794,7.0,9.0,102,2.0,5
1796,867,465,29.466122448979593,30.534240362811794,6.0,24.0,405,1.0,402
1797,867,455,29.466122448979593,31.02185941043084,6.0,26.0,417,2.0,412
1798,867,631,29.466122448979593,30.511020408163265,6.0,18.0,240,1.0,236
1799,867,625,29.466122448979593,31.02185941043084,6.0,15.0,251,2.0,242
1800,867,851,29.466122448979593,30.534240362811794,6.0,9.0,49,1.0,16
1801,867,848,29.466122448979593,31.67201814058957,6.0,6.0,97,2.0,19
1802,851,463,30.534240362811794,32.48471655328798,9.0,24.0,397,2.0,388
1803,851,618,30.534240362811794,32.46149659863946,9.0,16.0,247,2.0,233
1804,851,848,30.534240362811794,31.67201814058957,9.0,6.0,49,1.0,3
1805,851,861,30.534240362811794,32.507936507936506,9.0,6.0,86,2.0,10
1806,848,482,31.67201814058957,33.97079365079365,6.0,22.0,379,2.0,366
1807,848,482,31.67201814058957,33.99401360544218,6.0,22.0,379,2.0,366
1808,848,615,31.67201814058957,33.97079365079365,6.0,11.0,253,2.0,233
1809,848,627,31.67201814058957,33.99401360544218,6.0,11.0,243,2.0,221
1810,848,856,31.67201814058957,33.761814058956915,6.0,9.0,90,2.0,8
1811,861,482,32.507936507936506,33.97079365079365,6.0,22.0,384,1.0,379
1812,861,482,32.507936507936506,33.99401360544218,6.0,22.0,384,1.0,379
1813,861,615,32.507936507936506,33.97079365079365,6.0,11.0,254,1.0,246
1814,861,627,32.507936507936506,33.99401360544218,6.0,11.0,243,1.0,234
1815,861,856,32.507936507936506,33.761814058956915,6.0,9.0,54,1.0,5
1816,861,848,32.507936507936506,33.99401360544218,6.0,8.0,65,1.0,13
1817,856,451,33.761814058956915,35.68907029478458,9.0,25.0,413,2.0,405
1818,856,508,33.761814058956915,36.57142857142857,9.0,25.0,368,3.0,348
1819,856,626,33.761814058956915,35.68907029478458,9.0,17.0,245,2.0,230
1820,856,630,33.761814058956915,36.57142857142857,9.0,14.0,256,3.0,226
1821,856,838,33.761814058956915,35.68907029478458,9.0,9.0,85,2.0,18
1822,856,860,33.761814058956915,36.57142857142857,9.0,12.0,121,3.0,4
1823,848,451,33.99401360544218,35.68907029478458,8.0,25.0,404,2.0,397
1824,848,508,33.99401360544218,36.57142857142857,8.0,25.0,358,3.0,340
1825,848,626,33.99401360544218,35.68907029478458,8.0,17.0,234,2.0,222
1826,848,630,33.99401360544218,36.57142857142857,8.0,14.0,245,3.0,218
1827,848,838,33.99401360544218,35.68907029478458,8.0,9.0,74,2.0,10
1828,848,860,33.99401360544218,36.57142857142857,8.0,12.0,112,3.0,12
1829,838,423,35.68907029478458,37.01260770975057,9.0,20.0,419,1.0,415
1830,838,481,35.68907029478458,38.59156462585034,9.0,21.0,378,3.0,357
1831,838,630,35.68907029478458,36.989387755102044,9.0,15.0,215,1.0,208
1832,838,617,35.68907029478458,38.59156462585034,9.0,14.0,254,3.0,221
1833,838,846,35.68907029478458,37.54666666666667,9.0,7.0,80,2.0,8
1834,838,879,35.68907029478458,38.47546485260771,9.0,5.0,127,3.0,41
1835,860,481,36.57142857142857,38.59156462585034,12.0,21.0,389,2.0,379
1836,860,617,36.57142857142857,38.59156462585034,12.0,14.0,258,2.0,243
1837,860,625,36.57142857142857,39.19528344671202,12.0,14.0,261,3.0,235
1838,860,879,36.57142857142857,38.47546485260771,12.0,5.0,84,2.0,19
1839,846,481,37.54666666666667,38.59156462585034,7.0,21.0,368,1.0,365
1840,846,503,37.54666666666667,39.938321995464854,7.0,19.0,358,2.0,343
1841,846,503,37.54666666666667,40.24018140589569,7.0,22.0,362,3.0,343
1842,846,617,37.54666666666667,38.59156462585034,7.0,14.0,233,1.0,229
1843,846,625,37.54666666666667,39.19528344671202,7.0,14.0,232,2.0,221
1844,846,630,37.54666666666667,40.24018140589569,7.0,16.0,245,3.0,216
1845,846,848,37.54666666666667,39.938321995464854,7.0,7.0,103,2.0,2
1846,846,845,37.54666666666667,40.216961451247165,7.0,4.0,115,3.0,1
1847,879,503,38.47546485260771,39.938321995464854,5.0,19.0,381,1.0,376
1848,879,503,38.47546485260771,40.24018140589569,5.0,22.0,384,2.0,376
1849,879,424,38.47546485260771,41.40117913832199,5.0,19.0,472,3.0,455
1850,879,630,38.47546485260771,40.24018140589569,5.0,16.0,260,2.0,249
1851,879,631,38.47546485260771,41.40117913832199,5.0,12.0,278,3.0,248
1852,879,848,38.47546485260771,39.938321995464854,5.0,7.0,70,1.0,31
1853,879,845,38.47546485260771,40.216961451247165,5.0,4.0,82,2.0,34
1854,879,849,38.47546485260771,41.424399092970525,5.0,6.0,130,3.0,30
1855,848,424,39.938321995464854,41.40117913832199,7.0,19.0,429,1.0,424
1856,848,419,39.938321995464854,42.887256235827664,7.0,18.0,447,3.0,429
1857,848,631,39.938321995464854,41.40117913832199,7.0,12.0,226,1.0,217
1858,848,627,39.938321995464854,42.887256235827664,7.0,12.0,255,3.0,221
1859,848,849,39.938321995464854,41.424399092970525,7.0,6.0,64,1.0,1
1860,848,868,39.938321995464854,42.887256235827664,7.0,6.0,129,3.0,20
1861,845,424,40.216961451247165,41.40117913832199,4.0,19.0,424,1.0,421
1862,845,419,40.216961451247165,42.887256235827664,4.0,18.0,441,3.0,426
1863,845,631,40.216961451247165,41.40117913832199,4.0,12.0,220,1.0,214
1864,845,627,40.216961451247165,42.887256235827664,4.0,12.0,246,3.0,218
1865,845,849,40.216961451247165,41.424399092970525,4.0,6.0,52,1.0,4
1866,845,868,40.216961451247165,42.887256235827664,4.0,6.0,117,3.0,23
1867,849,419,41.424399092970525,42.887256235827664,6.0,18.0,435,1.0,430
1868,849,472,41.424399092970525,43.21233560090703,6.0,25.0,385,2.0,377
1869,849,487,41.424399092970525,44.0714739229025,6.0,25.0,380,3.0,362
1870,849,627,41.424399092970525,42.887256235827664,6.0,12.0,231,1.0,222
1871,849,630,41.424399092970525,43.21233560090703,6.0,17.0,232,2.0,219
1872,849,629,41.424399092970525,44.0714739229025,6.0,16.0,248,3.0,220
1873,849,868,41.424399092970525,42.887256235827664,6.0,6.0,66,1.0,19
1874,849,868,41.424399092970525,43.79283446712018,6.0,5.0,104,2.0,19
1875,849,851,41.424399092970525,44.09469387755102,6.0,8.0,115,3.0,2
1876,868,487,42.887256235827664,44.0714739229025,6.0,25.0,384,1.0,381
1877,868,489,42.887256235827664,45.069931972789114,6.0,26.0,390,2.0,379
1878,868,629,42.887256235827664,44.0714739229025,6.0,16.0,244,1.0,239
1879,868,625,42.887256235827664,45.069931972789114,6.0,17.0,261,2.0,243
1880,868,851,42.887256235827664,44.09469387755102,6.0,8.0,55,1.0,17
1881,868,489,43.79283446712018,45.069931972789114,5.0,26.0,383,1.0,379
1882,868,423,43.79283446712018,46.37024943310658,5.0,20.0,459,3.0,445
1883,868,625,43.79283446712018,45.069931972789114,5.0,17.0,249,1.0,243
1884,868,628,43.79283446712018,46.37024943310658,5.0,11.0,264,3.0,240
1885,851,423,44.09469387755102,46.37024943310658,8.0,20.0,439,2.0,428
1886,851,628,44.09469387755102,46.37024943310658,8.0,11.0,244,2.0,223
1887,851,868,44.09469387755102,45.46467120181406,8.0,5.0,61,1.0,17
1888,851,868,44.09469387755102,46.18448979591837,8.0,5.0,92,2.0,17
1889,868,596,45.46467120181406,47.4615873015873,5.0,21.0,285,2.0,272
1890,868,440,45.46467120181406,48.36716553287982,5.0,22.0,446,3.0,428
1891,868,632,45.46467120181406,47.438367346938776,5.0,17.0,251,2.0,236
1892,868,625,45.46467120181406,48.39038548752835,5.0,12.0,274,3.0,243
1893,868,878,45.46467120181406,47.275827664399095,5.0,5.0,79,2.0,10
1894,868,852,45.46467120181406,48.36716553287982,5.0,14.0,126,3.0,16
1895,868,596,46.18448979591837,47.4615873015873,5.0,21.0,278,1.0,272
1896,868,440,46.18448979591837,48.36716553287982,5.0,22.0,438,2.0,428
1897,868,632,46.18448979591837,47.438367346938776,5.0,17.0,242,1.0,236
1898,868,625,46.18448979591837,48.39038548752835,5.0,12.0,261,2.0,243
1899,868,878,46.18448979591837,47.275827664399095,5.0,5.0,48,1.0,10
1900,868,852,46.18448979591837,48.36716553287982,5.0,14.0,95,2.0,16
1901,878,440,47.275827664399095,48.36716553287982,5.0,22.0,441,1.0,438
1902,878,458,47.275827664399095,49.96934240362812,5.0,18.0,436,3.0,420
1903,878,625,47.275827664399095,48.39038548752835,5.0,12.0,258,1.0,253
1904,878,616,47.275827664399095,49.946122448979594,5.0,3.0,286,3.0,262
1905,878,852,47.275827664399095,48.36716553287982,5.0,14.0,54,1.0,26
1906,852,458,48.36716553287982,49.96934240362812,14.0,18.0,400,2.0,394
1907,852,484,48.36716553287982,50.41052154195012,14.0,20.0,378,2.0,368
1908,852,578,48.36716553287982,50.991020408163266,14.0,21.0,296,3.0,274
1909,852,616,48.36716553287982,49.946122448979594,14.0,3.0,246,2.0,236
1910,852,620,48.36716553287982,50.96780045351474,14.0,13.0,258,3.0,232
1911,852,617,48.36716553287982,50.991020408163266,14.0,15.0,261,3.0,235
1912,852,848,48.36716553287982,50.41052154195012,14.0,7.0,88,2.0,4
1913,848,470,50.41052154195012,52.87183673469388,7.0,22.0,393,2.0,378
1914,848,639,50.41052154195012,52.01269841269841,7.0,15.0,220,2.0,209
1915,848,822,50.41052154195012,52.03591836734694,7.0,4.0,75,2.0,26
1916,822,500,52.03591836734694,53.4291156462585,4.0,24.0,328,1.0,322
1917,822,442,52.03591836734694,54.96163265306122,4.0,20.0,400,3.0,380
1918,822,631,52.03591836734694,53.40589569160998,4.0,18.0,200,1.0,191
1919,822,617,52.03591836734694,54.96163265306122,4.0,12.0,241,3.0,205
1920,822,625,52.03591836734694,55.00807256235828,4.0,12.0,235,3.0,197
1921,822,827,52.03591836734694,53.80063492063492,4.0,9.0,76,2.0,5
1922,827,442,53.80063492063492,54.96163265306122,9.0,20.0,388,1.0,385
1923,827,457,53.80063492063492,55.867210884353746,9.0,27.0,381,2.0,370
1924,827,456,53.80063492063492,56.16907029478458,9.0,24.0,385,2.0,371
1925,827,617,53.80063492063492,54.96163265306122,9.0,12.0,216,1.0,210
1926,827,625,53.80063492063492,55.00807256235828,9.0,12.0,209,1.0,202
1927,827,630,53.80063492063492,56.447709750566894,9.0,9.0,228,3.0,197
1928,827,822,53.80063492063492,55.797551020408164,9.0,4.0,86,2.0,5
1929,822,484,55.797551020408164,57.330068027210885,4.0,24.0,344,2.0,338
1930,822,465,55.797551020408164,58.28208616780046,4.0,25.0,373,2.0,357
1931,822,617,55.797551020408164,57.330068027210885,4.0,8.0,215,2.0,205
1932,822,625,55.797551020408164,58.212426303854876,4.0,16.0,223,2.0,197
1933,822,826,55.797551020408164,57.283628117913835,4.0,6.0,64,1.0,4
1934,826,428,57.283628117913835,59.65206349206349,6.0,18.0,411,2.0,398
1935,826,624,57.283628117913835,59.97714285714286,6.0,11.0,233,3.0,202
1936,826,868,57.283628117913835,59.97714285714286,6.0,4.0,123,3.0,42
