,f0,f1,t0,t1,dB0,dB1,dist,utime,ufreq
0,185,69,1.8575963718820863,3.947392290249433,30.0,33.0,147,2.0,116
1,185,246,1.8575963718820863,3.6687528344671203,30.0,40.0,99,2.0,61
2,185,219,1.8575963718820863,4.504671201814059,30.0,37.0,119,3.0,34
3,185,485,1.8575963718820863,3.9706122448979593,30.0,30.0,313,2.0,300
4,185,430,1.8575963718820863,4.272471655328799,30.0,28.0,266,2.0,245
5,185,658,1.8575963718820863,3.6687528344671203,30.0,10.0,479,2.0,473
6,55,69,2.1362358276643993,3.947392290249433,29.0,33.0,79,2.0,14
7,55,185,2.1362358276643993,4.272471655328799,29.0,31.0,159,2.0,130
8,55,65,2.1362358276643993,4.992290249433107,29.0,27.0,123,3.0,10
9,55,246,2.1362358276643993,3.6687528344671203,29.0,40.0,202,2.0,191
10,55,219,2.1362358276643993,4.504671201814059,29.0,37.0,193,2.0,164
11,55,485,2.1362358276643993,3.9706122448979593,29.0,30.0,437,2.0,430
12,55,430,2.1362358276643993,4.272471655328799,29.0,28.0,386,2.0,375
13,69,65,3.947392290249433,4.992290249433107,33.0,27.0,45,1.0,4
14,69,91,3.947392290249433,6.292607709750567,33.0,27.0,103,2.0,22
15,69,220,3.947392290249433,5.410249433106576,33.0,38.0,164,1.0,151
16,69,246,3.947392290249433,6.896326530612245,33.0,38.0,218,3.0,177
17,69,431,3.947392290249433,5.38702947845805,33.0,23.0,367,1.0,362
18,69,484,3.947392290249433,6.640907029478458,33.0,27.0,431,3.0,415
19,185,91,4.272471655328799,6.292607709750567,31.0,27.0,128,2.0,94
20,185,220,4.272471655328799,5.410249433106576,31.0,38.0,60,1.0,35
21,185,246,4.272471655328799,6.896326530612245,31.0,38.0,128,3.0,61
22,185,431,4.272471655328799,5.38702947845805,31.0,23.0,251,1.0,246
23,185,484,4.272471655328799,6.640907029478458,31.0,27.0,316,2.0,299
24,185,615,4.272471655328799,6.339047619047619,31.0,9.0,439,2.0,430
25,65,91,4.992290249433107,6.292607709750567,27.0,27.0,62,1.0,26
26,65,164,4.992290249433107,7.801904761904762,27.0,31.0,156,3.0,99
27,65,246,4.992290249433107,6.896326530612245,27.0,38.0,199,2.0,181
28,65,246,4.992290249433107,7.778684807256236,27.0,37.0,217,3.0,181
29,65,484,4.992290249433107,6.640907029478458,27.0,27.0,425,2.0,419
30,65,491,4.992290249433107,7.778684807256236,27.0,29.0,443,3.0,426
31,91,164,6.292607709750567,7.801904761904762,27.0,31.0,98,2.0,73
32,91,151,6.292607709750567,8.40562358276644,27.0,28.0,109,2.0,60
33,91,246,6.292607709750567,7.778684807256236,27.0,37.0,168,1.0,155
34,91,247,6.292607709750567,8.382403628117913,27.0,31.0,180,2.0,156
35,91,491,6.292607709750567,7.778684807256236,27.0,29.0,405,1.0,400
36,91,485,6.292607709750567,8.70748299319728,27.0,28.0,407,2.0,394
37,164,90,7.801904761904762,9.891700680272109,31.0,32.0,117,2.0,74
38,164,82,7.801904761904762,10.750839002267574,31.0,29.0,151,3.0,82
39,164,348,7.801904761904762,9.659501133786849,31.0,30.0,201,2.0,184
40,164,246,7.801904761904762,10.170340136054422,31.0,32.0,131,2.0,82
41,164,485,7.801904761904762,9.287981859410431,31.0,30.0,327,1.0,321
42,164,431,7.801904761904762,10.147120181405896,31.0,27.0,285,2.0,267
43,164,616,7.801904761904762,8.962902494331066,31.0,5.0,455,1.0,452
44,164,620,7.801904761904762,9.264761904761905,31.0,6.0,460,1.0,456
45,164,619,7.801904761904762,10.518639455782314,31.0,13.0,470,3.0,455
46,151,90,8.40562358276644,9.891700680272109,28.0,32.0,88,1.0,61
47,151,82,8.40562358276644,10.750839002267574,28.0,29.0,122,2.0,69
48,151,185,8.40562358276644,11.377777777777778,28.0,31.0,132,3.0,34
49,151,348,8.40562358276644,9.659501133786849,28.0,30.0,204,1.0,197
50,151,246,8.40562358276644,10.170340136054422,28.0,32.0,122,2.0,95
51,151,246,8.40562358276644,11.354557823129252,28.0,32.0,159,3.0,95
52,151,431,8.40562358276644,10.147120181405896,28.0,27.0,290,2.0,280
53,151,492,8.40562358276644,11.377777777777778,28.0,26.0,364,3.0,341
54,151,619,8.40562358276644,10.518639455782314,28.0,13.0,477,2.0,468
55,151,626,8.40562358276644,10.983038548752834,28.0,10.0,488,3.0,475
56,90,185,9.891700680272109,11.377777777777778,32.0,31.0,115,1.0,95
57,90,246,9.891700680272109,11.354557823129252,32.0,32.0,168,1.0,156
58,90,218,9.891700680272109,12.701315192743765,32.0,38.0,176,3.0,128
59,90,492,9.891700680272109,11.377777777777778,32.0,26.0,407,1.0,402
60,90,435,9.891700680272109,12.701315192743765,32.0,24.0,366,3.0,345
61,82,182,10.750839002267574,12.956734693877552,29.0,31.0,138,2.0,100
62,82,181,10.750839002267574,12.979954648526077,29.0,34.0,138,2.0,99
63,82,218,10.750839002267574,12.701315192743765,29.0,38.0,160,2.0,136
64,82,247,10.750839002267574,13.14249433106576,29.0,29.0,195,2.0,165
65,82,435,10.750839002267574,12.701315192743765,29.0,24.0,363,2.0,353
66,82,483,10.750839002267574,13.421133786848072,29.0,25.0,417,3.0,401
67,185,182,11.377777777777778,12.956734693877552,31.0,31.0,68,2.0,3
68,185,181,11.377777777777778,12.979954648526077,31.0,34.0,69,2.0,4
69,185,218,11.377777777777778,12.701315192743765,31.0,38.0,66,1.0,33
70,185,247,11.377777777777778,13.14249433106576,31.0,29.0,98,2.0,62
71,185,219,11.377777777777778,14.02485260770975,31.0,33.0,119,3.0,34
72,185,435,11.377777777777778,12.701315192743765,31.0,24.0,256,1.0,250
73,185,483,11.377777777777778,13.421133786848072,31.0,25.0,311,2.0,298
74,185,615,11.377777777777778,12.654875283446712,31.0,7.0,434,1.0,430
75,182,82,12.956734693877552,14.721451247165533,31.0,31.0,126,2.0,100
76,182,185,12.956734693877552,15.836009070294786,31.0,30.0,124,3.0,3
77,182,219,12.956734693877552,14.02485260770975,31.0,33.0,59,1.0,37
78,182,242,12.956734693877552,15.789569160997733,31.0,38.0,136,3.0,60
79,182,598,12.956734693877552,14.55891156462585,31.0,19.0,422,2.0,416
80,182,410,12.956734693877552,15.743129251700681,31.0,26.0,258,3.0,228
81,182,650,12.956734693877552,15.301950113378686,31.0,9.0,479,2.0,468
82,181,82,12.979954648526077,14.721451247165533,34.0,31.0,124,2.0,99
83,181,185,12.979954648526077,15.836009070294786,34.0,30.0,123,3.0,4
84,181,219,12.979954648526077,14.02485260770975,34.0,33.0,59,1.0,38
85,181,242,12.979954648526077,15.789569160997733,34.0,38.0,136,3.0,61
86,181,598,12.979954648526077,14.55891156462585,34.0,19.0,423,2.0,417
87,181,410,12.979954648526077,15.743129251700681,34.0,26.0,258,3.0,229
88,181,650,12.979954648526077,15.301950113378686,34.0,9.0,480,2.0,469
89,82,185,14.721451247165533,15.836009070294786,31.0,30.0,114,1.0,103
90,82,172,14.721451247165533,17.507845804988662,31.0,33.0,150,3.0,90
91,82,242,14.721451247165533,15.789569160997733,31.0,38.0,166,1.0,160
92,82,300,14.721451247165533,16.904126984126986,31.0,35.0,237,2.0,218
93,82,410,14.721451247165533,15.743129251700681,31.0,26.0,331,1.0,328
94,82,483,14.721451247165533,16.114648526077097,31.0,26.0,405,1.0,401
95,82,411,14.721451247165533,17.2756462585034,31.0,30.0,347,3.0,329
96,185,82,15.836009070294786,16.904126984126986,30.0,31.0,113,1.0,103
97,185,172,15.836009070294786,17.507845804988662,30.0,33.0,73,2.0,13
98,185,171,15.836009070294786,18.3437641723356,30.0,36.0,109,3.0,14
99,185,300,15.836009070294786,16.904126984126986,30.0,35.0,124,1.0,115
100,185,246,15.836009070294786,17.925804988662133,30.0,35.0,109,2.0,61
101,185,411,15.836009070294786,17.2756462585034,30.0,30.0,234,1.0,226
102,185,485,15.836009070294786,18.808163265306124,30.0,28.0,326,3.0,300
103,185,659,15.836009070294786,17.925804988662133,30.0,5.0,482,2.0,474
104,185,615,15.836009070294786,18.018684807256236,30.0,8.0,440,2.0,430
105,82,171,16.904126984126986,18.3437641723356,31.0,36.0,108,1.0,89
106,82,170,16.904126984126986,19.040362811791383,31.0,30.0,127,2.0,88
107,82,246,16.904126984126986,17.925804988662133,31.0,35.0,170,1.0,164
108,82,208,16.904126984126986,18.854603174603174,31.0,31.0,151,2.0,126
109,82,246,16.904126984126986,19.82984126984127,31.0,27.0,207,3.0,164
110,82,485,16.904126984126986,18.808163265306124,31.0,28.0,411,2.0,403
111,82,475,16.904126984126986,19.272562358276645,31.0,24.0,406,2.0,393
112,172,170,17.507845804988662,19.040362811791383,33.0,30.0,66,2.0,2
113,172,184,17.507845804988662,20.433560090702947,33.0,34.0,127,3.0,12
114,172,208,17.507845804988662,18.854603174603174,33.0,31.0,68,1.0,36
115,172,246,17.507845804988662,19.82984126984127,33.0,27.0,124,2.0,74
116,172,308,17.507845804988662,20.387120181405898,33.0,31.0,184,3.0,136
117,172,485,17.507845804988662,18.808163265306124,33.0,28.0,318,1.0,313
118,172,475,17.507845804988662,19.272562358276645,33.0,24.0,312,2.0,303
119,172,428,17.507845804988662,20.456780045351476,33.0,31.0,286,3.0,256
120,171,184,18.3437641723356,20.433560090702947,36.0,34.0,91,2.0,13
121,171,246,18.3437641723356,19.82984126984127,36.0,27.0,99,1.0,75
122,171,308,18.3437641723356,20.387120181405898,36.0,31.0,163,2.0,137
123,171,298,18.3437641723356,21.269478458049885,36.0,32.0,179,3.0,127
124,171,428,18.3437641723356,20.456780045351476,36.0,31.0,273,2.0,257
125,171,615,18.3437641723356,20.89795918367347,36.0,3.0,457,3.0,444
126,170,184,19.040362811791383,20.433560090702947,30.0,34.0,62,1.0,14
127,170,184,19.040362811791383,21.5481179138322,30.0,31.0,109,3.0,14
128,170,308,19.040362811791383,20.387120181405898,30.0,31.0,150,1.0,138
129,170,298,19.040362811791383,21.269478458049885,30.0,32.0,160,2.0,128
130,170,428,19.040362811791383,20.456780045351476,30.0,31.0,265,1.0,258
131,170,417,19.040362811791383,21.966077097505668,30.0,23.0,277,3.0,247
132,170,615,19.040362811791383,20.89795918367347,30.0,3.0,452,2.0,445
133,170,615,19.040362811791383,22.01251700680272,30.0,2.0,463,3.0,445
134,184,183,20.433560090702947,22.244716553287983,34.0,33.0,78,2.0,1
135,184,409,20.433560090702947,22.50013605442177,34.0,29.0,242,2.0,225
136,184,417,20.433560090702947,21.966077097505668,34.0,23.0,242,2.0,233
137,184,411,20.433560090702947,22.546575963718823,34.0,31.0,245,2.0,227
138,184,430,20.433560090702947,23.127074829931974,34.0,23.0,272,3.0,246
139,184,615,20.433560090702947,22.01251700680272,34.0,2.0,436,2.0,431
140,184,193,21.5481179138322,23.823673469387757,31.0,31.0,98,2.0,9
141,184,221,21.5481179138322,23.823673469387757,31.0,33.0,105,2.0,37
142,184,230,21.5481179138322,24.380952380952383,31.0,30.0,130,3.0,46
143,184,430,21.5481179138322,23.127074829931974,31.0,23.0,255,2.0,246
144,184,417,21.5481179138322,24.380952380952383,31.0,21.0,263,3.0,233
145,183,193,22.244716553287983,23.823673469387757,33.0,31.0,69,2.0,10
146,183,69,22.244716553287983,24.589931972789117,33.0,30.0,152,2.0,114
147,183,221,22.244716553287983,23.823673469387757,33.0,33.0,78,2.0,38
148,183,230,22.244716553287983,24.380952380952383,33.0,30.0,103,2.0,47
149,183,231,22.244716553287983,25.123990929705215,33.0,30.0,133,3.0,48
150,183,417,22.244716553287983,24.380952380952383,33.0,21.0,251,2.0,234
151,183,637,22.244716553287983,25.123990929705215,33.0,6.0,471,3.0,454
152,193,152,23.823673469387757,25.44907029478458,31.0,32.0,81,2.0,41
153,193,183,23.823673469387757,26.656507936507936,31.0,35.0,122,3.0,10
154,193,231,23.823673469387757,25.123990929705215,31.0,30.0,68,1.0,38
155,193,306,23.823673469387757,26.63328798185941,31.0,33.0,166,3.0,113
156,193,410,23.823673469387757,25.774149659863944,31.0,24.0,233,2.0,217
157,193,410,23.823673469387757,26.076009070294784,31.0,24.0,238,2.0,217
158,193,637,23.823673469387757,25.123990929705215,31.0,6.0,448,1.0,444
159,69,183,24.589931972789117,26.656507936507936,30.0,35.0,145,2.0,114
160,69,171,24.589931972789117,27.00480725623583,30.0,33.0,146,2.0,102
161,69,306,24.589931972789117,26.63328798185941,30.0,33.0,253,2.0,237
162,69,410,24.589931972789117,25.774149659863944,30.0,24.0,345,1.0,341
163,69,410,24.589931972789117,26.076009070294784,30.0,24.0,347,1.0,341
164,69,411,24.589931972789117,27.00480725623583,30.0,31.0,357,2.0,342
165,152,183,25.44907029478458,26.656507936507936,32.0,35.0,61,1.0,31
166,152,171,25.44907029478458,27.00480725623583,32.0,33.0,70,2.0,19
167,152,306,25.44907029478458,26.63328798185941,32.0,33.0,162,1.0,154
168,152,307,25.44907029478458,27.840725623582767,32.0,31.0,186,2.0,155
169,152,411,25.44907029478458,27.00480725623583,32.0,31.0,268,2.0,259
170,183,184,26.656507936507936,28.676643990929705,35.0,29.0,87,2.0,1
171,183,307,26.656507936507936,27.840725623582767,35.0,31.0,134,1.0,124
172,183,230,26.656507936507936,28.676643990929705,35.0,30.0,99,2.0,47
173,183,417,26.656507936507936,28.699863945578233,35.0,23.0,250,2.0,234
174,171,184,27.00480725623583,28.676643990929705,33.0,29.0,73,2.0,13
175,171,182,27.00480725623583,29.76798185941043,33.0,32.0,120,3.0,11
176,171,230,27.00480725623583,28.676643990929705,33.0,30.0,93,2.0,59
177,171,301,27.00480725623583,29.744761904761905,33.0,31.0,176,3.0,130
178,171,417,27.00480725623583,28.699863945578233,33.0,23.0,257,2.0,246
179,171,427,27.00480725623583,29.95374149659864,33.0,23.0,286,3.0,256
180,184,182,28.676643990929705,29.76798185941043,29.0,32.0,47,1.0,2
181,184,91,28.676643990929705,30.162721088435376,29.0,31.0,113,1.0,93
182,184,301,28.676643990929705,29.744761904761905,29.0,31.0,126,1.0,117
183,184,231,28.676643990929705,30.325260770975056,29.0,30.0,85,2.0,47
184,184,427,28.676643990929705,29.95374149659864,29.0,23.0,249,1.0,243
185,184,419,28.676643990929705,30.25560090702948,29.0,19.0,245,2.0,235
186,184,625,28.676643990929705,30.325260770975056,29.0,4.0,447,2.0,441
187,182,184,29.76798185941043,31.880997732426305,32.0,30.0,91,2.0,2
188,182,308,29.76798185941043,31.74167800453515,32.0,33.0,152,2.0,126
189,182,272,29.76798185941043,32.55437641723356,32.0,35.0,150,3.0,90
190,182,428,29.76798185941043,31.880997732426305,32.0,29.0,262,2.0,246
191,182,420,29.76798185941043,32.08997732426304,32.0,26.0,258,2.0,238
192,91,184,30.162721088435376,31.880997732426305,31.0,30.0,119,2.0,93
193,91,182,30.162721088435376,32.298956916099776,31.0,31.0,129,2.0,91
194,91,82,30.162721088435376,33.08843537414966,31.0,33.0,126,3.0,9
195,91,308,30.162721088435376,31.74167800453515,31.0,33.0,227,2.0,217
196,91,272,30.162721088435376,32.55437641723356,31.0,35.0,208,2.0,181
197,91,428,30.162721088435376,31.880997732426305,31.0,29.0,345,2.0,337
198,91,420,30.162721088435376,32.08997732426304,31.0,26.0,339,2.0,329
199,184,82,31.880997732426305,33.08843537414966,30.0,33.0,114,1.0,102
200,184,290,31.880997732426305,33.715374149659866,30.0,31.0,132,2.0,106
201,184,274,31.880997732426305,34.04045351473923,30.0,36.0,129,2.0,90
202,184,410,31.880997732426305,33.90113378684807,30.0,22.0,242,2.0,226
203,184,410,31.880997732426305,34.04045351473923,30.0,21.0,244,2.0,226
204,184,618,31.880997732426305,33.8314739229025,30.0,8.0,442,2.0,434
205,182,138,32.298956916099776,34.89959183673469,31.0,32.0,120,3.0,44
206,182,185,32.298956916099776,35.062131519274374,31.0,29.0,119,3.0,3
207,182,290,32.298956916099776,33.715374149659866,31.0,31.0,124,1.0,108
208,182,274,32.298956916099776,34.04045351473923,31.0,36.0,119,2.0,92
209,182,326,32.298956916099776,35.131791383219955,31.0,30.0,189,3.0,144
210,182,410,32.298956916099776,33.90113378684807,31.0,22.0,238,2.0,228
211,182,410,32.298956916099776,34.04045351473923,31.0,21.0,240,2.0,228
212,182,618,32.298956916099776,33.8314739229025,31.0,8.0,441,2.0,436
213,82,138,33.08843537414966,34.89959183673469,33.0,32.0,96,2.0,56
214,82,185,33.08843537414966,35.062131519274374,33.0,29.0,134,2.0,103
215,82,326,33.08843537414966,35.131791383219955,33.0,30.0,259,2.0,244
216,82,411,33.08843537414966,35.898049886621315,33.0,25.0,351,3.0,329
217,138,172,34.89959183673469,36.73396825396826,32.0,30.0,86,2.0,34
218,138,184,34.89959183673469,37.45378684807256,32.0,30.0,119,3.0,46
219,138,231,34.89959183673469,36.26956916099773,32.0,30.0,110,1.0,93
220,138,305,34.89959183673469,37.871746031746035,32.0,32.0,210,3.0,167
221,138,410,34.89959183673469,36.91972789115646,32.0,21.0,286,2.0,272
222,185,172,35.062131519274374,36.73396825396826,29.0,30.0,73,2.0,13
223,185,184,35.062131519274374,37.45378684807256,29.0,30.0,103,2.0,1
224,185,231,35.062131519274374,36.26956916099773,29.0,30.0,69,1.0,46
225,185,305,35.062131519274374,37.871746031746035,29.0,32.0,170,3.0,120
226,185,410,35.062131519274374,36.91972789115646,29.0,21.0,239,2.0,225
227,185,427,35.062131519274374,37.89496598639456,29.0,29.0,271,3.0,242
228,185,638,35.062131519274374,36.26956916099773,29.0,4.0,456,1.0,453
229,172,70,36.73396825396826,38.66122448979592,30.0,31.0,132,2.0,102
230,172,61,36.73396825396826,38.98630385487528,30.0,31.0,147,2.0,111
231,172,305,36.73396825396826,37.871746031746035,30.0,32.0,142,1.0,133
232,172,275,36.73396825396826,38.42902494331066,30.0,37.0,126,2.0,103
233,172,307,36.73396825396826,39.31138321995465,30.0,32.0,175,3.0,135
234,172,427,36.73396825396826,37.89496598639456,30.0,29.0,260,1.0,255
235,172,423,36.73396825396826,38.730884353741494,30.0,26.0,265,2.0,251
236,172,410,36.73396825396826,39.31138321995465,30.0,29.0,263,3.0,238
237,172,631,36.73396825396826,38.31292517006803,30.0,8.0,464,2.0,459
238,184,70,37.45378684807256,38.66122448979592,30.0,31.0,125,1.0,114
239,184,61,37.45378684807256,38.98630385487528,30.0,31.0,140,2.0,123
240,184,172,37.45378684807256,40.03120181405896,30.0,35.0,112,3.0,12
241,184,307,37.45378684807256,39.31138321995465,30.0,32.0,147,2.0,123
242,184,279,37.45378684807256,40.00798185941043,30.0,33.0,145,3.0,95
243,184,423,37.45378684807256,38.730884353741494,30.0,26.0,245,1.0,239
244,184,410,37.45378684807256,39.31138321995465,30.0,29.0,240,2.0,226
245,184,418,37.45378684807256,40.00798185941043,30.0,32.0,259,3.0,234
246,70,172,38.66122448979592,40.03120181405896,31.0,35.0,118,1.0,102
247,70,279,38.66122448979592,40.00798185941043,31.0,33.0,217,1.0,209
248,70,418,38.66122448979592,40.00798185941043,31.0,32.0,353,1.0,348
249,70,417,38.66122448979592,41.02965986394558,31.0,20.0,362,2.0,347
250,61,172,38.98630385487528,40.03120181405896,31.0,35.0,120,1.0,111
251,61,82,38.98630385487528,41.67981859410431,31.0,30.0,118,3.0,21
252,61,279,38.98630385487528,40.00798185941043,31.0,33.0,222,1.0,218
253,61,327,38.98630385487528,41.67981859410431,31.0,31.0,290,3.0,266
254,61,418,38.98630385487528,40.00798185941043,31.0,32.0,360,1.0,357
255,61,417,38.98630385487528,41.02965986394558,31.0,20.0,367,2.0,356
256,172,82,40.03120181405896,41.67981859410431,35.0,30.0,115,2.0,90
257,172,184,40.03120181405896,42.21387755102041,35.0,37.0,95,2.0,12
258,172,327,40.03120181405896,41.67981859410431,35.0,31.0,170,2.0,155
259,172,257,40.03120181405896,42.21387755102041,35.0,35.0,127,2.0,85
260,172,417,40.03120181405896,42.956916099773245,35.0,21.0,276,3.0,245
261,172,627,40.03120181405896,41.65659863945578,35.0,8.0,460,2.0,455
262,82,184,41.67981859410431,43.39809523809524,30.0,28.0,126,2.0,102
263,82,184,41.67981859410431,44.11791383219955,30.0,30.0,146,2.0,102
264,82,231,41.67981859410431,43.39809523809524,30.0,30.0,166,2.0,149
265,82,231,41.67981859410431,44.14113378684807,30.0,31.0,183,2.0,149
266,82,417,41.67981859410431,42.956916099773245,30.0,21.0,339,1.0,335
267,82,417,41.67981859410431,43.39809523809524,30.0,22.0,343,2.0,335
268,82,417,41.67981859410431,44.58231292517007,30.0,21.0,358,3.0,335
269,184,231,42.21387755102041,43.39809523809524,37.0,30.0,69,1.0,47
270,184,231,42.21387755102041,44.14113378684807,37.0,31.0,95,2.0,47
271,184,417,42.21387755102041,43.39809523809524,37.0,22.0,239,1.0,233
272,184,417,42.21387755102041,44.58231292517007,37.0,21.0,254,2.0,233
273,184,231,43.39809523809524,45.7665306122449,28.0,30.0,112,2.0,47
274,184,278,43.39809523809524,46.11482993197279,28.0,33.0,150,3.0,94
275,184,417,43.39809523809524,44.58231292517007,28.0,21.0,239,1.0,233
276,184,417,43.39809523809524,45.7665306122449,28.0,21.0,254,2.0,233
277,184,91,44.11791383219955,46.439909297052154,30.0,31.0,137,2.0,93
278,184,231,44.11791383219955,45.7665306122449,30.0,30.0,85,2.0,47
279,184,278,44.11791383219955,46.11482993197279,30.0,33.0,127,2.0,94
280,184,417,44.11791383219955,45.7665306122449,30.0,21.0,244,2.0,233
281,184,417,44.11791383219955,46.509569160997735,30.0,20.0,255,2.0,233
282,184,231,45.7665306122449,47.69378684807256,30.0,31.0,95,2.0,47
283,184,414,45.7665306122449,47.94920634920635,30.0,23.0,248,2.0,230
284,184,429,45.7665306122449,48.645804988662135,30.0,28.0,275,3.0,245
285,184,638,45.7665306122449,47.69378684807256,30.0,5.0,462,2.0,454
286,91,184,46.439909297052154,47.69378684807256,31.0,29.0,108,1.0,93
287,91,184,46.439909297052154,48.13496598639456,31.0,32.0,118,2.0,93
288,91,164,46.439909297052154,49.22630385487528,31.0,33.0,140,3.0,73
289,91,231,46.439909297052154,47.69378684807256,31.0,31.0,150,1.0,140
290,91,305,46.439909297052154,48.78512471655329,31.0,32.0,237,2.0,214
291,91,288,46.439909297052154,49.11020408163265,31.0,32.0,228,3.0,197
292,91,414,46.439909297052154,47.94920634920635,31.0,23.0,329,2.0,323
293,91,429,46.439909297052154,48.645804988662135,31.0,28.0,351,2.0,338
294,91,411,46.439909297052154,49.22630385487528,31.0,21.0,342,3.0,320
295,184,164,47.69378684807256,49.22630385487528,29.0,33.0,69,2.0,20
296,184,145,47.69378684807256,50.31764172335601,29.0,31.0,120,3.0,39
297,184,305,47.69378684807256,48.78512471655329,29.0,32.0,130,1.0,121
298,184,288,47.69378684807256,49.11020408163265,29.0,32.0,121,1.0,104
299,184,231,47.69378684807256,50.08544217687075,29.0,28.0,113,2.0,47
300,184,411,47.69378684807256,49.22630385487528,29.0,21.0,236,2.0,227
301,184,417,47.69378684807256,50.52662131519274,29.0,20.0,263,3.0,233
302,184,619,47.69378684807256,49.73714285714286,29.0,7.0,444,2.0,435
303,184,164,48.13496598639456,49.22630385487528,32.0,33.0,51,1.0,20
304,184,145,48.13496598639456,50.31764172335601,32.0,31.0,102,2.0,39
305,184,231,48.13496598639456,50.08544217687075,32.0,28.0,96,2.0,47
306,184,411,48.13496598639456,49.22630385487528,32.0,21.0,232,1.0,227
307,184,417,48.13496598639456,50.52662131519274,32.0,20.0,255,2.0,233
308,184,619,48.13496598639456,49.73714285714286,32.0,7.0,440,2.0,435
309,164,145,49.22630385487528,50.31764172335601,33.0,31.0,51,1.0,19
310,164,184,49.22630385487528,51.710839002267576,33.0,29.0,109,2.0,20
311,164,273,49.22630385487528,51.50185941043084,33.0,35.0,147,2.0,109
312,164,417,49.22630385487528,50.52662131519274,33.0,20.0,259,1.0,253
313,164,410,49.22630385487528,51.50185941043084,33.0,28.0,265,2.0,246
314,164,615,49.22630385487528,51.24643990929705,33.0,4.0,459,2.0,451
315,145,184,50.31764172335601,51.710839002267576,31.0,29.0,72,1.0,39
316,145,184,50.31764172335601,52.45387755102041,31.0,30.0,100,2.0,39
317,145,273,50.31764172335601,51.50185941043084,31.0,35.0,138,1.0,128
318,145,231,50.31764172335601,52.45387755102041,31.0,29.0,126,2.0,86
319,145,410,50.31764172335601,51.50185941043084,31.0,28.0,270,1.0,265
320,145,417,50.31764172335601,52.45387755102041,31.0,20.0,287,2.0,272
321,184,231,51.710839002267576,53.63809523809524,29.0,31.0,95,2.0,47
322,184,216,51.710839002267576,54.14893424036281,29.0,34.0,110,2.0,32
323,184,417,51.710839002267576,53.63809523809524,29.0,21.0,247,2.0,233
324,184,413,51.710839002267576,54.659773242630386,29.0,23.0,262,3.0,229
325,184,646,51.710839002267576,53.127256235827666,29.0,12.0,466,1.0,462
326,184,615,51.710839002267576,54.07927437641723,29.0,5.0,443,2.0,431
327,184,231,52.45387755102041,53.63809523809524,30.0,31.0,69,1.0,47
328,184,216,52.45387755102041,54.14893424036281,30.0,34.0,80,2.0,32
329,184,231,52.45387755102041,55.263492063492066,30.0,29.0,130,3.0,47
330,184,417,52.45387755102041,53.63809523809524,30.0,21.0,239,1.0,233
331,184,413,52.45387755102041,54.659773242630386,30.0,23.0,248,2.0,229
332,184,417,52.45387755102041,55.28671201814059,30.0,20.0,263,3.0,233
333,184,615,52.45387755102041,54.07927437641723,30.0,5.0,437,2.0,431
334,184,61,53.63809523809524,55.913650793650795,31.0,30.0,157,2.0,123
335,184,231,53.63809523809524,55.263492063492066,31.0,29.0,84,2.0,47
336,184,231,53.63809523809524,56.0065306122449,31.0,29.0,112,2.0,47
337,184,413,53.63809523809524,54.659773242630386,31.0,23.0,233,1.0,229
338,184,417,53.63809523809524,55.28671201814059,31.0,20.0,244,2.0,233
339,184,417,53.63809523809524,56.47092970521542,31.0,21.0,263,3.0,233
340,184,673,53.63809523809524,55.49569160997733,31.0,11.0,496,2.0,489
341,184,632,53.63809523809524,56.447709750566894,31.0,6.0,464,3.0,448
342,184,61,54.07927437641723,55.913650793650795,29.0,30.0,146,2.0,123
343,184,231,54.07927437641723,55.263492063492066,29.0,29.0,69,1.0,47
344,184,231,54.07927437641723,56.0065306122449,29.0,29.0,95,2.0,47
345,184,417,54.07927437641723,55.28671201814059,29.0,20.0,239,1.0,233
346,184,417,54.07927437641723,56.47092970521542,29.0,21.0,255,2.0,233
347,184,673,54.07927437641723,55.49569160997733,29.0,11.0,493,1.0,489
348,184,632,54.07927437641723,56.447709750566894,29.0,6.0,459,2.0,448
349,61,183,55.913650793650795,57.79446712018141,30.0,31.0,146,2.0,122
350,61,183,55.913650793650795,58.42140589569161,30.0,32.0,163,3.0,122
351,61,214,55.913650793650795,57.09786848072562,30.0,31.0,161,1.0,153
352,61,246,55.913650793650795,58.28208616780046,30.0,31.0,211,2.0,185
353,61,427,55.913650793650795,57.0746485260771,30.0,30.0,369,1.0,366
354,61,434,55.913650793650795,58.18920634920635,30.0,28.0,386,2.0,373
355,184,183,56.447709750566894,57.79446712018141,28.0,31.0,58,1.0,1
356,184,183,56.447709750566894,58.42140589569161,28.0,32.0,85,2.0,1
357,184,246,56.447709750566894,58.28208616780046,28.0,31.0,100,2.0,62
358,184,220,56.447709750566894,59.16444444444445,28.0,30.0,122,3.0,36
359,184,434,56.447709750566894,58.18920634920635,28.0,28.0,261,2.0,250
360,184,439,56.447709750566894,59.16444444444445,28.0,27.0,281,3.0,255
361,184,637,56.447709750566894,58.83936507936508,28.0,4.0,465,2.0,453
362,183,91,57.79446712018141,59.90748299319728,31.0,36.0,129,2.0,92
363,183,220,57.79446712018141,59.16444444444445,31.0,30.0,70,1.0,37
364,183,439,57.79446712018141,59.16444444444445,31.0,27.0,263,1.0,256
365,183,637,57.79446712018141,58.83936507936508,31.0,4.0,456,1.0,454
366,183,91,58.42140589569161,59.90748299319728,32.0,36.0,112,1.0,92
367,246,69,1.8808163265306124,3.947392290249433,37.0,33.0,198,2.0,177
368,246,185,1.8808163265306124,4.272471655328799,37.0,31.0,120,2.0,61
369,246,219,1.8808163265306124,4.504671201814059,37.0,37.0,116,3.0,27
370,246,485,1.8808163265306124,3.9706122448979593,37.0,30.0,255,2.0,239
371,246,430,1.8808163265306124,4.272471655328799,37.0,28.0,211,2.0,184
372,246,658,1.8808163265306124,3.6687528344671203,37.0,10.0,419,2.0,412
373,246,694,1.8808163265306124,3.9938321995464854,37.0,4.0,457,2.0,448
374,219,69,2.1362358276643993,3.947392290249433,32.0,33.0,169,2.0,150
375,219,185,2.1362358276643993,4.272471655328799,32.0,31.0,98,2.0,34
376,219,65,2.1362358276643993,4.992290249433107,32.0,27.0,197,3.0,154
377,219,246,2.1362358276643993,3.6687528344671203,32.0,40.0,71,2.0,27
378,219,485,2.1362358276643993,3.9706122448979593,32.0,30.0,277,2.0,266
379,219,430,2.1362358276643993,4.272471655328799,32.0,28.0,230,2.0,211
380,219,658,2.1362358276643993,3.6687528344671203,32.0,10.0,444,2.0,439
381,219,694,2.1362358276643993,3.9938321995464854,32.0,4.0,482,2.0,475
382,246,65,3.6687528344671203,4.992290249433107,40.0,27.0,190,1.0,181
383,246,91,3.6687528344671203,6.292607709750567,40.0,27.0,192,3.0,155
384,246,220,3.6687528344671203,5.410249433106576,40.0,38.0,79,2.0,26
385,246,431,3.6687528344671203,5.38702947845805,40.0,23.0,199,2.0,185
386,246,484,3.6687528344671203,6.640907029478458,40.0,27.0,270,3.0,238
387,246,615,3.6687528344671203,6.339047619047619,40.0,9.0,387,3.0,369
388,219,91,4.504671201814059,6.292607709750567,37.0,27.0,149,2.0,128
389,219,246,4.504671201814059,6.896326530612245,37.0,38.0,106,2.0,27
390,219,484,4.504671201814059,6.640907029478458,37.0,27.0,281,2.0,265
391,219,615,4.504671201814059,6.339047619047619,37.0,9.0,404,2.0,396
392,220,164,5.410249433106576,7.801904761904762,38.0,31.0,117,2.0,56
393,220,246,5.410249433106576,6.896326530612245,38.0,38.0,69,1.0,26
394,220,246,5.410249433106576,7.778684807256236,38.0,37.0,105,2.0,26
395,220,247,5.410249433106576,8.382403628117913,38.0,31.0,131,3.0,27
396,220,484,5.410249433106576,6.640907029478458,38.0,27.0,269,1.0,264
397,220,491,5.410249433106576,7.778684807256236,38.0,29.0,290,2.0,271
398,220,644,5.410249433106576,7.75546485260771,38.0,5.0,436,2.0,424
399,246,151,6.896326530612245,8.40562358276644,38.0,28.0,115,2.0,95
400,246,247,6.896326530612245,8.382403628117913,38.0,31.0,64,1.0,1
401,246,348,6.896326530612245,9.659501133786849,38.0,30.0,157,3.0,102
402,246,485,6.896326530612245,8.70748299319728,38.0,28.0,251,2.0,239
403,246,485,6.896326530612245,9.287981859410431,38.0,30.0,260,2.0,239
404,246,616,6.896326530612245,8.962902494331066,38.0,5.0,381,2.0,370
405,246,620,6.896326530612245,9.264761904761905,38.0,6.0,388,2.0,374
406,246,90,7.778684807256236,9.891700680272109,37.0,32.0,181,2.0,156
407,246,82,7.778684807256236,10.750839002267574,37.0,29.0,208,3.0,164
408,246,348,7.778684807256236,9.659501133786849,37.0,30.0,130,2.0,102
409,246,485,7.778684807256236,9.287981859410431,37.0,30.0,248,2.0,239
410,246,431,7.778684807256236,10.147120181405896,37.0,27.0,211,2.0,185
411,246,616,7.778684807256236,8.962902494331066,37.0,5.0,373,1.0,370
412,246,620,7.778684807256236,9.264761904761905,37.0,6.0,379,1.0,374
413,246,619,7.778684807256236,10.518639455782314,37.0,13.0,391,3.0,373
414,247,90,8.382403628117913,9.891700680272109,31.0,32.0,170,2.0,157
415,247,82,8.382403628117913,10.750839002267574,31.0,29.0,194,2.0,165
416,247,348,8.382403628117913,9.659501133786849,31.0,30.0,115,1.0,101
417,247,246,8.382403628117913,10.170340136054422,31.0,32.0,77,2.0,1
418,247,246,8.382403628117913,11.354557823129252,31.0,32.0,128,3.0,1
419,247,431,8.382403628117913,10.147120181405896,31.0,27.0,199,2.0,184
420,247,619,8.382403628117913,10.518639455782314,31.0,13.0,383,2.0,372
421,247,626,8.382403628117913,10.983038548752834,31.0,10.0,395,3.0,379
422,348,82,9.659501133786849,10.750839002267574,30.0,29.0,270,1.0,266
423,348,185,9.659501133786849,11.377777777777778,30.0,31.0,179,2.0,163
424,348,246,9.659501133786849,11.354557823129252,30.0,32.0,125,2.0,102
425,348,492,9.659501133786849,11.377777777777778,30.0,26.0,162,2.0,144
426,348,626,9.659501133786849,10.983038548752834,30.0,10.0,284,1.0,278
427,246,185,10.170340136054422,11.377777777777778,32.0,31.0,80,1.0,61
428,246,182,10.170340136054422,12.956734693877552,32.0,31.0,136,3.0,64
429,246,181,10.170340136054422,12.979954648526077,32.0,34.0,137,3.0,65
430,246,218,10.170340136054422,12.701315192743765,32.0,38.0,113,3.0,28
431,246,247,10.170340136054422,13.14249433106576,32.0,29.0,128,3.0,1
432,246,492,10.170340136054422,11.377777777777778,32.0,26.0,251,1.0,246
433,246,435,10.170340136054422,12.701315192743765,32.0,24.0,218,3.0,189
434,246,615,10.170340136054422,12.654875283446712,32.0,7.0,384,2.0,369
435,246,182,11.354557823129252,12.956734693877552,32.0,31.0,94,2.0,64
436,246,181,11.354557823129252,12.979954648526077,32.0,34.0,96,2.0,65
437,246,218,11.354557823129252,12.701315192743765,32.0,38.0,64,1.0,28
438,246,247,11.354557823129252,13.14249433106576,32.0,29.0,77,2.0,1
439,246,219,11.354557823129252,14.02485260770975,32.0,33.0,118,3.0,27
440,246,435,11.354557823129252,12.701315192743765,32.0,24.0,198,1.0,189
441,246,483,11.354557823129252,13.421133786848072,32.0,25.0,253,2.0,237
442,246,615,11.354557823129252,12.654875283446712,32.0,7.0,373,1.0,369
443,246,719,11.354557823129252,13.165714285714285,32.0,9.0,479,2.0,473
444,218,82,12.701315192743765,14.721451247165533,38.0,31.0,161,2.0,136
445,218,219,12.701315192743765,14.02485260770975,38.0,33.0,57,1.0,1
446,218,598,12.701315192743765,14.55891156462585,38.0,19.0,388,2.0,380
447,218,650,12.701315192743765,15.301950113378686,38.0,9.0,446,3.0,432
448,247,82,13.14249433106576,14.721451247165533,29.0,31.0,178,2.0,165
449,247,185,13.14249433106576,15.836009070294786,29.0,30.0,132,3.0,62
450,247,242,13.14249433106576,15.789569160997733,29.0,38.0,114,3.0,5
451,247,598,13.14249433106576,14.55891156462585,29.0,19.0,356,1.0,351
452,247,410,13.14249433106576,15.743129251700681,29.0,26.0,198,3.0,163
453,247,483,13.14249433106576,16.114648526077097,29.0,26.0,268,3.0,236
454,247,745,13.14249433106576,14.55891156462585,29.0,13.0,502,1.0,498
455,247,650,13.14249433106576,15.301950113378686,29.0,9.0,414,2.0,403
456,219,185,14.02485260770975,15.836009070294786,33.0,30.0,85,2.0,34
457,219,82,14.02485260770975,16.904126984126986,33.0,31.0,185,3.0,137
458,219,242,14.02485260770975,15.789569160997733,33.0,38.0,79,2.0,23
459,219,300,14.02485260770975,16.904126984126986,33.0,35.0,148,3.0,81
460,219,410,14.02485260770975,15.743129251700681,33.0,26.0,205,2.0,191
461,219,483,14.02485260770975,16.114648526077097,33.0,26.0,279,2.0,264
462,219,650,14.02485260770975,15.301950113378686,33.0,9.0,434,1.0,431
463,219,616,14.02485260770975,16.393287981859412,33.0,18.0,410,2.0,397
464,242,82,15.789569160997733,16.904126984126986,38.0,31.0,167,1.0,160
465,242,172,15.789569160997733,17.507845804988662,38.0,33.0,102,2.0,70
466,242,171,15.789569160997733,18.3437641723356,38.0,36.0,131,3.0,71
467,242,300,15.789569160997733,16.904126984126986,38.0,35.0,75,1.0,58
468,242,246,15.789569160997733,17.925804988662133,38.0,35.0,92,2.0,4
469,242,411,15.789569160997733,17.2756462585034,38.0,30.0,181,1.0,169
470,242,659,15.789569160997733,17.925804988662133,38.0,5.0,427,2.0,417
471,242,615,15.789569160997733,18.018684807256236,38.0,8.0,385,2.0,373
472,300,171,16.904126984126986,18.3437641723356,35.0,36.0,143,1.0,129
473,300,170,16.904126984126986,19.040362811791383,35.0,30.0,159,2.0,130
474,300,246,16.904126984126986,17.925804988662133,35.0,35.0,70,1.0,54
475,300,208,16.904126984126986,18.854603174603174,35.0,31.0,125,2.0,92
476,300,246,16.904126984126986,19.82984126984127,35.0,27.0,137,3.0,54
477,300,485,16.904126984126986,18.808163265306124,35.0,28.0,202,2.0,185
478,300,475,16.904126984126986,19.272562358276645,35.0,24.0,203,2.0,175
479,300,659,16.904126984126986,17.925804988662133,35.0,5.0,362,1.0,359
480,300,615,16.904126984126986,18.018684807256236,35.0,8.0,319,1.0,315
481,246,170,17.925804988662133,19.040362811791383,35.0,30.0,90,1.0,76
482,246,184,17.925804988662133,20.433560090702947,35.0,34.0,125,3.0,62
483,246,308,17.925804988662133,20.387120181405898,35.0,31.0,123,2.0,62
484,246,475,17.925804988662133,19.272562358276645,35.0,24.0,236,1.0,229
485,246,428,17.925804988662133,20.456780045351476,35.0,31.0,212,3.0,182
486,246,615,17.925804988662133,20.89795918367347,35.0,3.0,391,3.0,369
487,208,184,18.854603174603174,20.433560090702947,31.0,34.0,72,2.0,24
488,208,184,18.854603174603174,21.5481179138322,31.0,31.0,118,3.0,24
489,208,308,18.854603174603174,20.387120181405898,31.0,31.0,120,2.0,100
490,208,298,18.854603174603174,21.269478458049885,31.0,32.0,138,2.0,90
491,208,428,18.854603174603174,20.456780045351476,31.0,31.0,231,2.0,220
492,208,615,18.854603174603174,20.89795918367347,31.0,3.0,416,2.0,407
493,246,184,19.82984126984127,21.5481179138322,27.0,31.0,97,2.0,62
494,246,183,19.82984126984127,22.244716553287983,27.0,33.0,122,2.0,63
495,246,298,19.82984126984127,21.269478458049885,27.0,32.0,81,1.0,52
496,246,409,19.82984126984127,22.50013605442177,27.0,29.0,199,3.0,163
497,246,417,19.82984126984127,21.966077097505668,27.0,23.0,194,2.0,171
498,246,411,19.82984126984127,22.546575963718823,27.0,31.0,202,3.0,165
499,246,615,19.82984126984127,20.89795918367347,27.0,3.0,372,1.0,369
500,246,615,19.82984126984127,22.01251700680272,27.0,2.0,381,2.0,369
501,308,184,20.387120181405898,21.5481179138322,31.0,31.0,134,1.0,124
502,308,183,20.387120181405898,22.244716553287983,31.0,33.0,148,2.0,125
503,308,409,20.387120181405898,22.50013605442177,31.0,29.0,136,2.0,101
504,308,417,20.387120181405898,21.966077097505668,31.0,23.0,128,2.0,109
505,308,411,20.387120181405898,22.546575963718823,31.0,31.0,139,2.0,103
506,308,430,20.387120181405898,23.127074829931974,31.0,23.0,170,3.0,122
507,308,772,20.387120181405898,21.5481179138322,31.0,9.0,467,1.0,464
508,308,615,20.387120181405898,22.01251700680272,31.0,2.0,315,2.0,307
509,298,193,21.269478458049885,23.823673469387757,32.0,31.0,152,3.0,105
510,298,409,21.269478458049885,22.50013605442177,32.0,29.0,123,1.0,111
511,298,221,21.269478458049885,23.823673469387757,32.0,33.0,134,3.0,77
512,298,411,21.269478458049885,22.546575963718823,32.0,31.0,126,1.0,113
513,298,430,21.269478458049885,23.127074829931974,32.0,23.0,154,2.0,132
514,409,193,22.50013605442177,23.823673469387757,29.0,31.0,223,1.0,216
515,409,69,22.50013605442177,24.589931972789117,29.0,30.0,352,2.0,340
516,409,152,22.50013605442177,25.44907029478458,29.0,32.0,287,3.0,257
517,409,221,22.50013605442177,23.823673469387757,29.0,33.0,196,1.0,188
518,409,230,22.50013605442177,24.380952380952383,29.0,30.0,196,2.0,179
519,409,231,22.50013605442177,25.123990929705215,29.0,30.0,211,3.0,178
520,409,417,22.50013605442177,24.380952380952383,29.0,21.0,81,2.0,8
521,409,809,22.50013605442177,23.84689342403628,29.0,11.0,404,1.0,400
522,409,806,22.50013605442177,24.752471655328797,29.0,12.0,409,2.0,397
523,409,637,22.50013605442177,25.123990929705215,29.0,6.0,254,3.0,228
524,409,848,22.50013605442177,23.84689342403628,29.0,8.0,443,1.0,439
525,409,853,22.50013605442177,24.79891156462585,29.0,5.0,455,2.0,444
526,409,847,22.50013605442177,25.123990929705215,29.0,5.0,452,3.0,438
527,221,152,23.823673469387757,25.44907029478458,33.0,32.0,98,2.0,69
528,221,183,23.823673469387757,26.656507936507936,33.0,35.0,128,3.0,38
529,221,231,23.823673469387757,25.123990929705215,33.0,30.0,57,1.0,10
530,221,306,23.823673469387757,26.63328798185941,33.0,33.0,148,3.0,85
531,221,410,23.823673469387757,25.774149659863944,33.0,24.0,207,2.0,189
532,221,410,23.823673469387757,26.076009070294784,33.0,24.0,212,2.0,189
533,221,637,23.823673469387757,25.123990929705215,33.0,6.0,420,1.0,416
534,230,152,24.380952380952383,25.44907029478458,30.0,32.0,91,1.0,78
535,230,183,24.380952380952383,26.656507936507936,30.0,35.0,109,2.0,47
536,230,171,24.380952380952383,27.00480725623583,30.0,33.0,127,3.0,59
537,230,306,24.380952380952383,26.63328798185941,30.0,33.0,123,2.0,76
538,230,410,24.380952380952383,25.774149659863944,30.0,24.0,190,1.0,180
539,230,410,24.380952380952383,26.076009070294784,30.0,24.0,194,2.0,180
540,230,411,24.380952380952383,27.00480725623583,30.0,31.0,213,3.0,181
541,231,183,25.123990929705215,26.656507936507936,30.0,35.0,82,2.0,48
542,231,171,25.123990929705215,27.00480725623583,30.0,33.0,101,2.0,60
543,231,306,25.123990929705215,26.63328798185941,30.0,33.0,99,2.0,75
544,231,307,25.123990929705215,27.840725623582767,30.0,31.0,140,3.0,76
545,231,411,25.123990929705215,27.00480725623583,30.0,31.0,197,2.0,180
546,306,184,26.63328798185941,28.676643990929705,33.0,29.0,150,2.0,122
547,306,307,26.63328798185941,27.840725623582767,33.0,31.0,52,1.0,1
548,306,230,26.63328798185941,28.676643990929705,33.0,30.0,116,2.0,76
549,306,417,26.63328798185941,28.699863945578233,33.0,23.0,142,2.0,111
550,306,772,26.63328798185941,28.676643990929705,33.0,6.0,474,2.0,466
551,306,770,26.63328798185941,29.1178231292517,33.0,5.0,476,2.0,464
552,307,182,27.840725623582767,29.76798185941043,31.0,32.0,150,2.0,125
553,307,91,27.840725623582767,30.162721088435376,31.0,31.0,238,2.0,216
554,307,301,27.840725623582767,29.744761904761905,31.0,31.0,82,2.0,6
555,307,231,27.840725623582767,30.325260770975056,31.0,30.0,131,2.0,76
556,307,427,27.840725623582767,29.95374149659864,31.0,23.0,151,2.0,120
557,307,419,27.840725623582767,30.25560090702948,31.0,19.0,153,2.0,112
558,307,770,27.840725623582767,29.1178231292517,31.0,5.0,466,1.0,463
559,307,625,27.840725623582767,30.325260770975056,31.0,4.0,336,2.0,318
560,230,182,28.676643990929705,29.76798185941043,30.0,32.0,67,1.0,48
561,230,91,28.676643990929705,30.162721088435376,30.0,31.0,153,1.0,139
562,230,301,28.676643990929705,29.744761904761905,30.0,31.0,85,1.0,71
563,230,231,28.676643990929705,30.325260770975056,30.0,30.0,71,2.0,1
564,230,427,28.676643990929705,29.95374149659864,30.0,23.0,205,1.0,197
565,230,419,28.676643990929705,30.25560090702948,30.0,19.0,201,2.0,189
566,230,625,28.676643990929705,30.325260770975056,30.0,4.0,401,2.0,395
567,301,184,29.744761904761905,31.880997732426305,31.0,30.0,149,2.0,117
568,301,182,29.744761904761905,32.298956916099776,31.0,31.0,162,3.0,119
569,301,308,29.744761904761905,31.74167800453515,31.0,33.0,86,2.0,7
570,301,272,29.744761904761905,32.55437641723356,31.0,35.0,124,3.0,29
571,301,428,29.744761904761905,31.880997732426305,31.0,29.0,157,2.0,127
572,301,420,29.744761904761905,32.08997732426304,31.0,26.0,156,2.0,119
573,301,772,29.744761904761905,31.045079365079367,31.0,6.0,474,1.0,471
574,231,184,30.325260770975056,31.880997732426305,30.0,30.0,82,2.0,47
575,231,182,30.325260770975056,32.298956916099776,30.0,31.0,98,2.0,49
576,231,82,30.325260770975056,33.08843537414966,30.0,33.0,191,3.0,149
577,231,308,30.325260770975056,31.74167800453515,30.0,33.0,98,1.0,77
578,231,272,30.325260770975056,32.55437641723356,30.0,35.0,104,2.0,41
579,231,428,30.325260770975056,31.880997732426305,30.0,29.0,208,2.0,197
580,231,420,30.325260770975056,32.08997732426304,30.0,26.0,204,2.0,189
581,308,82,31.74167800453515,33.08843537414966,33.0,33.0,233,1.0,226
582,308,290,31.74167800453515,33.715374149659866,33.0,31.0,87,2.0,18
583,308,274,31.74167800453515,34.04045351473923,33.0,36.0,105,2.0,34
584,308,410,31.74167800453515,33.90113378684807,33.0,22.0,138,2.0,102
585,308,410,31.74167800453515,34.04045351473923,33.0,21.0,142,2.0,102
586,308,618,31.74167800453515,33.8314739229025,33.0,8.0,323,2.0,310
587,308,744,31.74167800453515,34.62095238095238,33.0,7.0,453,3.0,436
588,272,138,32.55437641723356,34.89959183673469,35.0,32.0,168,2.0,134
589,272,185,32.55437641723356,35.062131519274374,35.0,29.0,139,3.0,87
590,272,290,32.55437641723356,33.715374149659866,35.0,31.0,53,1.0,18
591,272,274,32.55437641723356,34.04045351473923,35.0,36.0,64,1.0,2
592,272,326,32.55437641723356,35.131791383219955,35.0,30.0,123,3.0,54
593,272,410,32.55437641723356,33.90113378684807,35.0,22.0,150,1.0,138
594,272,410,32.55437641723356,34.04045351473923,35.0,21.0,152,1.0,138
595,272,618,32.55437641723356,33.8314739229025,35.0,8.0,350,1.0,346
596,272,744,32.55437641723356,34.62095238095238,35.0,7.0,480,2.0,472
597,290,138,33.715374149659866,34.89959183673469,31.0,32.0,160,1.0,152
598,290,185,33.715374149659866,35.062131519274374,31.0,29.0,120,1.0,105
599,290,326,33.715374149659866,35.131791383219955,31.0,30.0,71,1.0,36
600,290,231,33.715374149659866,36.26956916099773,31.0,30.0,125,3.0,59
601,290,411,33.715374149659866,35.898049886621315,31.0,25.0,153,2.0,121
602,290,632,33.715374149659866,35.80517006802721,31.0,4.0,354,2.0,342
603,290,638,33.715374149659866,36.26956916099773,31.0,4.0,365,3.0,348
604,274,185,34.04045351473923,35.062131519274374,36.0,29.0,99,1.0,89
605,274,172,34.04045351473923,36.73396825396826,36.0,30.0,154,3.0,102
606,274,326,34.04045351473923,35.131791383219955,36.0,30.0,70,1.0,52
607,274,231,34.04045351473923,36.26956916099773,36.0,30.0,105,2.0,43
608,274,411,34.04045351473923,35.898049886621315,36.0,25.0,159,2.0,137
609,274,410,34.04045351473923,36.91972789115646,36.0,21.0,184,3.0,136
610,274,632,34.04045351473923,35.80517006802721,36.0,4.0,366,2.0,358
611,274,638,34.04045351473923,36.26956916099773,36.0,4.0,376,2.0,364
612,326,172,35.131791383219955,36.73396825396826,30.0,30.0,169,2.0,154
613,326,184,35.131791383219955,37.45378684807256,30.0,30.0,174,2.0,142
614,326,231,35.131791383219955,36.26956916099773,30.0,30.0,107,1.0,95
615,326,305,35.131791383219955,37.871746031746035,30.0,32.0,120,3.0,21
616,326,410,35.131791383219955,36.91972789115646,30.0,21.0,114,2.0,84
617,326,427,35.131791383219955,37.89496598639456,30.0,29.0,156,3.0,101
618,326,638,35.131791383219955,36.26956916099773,30.0,4.0,316,1.0,312
619,326,772,35.131791383219955,37.430566893424036,30.0,6.0,457,2.0,446
620,231,184,36.26956916099773,37.45378684807256,30.0,30.0,69,1.0,47
621,231,70,36.26956916099773,38.66122448979592,30.0,31.0,191,2.0,161
622,231,61,36.26956916099773,38.98630385487528,30.0,31.0,206,3.0,170
623,231,305,36.26956916099773,37.871746031746035,30.0,32.0,101,2.0,74
624,231,275,36.26956916099773,38.42902494331066,30.0,37.0,103,2.0,44
625,231,427,36.26956916099773,37.89496598639456,30.0,29.0,208,2.0,196
626,231,423,36.26956916099773,38.730884353741494,30.0,26.0,219,2.0,192
627,231,631,36.26956916099773,38.31292517006803,30.0,8.0,410,2.0,400
628,305,61,37.871746031746035,38.98630385487528,32.0,31.0,249,1.0,244
629,305,172,37.871746031746035,40.03120181405896,32.0,35.0,162,2.0,133
630,305,307,37.871746031746035,39.31138321995465,32.0,32.0,62,1.0,2
631,305,279,37.871746031746035,40.00798185941043,32.0,33.0,96,2.0,26
632,305,410,37.871746031746035,39.31138321995465,32.0,29.0,122,1.0,105
633,305,418,37.871746031746035,40.00798185941043,32.0,32.0,146,2.0,113
634,305,726,37.871746031746035,39.2649433106576,32.0,8.0,425,1.0,421
635,275,172,38.42902494331066,40.03120181405896,37.0,35.0,124,2.0,103
636,275,279,38.42902494331066,40.00798185941043,37.0,33.0,68,2.0,4
637,275,418,38.42902494331066,40.00798185941043,37.0,32.0,158,2.0,143
638,275,417,38.42902494331066,41.02965986394558,37.0,20.0,181,3.0,142
639,307,82,39.31138321995465,41.67981859410431,32.0,30.0,247,2.0,225
640,307,184,39.31138321995465,42.21387755102041,32.0,37.0,175,3.0,123
641,307,327,39.31138321995465,41.67981859410431,32.0,31.0,104,2.0,20
642,307,257,39.31138321995465,42.21387755102041,32.0,35.0,135,3.0,50
643,307,417,39.31138321995465,41.02965986394558,32.0,20.0,133,2.0,110
644,307,627,39.31138321995465,41.65659863945578,32.0,8.0,336,2.0,320
645,279,82,40.00798185941043,41.67981859410431,33.0,30.0,210,2.0,197
646,279,184,40.00798185941043,42.21387755102041,33.0,37.0,134,2.0,95
647,279,327,40.00798185941043,41.67981859410431,33.0,31.0,87,2.0,48
648,279,257,40.00798185941043,42.21387755102041,33.0,35.0,98,2.0,22
649,279,417,40.00798185941043,41.02965986394558,33.0,20.0,145,1.0,138
650,279,417,40.00798185941043,42.956916099773245,33.0,21.0,188,3.0,138
651,279,627,40.00798185941043,41.65659863945578,33.0,8.0,355,2.0,348
652,279,744,40.00798185941043,42.4692970521542,33.0,7.0,477,2.0,465
653,327,184,41.67981859410431,43.39809523809524,31.0,28.0,161,2.0,143
654,327,184,41.67981859410431,44.11791383219955,31.0,30.0,177,2.0,143
655,327,231,41.67981859410431,43.39809523809524,31.0,30.0,121,2.0,96
656,327,231,41.67981859410431,44.14113378684807,31.0,31.0,143,2.0,96
657,327,417,41.67981859410431,42.956916099773245,31.0,21.0,105,1.0,90
658,327,417,41.67981859410431,43.39809523809524,31.0,22.0,117,2.0,90
659,327,417,41.67981859410431,44.58231292517007,31.0,21.0,154,3.0,90
660,327,772,41.67981859410431,43.37487528344671,31.0,6.0,451,2.0,445
661,327,772,41.67981859410431,44.11791383219955,31.0,7.0,457,2.0,445
662,257,184,42.21387755102041,43.39809523809524,35.0,28.0,89,1.0,73
663,257,184,42.21387755102041,44.11791383219955,35.0,30.0,110,2.0,73
664,257,231,42.21387755102041,43.39809523809524,35.0,30.0,57,1.0,26
665,257,231,42.21387755102041,44.14113378684807,35.0,31.0,87,2.0,26
666,257,417,42.21387755102041,43.39809523809524,35.0,22.0,168,1.0,160
667,257,417,42.21387755102041,44.58231292517007,35.0,21.0,190,2.0,160
668,231,184,43.39809523809524,45.7665306122449,30.0,30.0,112,2.0,47
669,231,278,43.39809523809524,46.11482993197279,30.0,33.0,126,3.0,47
670,231,417,43.39809523809524,44.58231292517007,30.0,21.0,193,1.0,186
671,231,417,43.39809523809524,45.7665306122449,30.0,21.0,212,2.0,186
672,231,184,44.14113378684807,45.7665306122449,31.0,30.0,84,2.0,47
673,231,91,44.14113378684807,46.439909297052154,31.0,31.0,171,2.0,140
674,231,278,44.14113378684807,46.11482993197279,31.0,33.0,97,2.0,47
675,231,417,44.14113378684807,45.7665306122449,31.0,21.0,199,2.0,186
676,231,417,44.14113378684807,46.509569160997735,31.0,20.0,212,2.0,186
677,231,184,45.7665306122449,47.69378684807256,30.0,29.0,95,2.0,47
678,231,184,45.7665306122449,48.13496598639456,30.0,32.0,112,2.0,47
679,231,414,45.7665306122449,47.94920634920635,30.0,23.0,206,2.0,183
680,231,429,45.7665306122449,48.645804988662135,30.0,28.0,234,3.0,198
681,231,638,45.7665306122449,47.69378684807256,30.0,5.0,415,2.0,407
682,278,184,46.11482993197279,47.69378684807256,33.0,29.0,116,2.0,94
683,278,184,46.11482993197279,48.13496598639456,33.0,32.0,128,2.0,94
684,278,231,46.11482993197279,47.69378684807256,33.0,31.0,83,2.0,47
685,278,305,46.11482993197279,48.78512471655329,33.0,32.0,118,3.0,27
686,278,414,46.11482993197279,47.94920634920635,33.0,23.0,157,2.0,136
687,278,429,46.11482993197279,48.645804988662135,33.0,28.0,186,3.0,151
688,278,638,46.11482993197279,47.69378684807256,33.0,5.0,366,2.0,360
689,278,772,46.11482993197279,48.87800453514739,33.0,6.0,508,3.0,494
690,231,164,47.69378684807256,49.22630385487528,31.0,33.0,94,2.0,67
691,231,145,47.69378684807256,50.31764172335601,31.0,31.0,142,3.0,86
692,231,305,47.69378684807256,48.78512471655329,31.0,32.0,88,1.0,74
693,231,288,47.69378684807256,49.11020408163265,31.0,32.0,83,1.0,57
694,231,411,47.69378684807256,49.22630385487528,31.0,21.0,192,2.0,180
695,231,417,47.69378684807256,50.52662131519274,31.0,20.0,222,3.0,186
696,231,619,47.69378684807256,49.73714285714286,31.0,7.0,398,2.0,388
697,305,145,48.78512471655329,50.31764172335601,32.0,31.0,173,2.0,160
698,305,184,48.78512471655329,51.710839002267576,32.0,29.0,175,3.0,121
699,305,231,48.78512471655329,50.08544217687075,32.0,28.0,93,1.0,74
700,305,273,48.78512471655329,51.50185941043084,32.0,35.0,121,3.0,32
701,305,417,48.78512471655329,50.52662131519274,32.0,20.0,135,2.0,112
702,305,410,48.78512471655329,51.50185941043084,32.0,28.0,157,3.0,105
703,305,615,48.78512471655329,51.24643990929705,32.0,4.0,328,2.0,310
704,288,145,49.11020408163265,50.31764172335601,32.0,31.0,152,1.0,143
705,288,184,49.11020408163265,51.710839002267576,32.0,29.0,153,3.0,104
706,288,273,49.11020408163265,51.50185941043084,32.0,35.0,104,2.0,15
707,288,417,49.11020408163265,50.52662131519274,32.0,20.0,143,1.0,129
708,288,410,49.11020408163265,51.50185941043084,32.0,28.0,160,2.0,122
709,288,615,49.11020408163265,51.24643990929705,32.0,4.0,340,2.0,327
710,231,184,50.08544217687075,51.710839002267576,28.0,29.0,84,2.0,47
711,231,184,50.08544217687075,52.45387755102041,28.0,30.0,112,2.0,47
712,231,273,50.08544217687075,51.50185941043084,28.0,35.0,74,1.0,42
713,231,410,50.08544217687075,51.50185941043084,28.0,28.0,189,1.0,179
714,231,417,50.08544217687075,52.45387755102041,28.0,20.0,212,2.0,186
715,231,615,50.08544217687075,51.24643990929705,28.0,4.0,387,1.0,384
716,231,694,50.08544217687075,52.895056689342404,28.0,4.0,479,3.0,463
717,273,184,51.50185941043084,53.63809523809524,35.0,31.0,128,2.0,89
718,273,184,51.50185941043084,54.07927437641723,35.0,29.0,142,3.0,89
719,273,231,51.50185941043084,53.63809523809524,35.0,31.0,101,2.0,42
720,273,216,51.50185941043084,54.14893424036281,35.0,34.0,127,3.0,57
721,273,417,51.50185941043084,53.63809523809524,35.0,21.0,171,2.0,144
722,273,694,51.50185941043084,52.895056689342404,35.0,4.0,425,1.0,421
723,273,646,51.50185941043084,53.127256235827666,35.0,12.0,380,2.0,373
724,273,615,51.50185941043084,54.07927437641723,35.0,5.0,360,3.0,342
725,231,184,52.45387755102041,53.63809523809524,29.0,31.0,69,1.0,47
726,231,184,52.45387755102041,54.07927437641723,29.0,29.0,84,2.0,47
727,231,216,52.45387755102041,54.14893424036281,29.0,34.0,75,2.0,15
728,231,417,52.45387755102041,53.63809523809524,29.0,21.0,193,1.0,186
729,231,413,52.45387755102041,54.659773242630386,29.0,23.0,205,2.0,182
730,231,417,52.45387755102041,55.28671201814059,29.0,20.0,222,3.0,186
731,231,615,52.45387755102041,54.07927437641723,29.0,5.0,390,2.0,384
732,231,61,53.63809523809524,55.913650793650795,31.0,30.0,196,2.0,170
733,231,184,53.63809523809524,56.447709750566894,31.0,28.0,130,3.0,47
734,231,413,53.63809523809524,54.659773242630386,31.0,23.0,187,1.0,182
735,231,417,53.63809523809524,55.28671201814059,31.0,20.0,199,2.0,186
736,231,417,53.63809523809524,56.47092970521542,31.0,21.0,222,3.0,186
737,231,673,53.63809523809524,55.49569160997733,31.0,11.0,449,2.0,442
738,231,632,53.63809523809524,56.447709750566894,31.0,6.0,419,3.0,401
739,216,61,54.14893424036281,55.913650793650795,34.0,30.0,173,2.0,155
740,216,184,54.14893424036281,56.447709750566894,34.0,28.0,104,2.0,32
741,216,231,54.14893424036281,55.263492063492066,34.0,29.0,50,1.0,15
742,216,231,54.14893424036281,56.0065306122449,34.0,29.0,81,2.0,15
743,216,214,54.14893424036281,57.09786848072562,34.0,31.0,127,3.0,2
744,216,417,54.14893424036281,55.28671201814059,34.0,20.0,207,1.0,201
745,216,417,54.14893424036281,56.47092970521542,34.0,21.0,225,2.0,201
746,216,427,54.14893424036281,57.0746485260771,34.0,30.0,246,3.0,211
747,216,673,54.14893424036281,55.49569160997733,34.0,11.0,461,1.0,457
748,216,632,54.14893424036281,56.447709750566894,34.0,6.0,428,2.0,416
749,231,184,55.263492063492066,56.447709750566894,29.0,28.0,69,1.0,47
750,231,183,55.263492063492066,57.79446712018141,29.0,31.0,119,3.0,48
751,231,214,55.263492063492066,57.09786848072562,29.0,31.0,81,2.0,17
752,231,417,55.263492063492066,56.47092970521542,29.0,21.0,193,1.0,186
753,231,427,55.263492063492066,57.0746485260771,29.0,30.0,211,2.0,196
754,231,434,55.263492063492066,58.18920634920635,29.0,28.0,239,3.0,203
755,231,632,55.263492063492066,56.447709750566894,29.0,6.0,404,1.0,401
756,231,671,55.263492063492066,57.213968253968254,29.0,5.0,448,2.0,440
757,231,183,56.0065306122449,57.79446712018141,29.0,31.0,91,2.0,48
758,231,183,56.0065306122449,58.42140589569161,29.0,32.0,115,2.0,48
759,231,214,56.0065306122449,57.09786848072562,29.0,31.0,50,1.0,17
760,231,246,56.0065306122449,58.28208616780046,29.0,31.0,99,2.0,15
761,231,427,56.0065306122449,57.0746485260771,29.0,30.0,201,1.0,196
762,231,434,56.0065306122449,58.18920634920635,29.0,28.0,224,2.0,203
763,231,671,56.0065306122449,57.213968253968254,29.0,5.0,443,1.0,440
764,231,637,56.0065306122449,58.83936507936508,29.0,4.0,424,3.0,406
765,214,183,57.09786848072562,58.42140589569161,31.0,32.0,65,1.0,31
766,214,91,57.09786848072562,59.90748299319728,31.0,36.0,173,3.0,123
767,214,246,57.09786848072562,58.28208616780046,31.0,31.0,60,1.0,32
768,214,220,57.09786848072562,59.16444444444445,31.0,30.0,89,2.0,6
769,214,434,57.09786848072562,58.18920634920635,31.0,28.0,225,1.0,220
770,214,439,57.09786848072562,59.16444444444445,31.0,27.0,242,2.0,225
771,214,637,57.09786848072562,58.83936507936508,31.0,4.0,430,2.0,423
772,246,91,58.28208616780046,59.90748299319728,31.0,36.0,170,2.0,155
773,412,69,1.2306575963718822,3.947392290249433,30.0,33.0,362,3.0,343
774,412,246,1.2306575963718822,3.6687528344671203,30.0,40.0,196,2.0,166
775,412,485,1.2306575963718822,3.9706122448979593,30.0,30.0,139,3.0,73
776,412,658,1.2306575963718822,3.6687528344671203,30.0,10.0,267,2.0,246
777,412,694,1.2306575963718822,3.9938321995464854,30.0,4.0,306,3.0,282
778,412,825,1.2306575963718822,3.6919727891156464,30.0,6.0,426,2.0,413
779,493,69,2.159455782312925,3.947392290249433,17.0,33.0,431,2.0,424
780,493,185,2.159455782312925,4.272471655328799,17.0,31.0,321,2.0,308
781,493,65,2.159455782312925,4.992290249433107,17.0,27.0,445,3.0,428
782,493,246,2.159455782312925,3.6687528344671203,17.0,40.0,255,2.0,247
783,493,219,2.159455782312925,4.504671201814059,17.0,37.0,292,2.0,274
784,493,485,2.159455782312925,3.9706122448979593,17.0,30.0,78,2.0,8
785,493,430,2.159455782312925,4.272471655328799,17.0,28.0,111,2.0,63
786,493,658,2.159455782312925,3.6687528344671203,17.0,10.0,177,2.0,165
787,493,694,2.159455782312925,3.9938321995464854,17.0,4.0,216,2.0,201
788,493,825,2.159455782312925,3.6919727891156464,17.0,6.0,338,2.0,332
789,485,65,3.9706122448979593,4.992290249433107,30.0,27.0,422,1.0,420
790,485,91,3.9706122448979593,6.292607709750567,30.0,27.0,406,2.0,394
791,485,220,3.9706122448979593,5.410249433106576,30.0,38.0,272,1.0,265
792,485,246,3.9706122448979593,6.896326530612245,30.0,38.0,270,3.0,239
793,485,431,3.9706122448979593,5.38702947845805,30.0,23.0,81,1.0,54
794,485,484,3.9706122448979593,6.640907029478458,30.0,27.0,115,3.0,1
795,485,615,3.9706122448979593,6.339047619047619,30.0,9.0,165,2.0,130
796,430,91,4.272471655328799,6.292607709750567,28.0,27.0,350,2.0,339
797,430,220,4.272471655328799,5.410249433106576,28.0,38.0,216,1.0,210
798,430,246,4.272471655328799,6.896326530612245,28.0,38.0,216,3.0,184
799,430,431,4.272471655328799,5.38702947845805,28.0,23.0,48,1.0,1
800,430,484,4.272471655328799,6.640907029478458,28.0,27.0,115,2.0,54
801,430,615,4.272471655328799,6.339047619047619,28.0,9.0,205,2.0,185
802,431,164,5.38702947845805,7.801904761904762,23.0,31.0,287,2.0,267
803,431,246,5.38702947845805,6.896326530612245,23.0,38.0,196,2.0,185
804,431,246,5.38702947845805,7.778684807256236,23.0,37.0,212,2.0,185
805,431,484,5.38702947845805,6.640907029478458,23.0,27.0,76,1.0,53
806,431,491,5.38702947845805,7.778684807256236,23.0,29.0,119,2.0,60
807,431,644,5.38702947845805,7.75546485260771,23.0,5.0,236,2.0,213
808,484,164,6.640907029478458,7.801904761904762,27.0,31.0,324,1.0,320
809,484,151,6.640907029478458,8.40562358276644,27.0,28.0,342,2.0,333
810,484,246,6.640907029478458,7.778684807256236,27.0,37.0,243,1.0,238
811,484,247,6.640907029478458,8.382403628117913,27.0,31.0,249,2.0,237
812,484,491,6.640907029478458,7.778684807256236,27.0,29.0,49,1.0,7
813,484,485,6.640907029478458,8.70748299319728,27.0,28.0,89,2.0,1
814,484,485,6.640907029478458,9.287981859410431,27.0,30.0,114,3.0,1
815,484,644,6.640907029478458,7.75546485260771,27.0,5.0,167,1.0,160
816,484,616,6.640907029478458,8.962902494331066,27.0,5.0,166,2.0,132
817,484,620,6.640907029478458,9.264761904761905,27.0,6.0,177,3.0,136
818,484,824,6.640907029478458,8.382403628117913,27.0,3.0,348,2.0,340
819,491,90,7.778684807256236,9.891700680272109,29.0,32.0,411,2.0,401
820,491,82,7.778684807256236,10.750839002267574,29.0,29.0,429,3.0,409
821,491,348,7.778684807256236,9.659501133786849,29.0,30.0,164,2.0,143
822,491,246,7.778684807256236,10.170340136054422,29.0,32.0,266,2.0,245
823,491,485,7.778684807256236,9.287981859410431,29.0,30.0,65,2.0,6
824,491,431,7.778684807256236,10.147120181405896,29.0,27.0,118,2.0,60
825,491,616,7.778684807256236,8.962902494331066,29.0,5.0,135,1.0,125
826,491,620,7.778684807256236,9.264761904761905,29.0,6.0,144,1.0,129
827,491,619,7.778684807256236,10.518639455782314,29.0,13.0,174,3.0,128
828,485,90,8.70748299319728,9.891700680272109,28.0,32.0,398,1.0,395
829,485,82,8.70748299319728,10.750839002267574,28.0,29.0,412,2.0,403
830,485,185,8.70748299319728,11.377777777777778,28.0,31.0,321,3.0,300
831,485,246,8.70748299319728,10.170340136054422,28.0,32.0,247,1.0,239
832,485,246,8.70748299319728,11.354557823129252,28.0,32.0,265,3.0,239
833,485,431,8.70748299319728,10.147120181405896,28.0,27.0,82,1.0,54
834,485,492,8.70748299319728,11.377777777777778,28.0,26.0,115,3.0,7
835,485,619,8.70748299319728,10.518639455782314,28.0,13.0,155,2.0,134
836,485,626,8.70748299319728,10.983038548752834,28.0,10.0,172,2.0,141
837,485,856,8.70748299319728,11.331337868480725,28.0,6.0,388,3.0,371
838,485,82,9.287981859410431,10.750839002267574,30.0,29.0,408,1.0,403
839,485,185,9.287981859410431,11.377777777777778,30.0,31.0,313,2.0,300
840,485,246,9.287981859410431,11.354557823129252,30.0,32.0,255,2.0,239
841,485,492,9.287981859410431,11.377777777777778,30.0,26.0,90,2.0,7
842,485,619,9.287981859410431,10.518639455782314,30.0,13.0,144,1.0,134
843,485,626,9.287981859410431,10.983038548752834,30.0,10.0,159,2.0,141
844,485,856,9.287981859410431,11.331337868480725,30.0,6.0,381,2.0,371
845,431,185,10.147120181405896,11.377777777777778,27.0,31.0,252,1.0,246
846,431,182,10.147120181405896,12.956734693877552,27.0,31.0,277,3.0,249
847,431,181,10.147120181405896,12.979954648526077,27.0,34.0,278,3.0,250
848,431,246,10.147120181405896,11.354557823129252,27.0,32.0,192,1.0,185
849,431,218,10.147120181405896,12.701315192743765,27.0,38.0,240,3.0,213
850,431,492,10.147120181405896,11.377777777777778,27.0,26.0,81,1.0,61
851,431,435,10.147120181405896,12.701315192743765,27.0,24.0,110,3.0,4
852,431,615,10.147120181405896,12.654875283446712,27.0,7.0,213,3.0,184
853,431,856,10.147120181405896,11.331337868480725,27.0,6.0,428,1.0,425
854,492,182,11.377777777777778,12.956734693877552,26.0,31.0,317,2.0,310
855,492,181,11.377777777777778,12.979954648526077,26.0,34.0,319,2.0,311
856,492,218,11.377777777777778,12.701315192743765,26.0,38.0,280,1.0,274
857,492,247,11.377777777777778,13.14249433106576,26.0,29.0,257,2.0,245
858,492,219,11.377777777777778,14.02485260770975,26.0,33.0,296,3.0,273
859,492,435,11.377777777777778,12.701315192743765,26.0,24.0,81,1.0,57
860,492,483,11.377777777777778,13.421133786848072,26.0,25.0,88,2.0,9
861,492,615,11.377777777777778,12.654875283446712,26.0,7.0,135,1.0,123
862,492,719,11.377777777777778,13.165714285714285,26.0,9.0,240,2.0,227
863,492,861,11.377777777777778,13.14249433106576,26.0,4.0,377,2.0,369
864,435,82,12.701315192743765,14.721451247165533,24.0,31.0,364,2.0,353
865,435,219,12.701315192743765,14.02485260770975,24.0,33.0,223,1.0,216
866,435,598,12.701315192743765,14.55891156462585,24.0,19.0,182,2.0,163
867,435,745,12.701315192743765,14.55891156462585,24.0,13.0,320,2.0,310
868,435,650,12.701315192743765,15.301950113378686,24.0,9.0,242,3.0,215
869,435,846,12.701315192743765,14.55891156462585,24.0,6.0,419,2.0,411
870,435,825,12.701315192743765,15.32517006802721,24.0,10.0,406,3.0,390
871,483,82,13.421133786848072,14.721451247165533,25.0,31.0,405,1.0,401
872,483,185,13.421133786848072,15.836009070294786,25.0,30.0,316,2.0,298
873,483,242,13.421133786848072,15.789569160997733,25.0,38.0,262,2.0,241
874,483,598,13.421133786848072,14.55891156462585,25.0,19.0,125,1.0,115
875,483,410,13.421133786848072,15.743129251700681,25.0,26.0,124,2.0,73
876,483,745,13.421133786848072,14.55891156462585,25.0,13.0,267,1.0,262
877,483,650,13.421133786848072,15.301950113378686,25.0,9.0,186,2.0,167
878,483,616,13.421133786848072,16.393287981859412,25.0,18.0,185,3.0,133
879,483,846,13.421133786848072,14.55891156462585,25.0,6.0,366,1.0,363
880,483,825,13.421133786848072,15.32517006802721,25.0,10.0,352,2.0,342
881,598,185,14.55891156462585,15.836009070294786,19.0,30.0,417,1.0,413
882,598,172,14.55891156462585,17.507845804988662,19.0,33.0,445,3.0,426
883,598,242,14.55891156462585,15.789569160997733,19.0,38.0,360,1.0,356
884,598,300,14.55891156462585,16.904126984126986,19.0,35.0,315,2.0,298
885,598,410,14.55891156462585,15.743129251700681,19.0,26.0,195,1.0,188
886,598,483,14.55891156462585,16.114648526077097,19.0,26.0,133,2.0,115
887,598,411,14.55891156462585,17.2756462585034,19.0,30.0,221,3.0,187
888,598,616,14.55891156462585,16.393287981859412,19.0,18.0,81,2.0,18
889,598,852,14.55891156462585,16.416507936507937,19.0,11.0,266,2.0,254
890,598,826,14.55891156462585,17.507845804988662,19.0,3.0,261,3.0,228
891,410,82,15.743129251700681,16.904126984126986,26.0,31.0,332,1.0,328
892,410,172,15.743129251700681,17.507845804988662,26.0,33.0,250,2.0,238
893,410,171,15.743129251700681,18.3437641723356,26.0,36.0,264,3.0,239
894,410,300,15.743129251700681,16.904126984126986,26.0,35.0,121,1.0,110
895,410,246,15.743129251700681,17.925804988662133,26.0,35.0,189,2.0,164
896,410,411,15.743129251700681,17.2756462585034,26.0,30.0,66,2.0,1
897,410,659,15.743129251700681,17.925804988662133,26.0,5.0,266,2.0,249
898,410,615,15.743129251700681,18.018684807256236,26.0,8.0,227,2.0,205
899,410,826,15.743129251700681,17.507845804988662,26.0,3.0,423,2.0,416
900,410,850,15.743129251700681,18.22766439909297,26.0,5.0,453,2.0,440
901,483,172,16.114648526077097,17.507845804988662,26.0,33.0,317,1.0,311
902,483,171,16.114648526077097,18.3437641723356,26.0,36.0,326,2.0,312
903,483,170,16.114648526077097,19.040362811791383,26.0,30.0,337,3.0,313
904,483,246,16.114648526077097,17.925804988662133,26.0,35.0,250,2.0,237
905,483,208,16.114648526077097,18.854603174603174,26.0,31.0,299,3.0,275
906,483,411,16.114648526077097,17.2756462585034,26.0,30.0,88,1.0,72
907,483,485,16.114648526077097,18.808163265306124,26.0,28.0,116,3.0,2
908,483,659,16.114648526077097,17.925804988662133,26.0,5.0,193,2.0,176
909,483,615,16.114648526077097,18.018684807256236,26.0,8.0,155,2.0,132
910,483,826,16.114648526077097,17.507845804988662,26.0,3.0,348,1.0,343
911,483,850,16.114648526077097,18.22766439909297,26.0,5.0,378,2.0,367
912,411,171,17.2756462585034,18.3437641723356,30.0,36.0,244,1.0,240
913,411,170,17.2756462585034,19.040362811791383,30.0,30.0,253,2.0,241
914,411,208,17.2756462585034,18.854603174603174,30.0,31.0,214,2.0,203
915,411,246,17.2756462585034,19.82984126984127,30.0,27.0,198,3.0,165
916,411,485,17.2756462585034,18.808163265306124,30.0,28.0,99,2.0,74
917,411,475,17.2756462585034,19.272562358276645,30.0,24.0,107,2.0,64
918,411,806,17.2756462585034,19.272562358276645,30.0,3.0,404,2.0,395
919,485,184,18.808163265306124,20.433560090702947,28.0,34.0,309,2.0,301
920,485,184,18.808163265306124,21.5481179138322,28.0,31.0,323,3.0,301
921,485,246,18.808163265306124,19.82984126984127,28.0,27.0,243,1.0,239
922,485,308,18.808163265306124,20.387120181405898,28.0,31.0,190,2.0,177
923,485,298,18.808163265306124,21.269478458049885,28.0,32.0,215,2.0,187
924,485,428,18.808163265306124,20.456780045351476,28.0,31.0,91,2.0,57
925,485,615,18.808163265306124,20.89795918367347,28.0,3.0,158,2.0,130
926,485,772,18.808163265306124,21.5481179138322,28.0,9.0,310,3.0,287
927,485,860,18.808163265306124,21.61777777777778,28.0,5.0,394,3.0,375
928,475,184,19.272562358276645,20.433560090702947,24.0,34.0,295,1.0,291
929,475,184,19.272562358276645,21.5481179138322,24.0,31.0,307,2.0,291
930,475,183,19.272562358276645,22.244716553287983,24.0,33.0,319,3.0,292
931,475,308,19.272562358276645,20.387120181405898,24.0,31.0,174,1.0,167
932,475,298,19.272562358276645,21.269478458049885,24.0,32.0,197,2.0,177
933,475,428,19.272562358276645,20.456780045351476,24.0,31.0,69,1.0,47
934,475,417,19.272562358276645,21.966077097505668,24.0,23.0,130,3.0,58
935,475,615,19.272562358276645,20.89795918367347,24.0,3.0,157,2.0,140
936,475,772,19.272562358276645,21.5481179138322,24.0,9.0,313,2.0,297
937,475,615,19.272562358276645,22.01251700680272,24.0,2.0,183,3.0,140
938,475,860,19.272562358276645,21.61777777777778,24.0,5.0,398,2.0,385
939,428,184,20.456780045351476,21.5481179138322,31.0,31.0,248,1.0,244
940,428,183,20.456780045351476,22.244716553287983,31.0,33.0,257,2.0,245
941,428,409,20.456780045351476,22.50013605442177,31.0,29.0,90,2.0,19
942,428,417,20.456780045351476,21.966077097505668,31.0,23.0,66,2.0,11
943,428,411,20.456780045351476,22.546575963718823,31.0,31.0,92,2.0,17
944,428,430,20.456780045351476,23.127074829931974,31.0,23.0,115,3.0,2
945,428,772,20.456780045351476,21.5481179138322,31.0,9.0,347,1.0,344
946,428,615,20.456780045351476,22.01251700680272,31.0,2.0,199,2.0,187
947,428,860,20.456780045351476,21.61777777777778,31.0,5.0,435,1.0,432
948,417,193,21.966077097505668,23.823673469387757,23.0,31.0,238,2.0,224
949,417,69,21.966077097505668,24.589931972789117,23.0,30.0,366,3.0,348
950,417,221,21.966077097505668,23.823673469387757,23.0,33.0,212,2.0,196
951,417,230,21.966077097505668,24.380952380952383,23.0,30.0,214,2.0,187
952,417,430,21.966077097505668,23.127074829931974,23.0,23.0,52,1.0,13
953,417,809,21.966077097505668,23.84689342403628,23.0,11.0,400,2.0,392
954,417,806,21.966077097505668,24.752471655328797,23.0,12.0,407,3.0,389
955,417,848,21.966077097505668,23.84689342403628,23.0,8.0,439,2.0,431
956,417,853,21.966077097505668,24.79891156462585,23.0,5.0,453,3.0,436
957,411,193,22.546575963718823,23.823673469387757,31.0,31.0,225,1.0,218
958,411,69,22.546575963718823,24.589931972789117,31.0,30.0,353,2.0,342
959,411,152,22.546575963718823,25.44907029478458,31.0,32.0,288,3.0,259
960,411,221,22.546575963718823,23.823673469387757,31.0,33.0,198,1.0,190
961,411,230,22.546575963718823,24.380952380952383,31.0,30.0,197,2.0,181
962,411,231,22.546575963718823,25.123990929705215,31.0,30.0,211,3.0,180
963,411,417,22.546575963718823,24.380952380952383,31.0,21.0,79,2.0,6
964,411,809,22.546575963718823,23.84689342403628,31.0,11.0,402,1.0,398
965,411,806,22.546575963718823,24.752471655328797,31.0,12.0,406,2.0,395
966,411,637,22.546575963718823,25.123990929705215,31.0,6.0,252,3.0,226
967,411,848,22.546575963718823,23.84689342403628,31.0,8.0,441,1.0,437
968,411,853,22.546575963718823,24.79891156462585,31.0,5.0,453,2.0,442
969,411,847,22.546575963718823,25.123990929705215,31.0,5.0,450,3.0,436
970,430,69,23.127074829931974,24.589931972789117,23.0,30.0,366,1.0,361
971,430,152,23.127074829931974,25.44907029478458,23.0,32.0,295,2.0,278
972,430,230,23.127074829931974,24.380952380952383,23.0,30.0,207,1.0,200
973,430,231,23.127074829931974,25.123990929705215,23.0,30.0,217,2.0,199
974,430,417,23.127074829931974,24.380952380952383,23.0,21.0,56,1.0,13
975,430,410,23.127074829931974,25.774149659863944,23.0,24.0,116,3.0,20
976,430,410,23.127074829931974,26.076009070294784,23.0,24.0,129,3.0,20
977,430,806,23.127074829931974,24.752471655328797,23.0,12.0,382,2.0,376
978,430,637,23.127074829931974,25.123990929705215,23.0,6.0,224,2.0,207
979,430,853,23.127074829931974,24.79891156462585,23.0,5.0,429,2.0,423
980,430,847,23.127074829931974,25.123990929705215,23.0,5.0,426,2.0,417
981,417,152,24.380952380952383,25.44907029478458,21.0,32.0,269,1.0,265
982,417,183,24.380952380952383,26.656507936507936,21.0,35.0,254,2.0,234
983,417,171,24.380952380952383,27.00480725623583,21.0,33.0,271,3.0,246
984,417,306,24.380952380952383,26.63328798185941,21.0,33.0,147,2.0,111
985,417,410,24.380952380952383,25.774149659863944,21.0,24.0,60,1.0,7
986,417,410,24.380952380952383,26.076009070294784,21.0,24.0,73,2.0,7
987,417,411,24.380952380952383,27.00480725623583,21.0,31.0,113,3.0,6
988,417,809,24.380952380952383,26.21532879818594,21.0,13.0,400,2.0,392
989,417,879,24.380952380952383,26.23854875283447,21.0,8.0,469,2.0,462
990,410,171,25.774149659863944,27.00480725623583,24.0,33.0,245,1.0,239
991,410,184,25.774149659863944,28.676643990929705,24.0,29.0,258,3.0,226
992,410,307,25.774149659863944,27.840725623582767,24.0,31.0,136,2.0,103
993,410,230,25.774149659863944,28.676643990929705,24.0,30.0,219,3.0,180
994,410,411,25.774149659863944,27.00480725623583,24.0,31.0,53,1.0,1
995,410,417,25.774149659863944,28.699863945578233,24.0,23.0,126,3.0,7
996,410,812,25.774149659863944,27.445986394557824,24.0,10.0,408,2.0,402
997,410,772,25.774149659863944,28.676643990929705,24.0,6.0,383,3.0,362
998,410,827,25.774149659863944,27.747845804988664,24.0,6.0,426,2.0,417
999,410,848,25.774149659863944,28.676643990929705,24.0,5.0,455,3.0,438
1000,410,184,26.076009070294784,28.676643990929705,24.0,29.0,252,3.0,226
1001,410,307,26.076009070294784,27.840725623582767,24.0,31.0,128,2.0,103
1002,410,230,26.076009070294784,28.676643990929705,24.0,30.0,212,3.0,180
1003,410,417,26.076009070294784,28.699863945578233,24.0,23.0,113,3.0,7
1004,410,812,26.076009070294784,27.445986394557824,24.0,10.0,406,1.0,402
1005,410,772,26.076009070294784,28.676643990929705,24.0,6.0,379,3.0,362
1006,410,827,26.076009070294784,27.747845804988664,24.0,6.0,423,2.0,417
1007,410,848,26.076009070294784,28.676643990929705,24.0,5.0,452,3.0,438
1008,411,184,27.00480725623583,28.676643990929705,31.0,29.0,238,2.0,227
1009,411,182,27.00480725623583,29.76798185941043,31.0,32.0,258,3.0,229
1010,411,230,27.00480725623583,28.676643990929705,31.0,30.0,195,2.0,181
1011,411,301,27.00480725623583,29.744761904761905,31.0,31.0,161,3.0,110
1012,411,417,27.00480725623583,28.699863945578233,31.0,23.0,73,2.0,6
1013,411,427,27.00480725623583,29.95374149659864,31.0,23.0,128,3.0,16
1014,411,772,27.00480725623583,28.676643990929705,31.0,6.0,368,2.0,361
1015,411,770,27.00480725623583,29.1178231292517,31.0,5.0,370,2.0,359
1016,411,848,27.00480725623583,28.676643990929705,31.0,5.0,443,2.0,437
1017,417,182,28.699863945578233,29.76798185941043,23.0,32.0,239,1.0,235
1018,417,91,28.699863945578233,30.162721088435376,23.0,31.0,332,1.0,326
1019,417,301,28.699863945578233,29.744761904761905,23.0,31.0,124,1.0,116
1020,417,231,28.699863945578233,30.325260770975056,23.0,30.0,199,2.0,186
1021,417,427,28.699863945578233,29.95374149659864,23.0,23.0,55,1.0,10
1022,417,419,28.699863945578233,30.25560090702948,23.0,19.0,67,2.0,2
1023,417,625,28.699863945578233,30.325260770975056,23.0,4.0,219,2.0,208
1024,417,772,28.699863945578233,31.045079365079367,23.0,6.0,369,2.0,355
1025,417,866,28.699863945578233,31.068299319727892,23.0,4.0,460,2.0,449
1026,427,184,29.95374149659864,31.880997732426305,23.0,30.0,257,2.0,243
1027,427,182,29.95374149659864,32.298956916099776,23.0,31.0,265,2.0,245
1028,427,308,29.95374149659864,31.74167800453515,23.0,33.0,142,2.0,119
1029,427,272,29.95374149659864,32.55437641723356,23.0,35.0,191,3.0,155
1030,427,428,29.95374149659864,31.880997732426305,23.0,29.0,83,2.0,1
1031,427,420,29.95374149659864,32.08997732426304,23.0,26.0,92,2.0,7
1032,427,772,29.95374149659864,31.045079365079367,23.0,6.0,348,1.0,345
1033,427,819,29.95374149659864,32.15963718820862,23.0,5.0,403,2.0,392
1034,427,866,29.95374149659864,31.068299319727892,23.0,4.0,442,1.0,439
1035,427,820,29.95374149659864,32.15963718820862,23.0,5.0,404,2.0,393
1036,419,184,30.25560090702948,31.880997732426305,19.0,30.0,245,2.0,235
1037,419,182,30.25560090702948,32.298956916099776,19.0,31.0,253,2.0,237
1038,419,82,30.25560090702948,33.08843537414966,19.0,33.0,358,3.0,337
1039,419,308,30.25560090702948,31.74167800453515,19.0,33.0,128,1.0,111
1040,419,272,30.25560090702948,32.55437641723356,19.0,35.0,177,2.0,147
1041,419,428,30.25560090702948,31.880997732426305,19.0,29.0,71,2.0,9
1042,419,420,30.25560090702948,32.08997732426304,19.0,26.0,79,2.0,1
1043,419,819,30.25560090702948,32.15963718820862,19.0,5.0,408,2.0,400
1044,419,820,30.25560090702948,32.15963718820862,19.0,5.0,409,2.0,401
1045,428,82,31.880997732426305,33.08843537414966,29.0,33.0,350,1.0,346
1046,428,290,31.880997732426305,33.715374149659866,29.0,31.0,159,2.0,138
1047,428,274,31.880997732426305,34.04045351473923,29.0,36.0,180,2.0,154
1048,428,410,31.880997732426305,33.90113378684807,29.0,22.0,89,2.0,18
1049,428,410,31.880997732426305,34.04045351473923,29.0,21.0,95,2.0,18
1050,428,618,31.880997732426305,33.8314739229025,29.0,8.0,208,2.0,190
1051,428,744,31.880997732426305,34.62095238095238,29.0,7.0,337,3.0,316
1052,428,866,31.880997732426305,33.436734693877554,29.0,4.0,443,2.0,438
1053,428,854,31.880997732426305,34.04045351473923,29.0,3.0,436,2.0,426
1054,420,138,32.08997732426304,34.89959183673469,26.0,32.0,307,3.0,282
1055,420,185,32.08997732426304,35.062131519274374,26.0,29.0,268,3.0,235
1056,420,290,32.08997732426304,33.715374149659866,26.0,31.0,148,2.0,130
1057,420,274,32.08997732426304,34.04045351473923,26.0,36.0,168,2.0,146
1058,420,410,32.08997732426304,33.90113378684807,26.0,22.0,79,2.0,10
1059,420,410,32.08997732426304,34.04045351473923,26.0,21.0,85,2.0,10
1060,420,618,32.08997732426304,33.8314739229025,26.0,8.0,212,2.0,198
1061,420,744,32.08997732426304,34.62095238095238,26.0,7.0,342,3.0,324
1062,420,866,32.08997732426304,33.436734693877554,26.0,4.0,450,1.0,446
1063,420,854,32.08997732426304,34.04045351473923,26.0,3.0,442,2.0,434
1064,410,185,33.90113378684807,35.062131519274374,22.0,29.0,230,1.0,225
1065,410,172,33.90113378684807,36.73396825396826,22.0,30.0,267,3.0,238
1066,410,326,33.90113378684807,35.131791383219955,22.0,30.0,99,1.0,84
1067,410,231,33.90113378684807,36.26956916099773,22.0,30.0,206,2.0,179
1068,410,411,33.90113378684807,35.898049886621315,22.0,25.0,86,2.0,1
1069,410,632,33.90113378684807,35.80517006802721,22.0,4.0,237,2.0,222
1070,410,638,33.90113378684807,36.26956916099773,22.0,4.0,250,2.0,228
1071,410,860,33.90113378684807,35.71229024943311,22.0,3.0,457,2.0,450
1072,410,855,33.90113378684807,36.87328798185941,22.0,5.0,463,3.0,445
1073,410,185,34.04045351473923,35.062131519274374,21.0,29.0,229,1.0,225
1074,410,172,34.04045351473923,36.73396825396826,21.0,30.0,265,3.0,238
1075,410,326,34.04045351473923,35.131791383219955,21.0,30.0,96,1.0,84
1076,410,231,34.04045351473923,36.26956916099773,21.0,30.0,203,2.0,179
1077,410,411,34.04045351473923,35.898049886621315,21.0,25.0,80,2.0,1
1078,410,632,34.04045351473923,35.80517006802721,21.0,4.0,235,2.0,222
1079,410,638,34.04045351473923,36.26956916099773,21.0,4.0,247,2.0,228
1080,410,860,34.04045351473923,35.71229024943311,21.0,3.0,456,2.0,450
1081,410,855,34.04045351473923,36.87328798185941,21.0,5.0,461,3.0,445
1082,411,184,35.898049886621315,37.45378684807256,25.0,30.0,237,2.0,227
1083,411,70,35.898049886621315,38.66122448979592,25.0,31.0,361,3.0,341
1084,411,305,35.898049886621315,37.871746031746035,25.0,32.0,136,2.0,106
1085,411,275,35.898049886621315,38.42902494331066,25.0,37.0,174,3.0,136
1086,411,410,35.898049886621315,36.91972789115646,25.0,21.0,44,1.0,1
1087,411,427,35.898049886621315,37.89496598639456,25.0,29.0,87,2.0,16
1088,411,423,35.898049886621315,38.730884353741494,25.0,26.0,123,3.0,12
1089,411,772,35.898049886621315,37.430566893424036,25.0,6.0,367,2.0,361
1090,411,631,35.898049886621315,38.31292517006803,25.0,8.0,243,2.0,220
1091,411,846,35.898049886621315,37.45378684807256,25.0,5.0,440,2.0,435
1092,411,825,35.898049886621315,38.42902494331066,25.0,4.0,428,3.0,414
1093,410,70,36.91972789115646,38.66122448979592,21.0,31.0,348,2.0,340
1094,410,61,36.91972789115646,38.98630385487528,21.0,31.0,360,2.0,349
1095,410,275,36.91972789115646,38.42902494331066,21.0,37.0,150,2.0,135
1096,410,307,36.91972789115646,39.31138321995465,21.0,32.0,146,2.0,103
1097,410,423,36.91972789115646,38.730884353741494,21.0,26.0,79,2.0,13
1098,410,631,36.91972789115646,38.31292517006803,21.0,8.0,229,1.0,221
1099,410,726,36.91972789115646,39.2649433106576,21.0,8.0,332,2.0,316
1100,410,825,36.91972789115646,38.42902494331066,21.0,4.0,420,2.0,415
1101,410,829,36.91972789115646,39.2649433106576,21.0,6.0,431,2.0,419
1102,427,61,37.89496598639456,38.98630385487528,29.0,31.0,369,1.0,366
1103,427,172,37.89496598639456,40.03120181405896,29.0,35.0,271,2.0,255
1104,427,307,37.89496598639456,39.31138321995465,29.0,32.0,135,1.0,120
1105,427,279,37.89496598639456,40.00798185941043,29.0,33.0,174,2.0,148
1106,427,410,37.89496598639456,39.31138321995465,29.0,29.0,63,1.0,17
1107,427,418,37.89496598639456,40.00798185941043,29.0,32.0,91,2.0,9
1108,427,726,37.89496598639456,39.2649433106576,29.0,8.0,305,1.0,299
1109,427,805,37.89496598639456,40.28662131519275,29.0,10.0,392,2.0,378
1110,427,829,37.89496598639456,39.2649433106576,29.0,6.0,406,1.0,402
1111,427,862,37.89496598639456,40.03120181405896,29.0,10.0,445,2.0,435
1112,423,172,38.730884353741494,40.03120181405896,26.0,35.0,257,1.0,251
1113,423,82,38.730884353741494,41.67981859410431,26.0,30.0,364,3.0,341
1114,423,279,38.730884353741494,40.00798185941043,26.0,33.0,154,1.0,144
1115,423,327,38.730884353741494,41.67981859410431,26.0,31.0,159,3.0,96
1116,423,418,38.730884353741494,40.00798185941043,26.0,32.0,55,1.0,5
1117,423,417,38.730884353741494,41.02965986394558,26.0,20.0,99,2.0,6
1118,423,805,38.730884353741494,40.28662131519275,26.0,10.0,388,2.0,382
1119,423,627,38.730884353741494,41.65659863945578,26.0,8.0,240,3.0,204
1120,423,862,38.730884353741494,40.03120181405896,26.0,10.0,443,1.0,439
1121,410,82,39.31138321995465,41.67981859410431,29.0,30.0,343,2.0,328
1122,410,184,39.31138321995465,42.21387755102041,29.0,37.0,258,3.0,226
1123,410,327,39.31138321995465,41.67981859410431,29.0,31.0,132,2.0,83
1124,410,257,39.31138321995465,42.21387755102041,29.0,35.0,198,3.0,153
1125,410,417,39.31138321995465,41.02965986394558,29.0,20.0,74,2.0,7
1126,410,627,39.31138321995465,41.65659863945578,29.0,8.0,239,2.0,217
1127,418,82,40.00798185941043,41.67981859410431,32.0,30.0,344,2.0,336
1128,418,184,40.00798185941043,42.21387755102041,32.0,37.0,253,2.0,234
1129,418,327,40.00798185941043,41.67981859410431,32.0,31.0,116,2.0,91
1130,418,257,40.00798185941043,42.21387755102041,32.0,35.0,187,2.0,161
1131,418,417,40.00798185941043,41.02965986394558,32.0,20.0,44,1.0,1
1132,418,417,40.00798185941043,42.956916099773245,32.0,21.0,127,3.0,1
1133,418,627,40.00798185941043,41.65659863945578,32.0,8.0,221,2.0,209
1134,418,744,40.00798185941043,42.4692970521542,32.0,7.0,343,2.0,326
1135,417,184,41.02965986394558,42.21387755102041,20.0,37.0,239,1.0,233
1136,417,184,41.02965986394558,43.39809523809524,20.0,28.0,254,2.0,233
1137,417,257,41.02965986394558,42.21387755102041,20.0,35.0,168,1.0,160
1138,417,231,41.02965986394558,43.39809523809524,20.0,30.0,212,2.0,186
1139,417,744,41.02965986394558,42.4692970521542,20.0,7.0,333,1.0,327
1140,417,772,41.02965986394558,43.37487528344671,20.0,6.0,369,2.0,355
1141,417,184,42.956916099773245,44.11791383219955,21.0,30.0,238,1.0,233
1142,417,184,42.956916099773245,45.7665306122449,21.0,30.0,263,3.0,233
1143,417,231,42.956916099773245,44.14113378684807,21.0,31.0,193,1.0,186
1144,417,231,42.956916099773245,45.7665306122449,21.0,30.0,222,3.0,186
1145,417,772,42.956916099773245,44.11791383219955,21.0,7.0,359,1.0,355
1146,417,771,42.956916099773245,45.7665306122449,21.0,4.0,374,3.0,354
1147,417,847,42.956916099773245,44.11791383219955,21.0,3.0,433,1.0,430
1148,417,184,43.39809523809524,45.7665306122449,22.0,30.0,254,2.0,233
1149,417,231,43.39809523809524,45.7665306122449,22.0,30.0,212,2.0,186
1150,417,278,43.39809523809524,46.11482993197279,22.0,33.0,182,3.0,139
1151,417,771,43.39809523809524,45.7665306122449,22.0,4.0,368,2.0,354
1152,417,184,44.58231292517007,45.7665306122449,21.0,30.0,239,1.0,233
1153,417,91,44.58231292517007,46.439909297052154,21.0,31.0,336,2.0,326
1154,417,231,44.58231292517007,45.7665306122449,21.0,30.0,193,1.0,186
1155,417,278,44.58231292517007,46.11482993197279,21.0,33.0,154,2.0,139
1156,417,771,44.58231292517007,45.7665306122449,21.0,4.0,358,1.0,354
1157,417,773,44.58231292517007,46.95074829931973,21.0,5.0,370,2.0,356
1158,417,184,45.7665306122449,47.69378684807256,21.0,29.0,247,2.0,233
1159,417,184,45.7665306122449,48.13496598639456,21.0,32.0,254,2.0,233
1160,417,231,45.7665306122449,47.69378684807256,21.0,31.0,204,2.0,186
1161,417,414,45.7665306122449,47.94920634920635,21.0,23.0,94,2.0,3
1162,417,429,45.7665306122449,48.645804988662135,21.0,28.0,125,3.0,12
1163,417,773,45.7665306122449,46.95074829931973,21.0,5.0,360,1.0,356
1164,417,638,45.7665306122449,47.69378684807256,21.0,5.0,236,2.0,221
1165,417,865,45.7665306122449,48.13496598639456,21.0,3.0,459,2.0,448
1166,417,184,46.509569160997735,47.69378684807256,20.0,29.0,239,1.0,233
1167,417,184,46.509569160997735,48.13496598639456,20.0,32.0,243,2.0,233
1168,417,164,46.509569160997735,49.22630385487528,20.0,33.0,279,3.0,253
1169,417,231,46.509569160997735,47.69378684807256,20.0,31.0,193,1.0,186
1170,417,305,46.509569160997735,48.78512471655329,20.0,32.0,149,2.0,112
1171,417,288,46.509569160997735,49.11020408163265,20.0,32.0,171,3.0,129
1172,417,414,46.509569160997735,47.94920634920635,20.0,23.0,62,1.0,3
1173,417,429,46.509569160997735,48.645804988662135,20.0,28.0,93,2.0,12
1174,417,411,46.509569160997735,49.22630385487528,20.0,21.0,117,3.0,6
1175,417,638,46.509569160997735,47.69378684807256,20.0,5.0,227,1.0,221
1176,417,772,46.509569160997735,48.87800453514739,20.0,6.0,369,2.0,355
1177,417,865,46.509569160997735,48.13496598639456,20.0,3.0,453,2.0,448
1178,414,164,47.94920634920635,49.22630385487528,23.0,33.0,256,1.0,250
1179,414,145,47.94920634920635,50.31764172335601,23.0,31.0,288,2.0,269
1180,414,288,47.94920634920635,49.11020408163265,23.0,32.0,136,1.0,126
1181,414,231,47.94920634920635,50.08544217687075,23.0,28.0,205,2.0,183
1182,414,411,47.94920634920635,49.22630385487528,23.0,21.0,55,1.0,3
1183,414,417,47.94920634920635,50.52662131519274,23.0,20.0,111,3.0,3
1184,414,619,47.94920634920635,49.73714285714286,23.0,7.0,219,2.0,205
1185,414,813,47.94920634920635,50.45696145124717,23.0,9.0,413,3.0,399
1186,414,850,47.94920634920635,50.43374149659864,23.0,8.0,449,2.0,436
1187,429,145,48.645804988662135,50.31764172335601,28.0,31.0,293,2.0,284
1188,429,231,48.645804988662135,50.08544217687075,28.0,28.0,207,1.0,198
1189,429,273,48.645804988662135,51.50185941043084,28.0,35.0,199,3.0,156
1190,429,417,48.645804988662135,50.52662131519274,28.0,20.0,82,2.0,12
1191,429,410,48.645804988662135,51.50185941043084,28.0,28.0,124,3.0,19
1192,429,619,48.645804988662135,49.73714285714286,28.0,7.0,196,1.0,190
1193,429,813,48.645804988662135,50.45696145124717,28.0,9.0,392,2.0,384
1194,429,615,48.645804988662135,51.24643990929705,28.0,4.0,217,3.0,186
1195,429,850,48.645804988662135,50.43374149659864,28.0,8.0,428,2.0,421
1196,429,847,48.645804988662135,51.26965986394558,28.0,3.0,433,3.0,418
1197,411,145,49.22630385487528,50.31764172335601,21.0,31.0,270,1.0,266
1198,411,184,49.22630385487528,51.710839002267576,21.0,29.0,251,2.0,227
1199,411,273,49.22630385487528,51.50185941043084,21.0,35.0,169,2.0,138
1200,411,417,49.22630385487528,50.52662131519274,21.0,20.0,56,1.0,6
1201,411,410,49.22630385487528,51.50185941043084,21.0,28.0,98,2.0,1
1202,411,813,49.22630385487528,50.45696145124717,21.0,9.0,405,1.0,402
1203,411,615,49.22630385487528,51.24643990929705,21.0,4.0,222,2.0,204
1204,411,850,49.22630385487528,50.43374149659864,21.0,8.0,442,1.0,439
1205,411,847,49.22630385487528,51.26965986394558,21.0,3.0,445,2.0,436
1206,417,184,50.52662131519274,51.710839002267576,20.0,29.0,239,1.0,233
1207,417,184,50.52662131519274,52.45387755102041,20.0,30.0,247,2.0,233
1208,417,231,50.52662131519274,52.45387755102041,20.0,29.0,204,2.0,186
1209,417,694,50.52662131519274,52.895056689342404,20.0,4.0,295,2.0,277
1210,417,646,50.52662131519274,53.127256235827666,20.0,12.0,255,3.0,229
1211,417,866,50.52662131519274,52.45387755102041,20.0,3.0,457,2.0,449
1212,410,184,51.50185941043084,53.63809523809524,28.0,31.0,244,2.0,226
1213,410,184,51.50185941043084,54.07927437641723,28.0,29.0,252,3.0,226
1214,410,231,51.50185941043084,53.63809523809524,28.0,31.0,201,2.0,179
1215,410,216,51.50185941043084,54.14893424036281,28.0,34.0,225,3.0,194
1216,410,417,51.50185941043084,53.63809523809524,28.0,21.0,92,2.0,7
1217,410,694,51.50185941043084,52.895056689342404,28.0,4.0,290,1.0,284
1218,410,646,51.50185941043084,53.127256235827666,28.0,12.0,246,2.0,236
1219,410,615,51.50185941043084,54.07927437641723,28.0,5.0,233,3.0,205
1220,410,866,51.50185941043084,53.63809523809524,28.0,4.0,465,2.0,456
1221,417,184,52.45387755102041,53.63809523809524,20.0,31.0,239,1.0,233
1222,417,184,52.45387755102041,54.07927437641723,20.0,29.0,243,2.0,233
1223,417,231,52.45387755102041,53.63809523809524,20.0,31.0,193,1.0,186
1224,417,216,52.45387755102041,54.14893424036281,20.0,34.0,214,2.0,201
1225,417,231,52.45387755102041,55.263492063492066,20.0,29.0,222,3.0,186
1226,417,413,52.45387755102041,54.659773242630386,20.0,23.0,95,2.0,4
1227,417,615,52.45387755102041,54.07927437641723,20.0,5.0,210,2.0,198
1228,417,866,52.45387755102041,53.63809523809524,20.0,4.0,452,1.0,449
1229,417,61,53.63809523809524,55.913650793650795,21.0,30.0,369,2.0,356
1230,417,184,53.63809523809524,56.447709750566894,21.0,28.0,263,3.0,233
1231,417,231,53.63809523809524,55.263492063492066,21.0,29.0,199,2.0,186
1232,417,231,53.63809523809524,56.0065306122449,21.0,29.0,212,2.0,186
1233,417,413,53.63809523809524,54.659773242630386,21.0,23.0,44,1.0,4
1234,417,673,53.63809523809524,55.49569160997733,21.0,11.0,268,2.0,256
1235,417,632,53.63809523809524,56.447709750566894,21.0,6.0,247,3.0,215
1236,417,857,53.63809523809524,55.472471655328796,21.0,6.0,447,2.0,440
1237,417,847,53.63809523809524,56.447709750566894,21.0,6.0,447,3.0,430
1238,413,61,54.659773242630386,55.913650793650795,23.0,30.0,356,1.0,352
1239,413,184,54.659773242630386,56.447709750566894,23.0,28.0,242,2.0,229
1240,413,231,54.659773242630386,56.0065306122449,23.0,29.0,191,1.0,182
1241,413,214,54.659773242630386,57.09786848072562,23.0,31.0,225,2.0,199
1242,413,417,54.659773242630386,56.47092970521542,23.0,21.0,78,2.0,4
1243,413,427,54.659773242630386,57.0746485260771,23.0,30.0,105,2.0,14
1244,413,632,54.659773242630386,56.447709750566894,23.0,6.0,232,2.0,219
1245,413,671,54.659773242630386,57.213968253968254,23.0,5.0,280,3.0,258
1246,413,847,54.659773242630386,56.447709750566894,23.0,6.0,441,2.0,434
1247,417,184,55.28671201814059,56.447709750566894,20.0,28.0,238,1.0,233
1248,417,183,55.28671201814059,57.79446712018141,20.0,31.0,258,3.0,234
1249,417,214,55.28671201814059,57.09786848072562,20.0,31.0,217,2.0,203
1250,417,427,55.28671201814059,57.0746485260771,20.0,30.0,78,2.0,10
1251,417,434,55.28671201814059,58.18920634920635,20.0,28.0,126,3.0,17
1252,417,632,55.28671201814059,56.447709750566894,20.0,6.0,221,1.0,215
1253,417,671,55.28671201814059,57.213968253968254,20.0,5.0,267,2.0,254
1254,417,847,55.28671201814059,56.447709750566894,20.0,6.0,433,1.0,430
1255,417,183,56.47092970521542,57.79446712018141,21.0,31.0,241,1.0,234
1256,417,183,56.47092970521542,58.42140589569161,21.0,32.0,249,2.0,234
1257,417,246,56.47092970521542,58.28208616780046,21.0,31.0,188,2.0,171
1258,417,220,56.47092970521542,59.16444444444445,21.0,30.0,229,3.0,197
1259,417,434,56.47092970521542,58.18920634920635,21.0,28.0,76,2.0,17
1260,417,439,56.47092970521542,59.16444444444445,21.0,27.0,118,3.0,22
1261,417,637,56.47092970521542,58.83936507936508,21.0,4.0,242,2.0,220
1262,417,847,56.47092970521542,58.83936507936508,21.0,3.0,442,2.0,430
1263,427,183,57.0746485260771,58.42140589569161,30.0,32.0,251,1.0,244
1264,427,91,57.0746485260771,59.90748299319728,30.0,36.0,357,3.0,336
1265,427,246,57.0746485260771,58.28208616780046,30.0,31.0,188,1.0,181
1266,427,220,57.0746485260771,59.16444444444445,30.0,30.0,226,2.0,207
1267,427,434,57.0746485260771,58.18920634920635,30.0,28.0,49,1.0,7
1268,427,439,57.0746485260771,59.16444444444445,30.0,27.0,91,2.0,12
1269,427,637,57.0746485260771,58.83936507936508,30.0,4.0,223,2.0,210
1270,427,805,57.0746485260771,59.90748299319728,30.0,3.0,397,3.0,378
1271,427,847,57.0746485260771,58.83936507936508,30.0,3.0,427,2.0,420
1272,434,91,58.18920634920635,59.90748299319728,28.0,36.0,351,2.0,343
1273,434,805,58.18920634920635,59.90748299319728,28.0,3.0,378,2.0,371
1274,615,185,1.8575963718820863,4.272471655328799,12.0,31.0,442,2.0,430
1275,615,246,1.8575963718820863,3.6687528344671203,12.0,40.0,377,2.0,369
1276,615,219,1.8575963718820863,4.504671201814059,12.0,37.0,412,3.0,396
1277,615,485,1.8575963718820863,3.9706122448979593,12.0,30.0,159,2.0,130
1278,615,430,1.8575963718820863,4.272471655328799,12.0,28.0,212,2.0,185
1279,615,658,1.8575963718820863,3.6687528344671203,12.0,10.0,89,2.0,43
1280,615,694,1.8575963718820863,3.9938321995464854,12.0,4.0,121,2.0,79
1281,615,825,1.8575963718820863,3.6919727891156464,12.0,6.0,224,2.0,210
1282,658,220,3.6687528344671203,5.410249433106576,10.0,38.0,444,2.0,438
1283,658,431,3.6687528344671203,5.38702947845805,10.0,23.0,239,2.0,227
1284,658,484,3.6687528344671203,6.640907029478458,10.0,27.0,216,3.0,174
1285,658,615,3.6687528344671203,6.339047619047619,10.0,9.0,123,3.0,43
1286,694,220,3.9938321995464854,5.410249433106576,4.0,38.0,478,1.0,474
1287,694,246,3.9938321995464854,6.896326530612245,4.0,38.0,465,3.0,448
1288,694,431,3.9938321995464854,5.38702947845805,4.0,23.0,270,1.0,263
1289,694,484,3.9938321995464854,6.640907029478458,4.0,27.0,239,3.0,210
1290,694,615,3.9938321995464854,6.339047619047619,4.0,9.0,128,2.0,79
1291,615,164,6.339047619047619,7.801904761904762,9.0,31.0,455,1.0,451
1292,615,151,6.339047619047619,8.40562358276644,9.0,28.0,472,2.0,464
1293,615,246,6.339047619047619,7.778684807256236,9.0,37.0,374,1.0,369
1294,615,247,6.339047619047619,8.382403628117913,9.0,31.0,378,2.0,368
1295,615,491,6.339047619047619,7.778684807256236,9.0,29.0,139,1.0,124
1296,615,485,6.339047619047619,8.70748299319728,9.0,28.0,165,2.0,130
1297,615,485,6.339047619047619,9.287981859410431,9.0,30.0,182,3.0,130
1298,615,644,6.339047619047619,7.75546485260771,9.0,5.0,68,1.0,29
1299,615,616,6.339047619047619,8.962902494331066,9.0,5.0,113,3.0,1
1300,615,620,6.339047619047619,9.264761904761905,9.0,6.0,126,3.0,5
1301,615,824,6.339047619047619,8.382403628117913,9.0,3.0,227,2.0,209
1302,644,348,7.75546485260771,9.659501133786849,5.0,30.0,307,2.0,296
1303,644,246,7.75546485260771,10.170340136054422,5.0,32.0,411,2.0,398
1304,644,485,7.75546485260771,9.287981859410431,5.0,30.0,172,2.0,159
1305,644,431,7.75546485260771,10.147120181405896,5.0,27.0,237,2.0,213
1306,644,616,7.75546485260771,8.962902494331066,5.0,5.0,59,1.0,28
1307,644,620,7.75546485260771,9.264761904761905,5.0,6.0,69,2.0,24
1308,644,619,7.75546485260771,10.518639455782314,5.0,13.0,122,3.0,25
1309,616,185,8.962902494331066,11.377777777777778,5.0,31.0,443,2.0,431
1310,616,246,8.962902494331066,10.170340136054422,5.0,32.0,374,1.0,370
1311,616,246,8.962902494331066,11.354557823129252,5.0,32.0,384,2.0,370
1312,616,431,8.962902494331066,10.147120181405896,5.0,27.0,192,1.0,185
1313,616,492,8.962902494331066,11.377777777777778,5.0,26.0,162,2.0,124
1314,616,619,8.962902494331066,10.518639455782314,5.0,13.0,67,2.0,3
1315,616,626,8.962902494331066,10.983038548752834,5.0,10.0,88,2.0,10
1316,616,856,8.962902494331066,11.331337868480725,5.0,6.0,261,2.0,240
1317,620,185,9.264761904761905,11.377777777777778,6.0,31.0,444,2.0,435
1318,620,246,9.264761904761905,11.354557823129252,6.0,32.0,385,2.0,374
1319,620,492,9.264761904761905,11.377777777777778,6.0,26.0,157,2.0,128
1320,620,619,9.264761904761905,10.518639455782314,6.0,13.0,54,1.0,1
1321,620,626,9.264761904761905,10.983038548752834,6.0,10.0,74,2.0,6
1322,620,856,9.264761904761905,11.331337868480725,6.0,6.0,252,2.0,236
1323,619,182,10.518639455782314,12.956734693877552,13.0,31.0,449,2.0,437
1324,619,181,10.518639455782314,12.979954648526077,13.0,34.0,451,2.0,438
1325,619,218,10.518639455782314,12.701315192743765,13.0,38.0,412,2.0,401
1326,619,247,10.518639455782314,13.14249433106576,13.0,29.0,389,3.0,372
1327,619,435,10.518639455782314,12.701315192743765,13.0,24.0,207,2.0,184
1328,619,483,10.518639455782314,13.421133786848072,13.0,25.0,185,3.0,136
1329,619,615,10.518639455782314,12.654875283446712,13.0,7.0,92,2.0,4
1330,619,719,10.518639455782314,13.165714285714285,13.0,9.0,152,3.0,100
1331,619,861,10.518639455782314,13.14249433106576,13.0,4.0,267,3.0,242
1332,626,182,10.983038548752834,12.956734693877552,10.0,31.0,452,2.0,444
1333,626,181,10.983038548752834,12.979954648526077,10.0,34.0,453,2.0,445
1334,626,218,10.983038548752834,12.701315192743765,10.0,38.0,415,2.0,408
1335,626,247,10.983038548752834,13.14249433106576,10.0,29.0,390,2.0,379
1336,626,435,10.983038548752834,12.701315192743765,10.0,24.0,205,2.0,191
1337,626,483,10.983038548752834,13.421133786848072,10.0,25.0,177,2.0,143
1338,626,615,10.983038548752834,12.654875283446712,10.0,7.0,73,2.0,11
1339,626,719,10.983038548752834,13.165714285714285,10.0,9.0,132,2.0,93
1340,626,861,10.983038548752834,13.14249433106576,10.0,4.0,253,2.0,235
1341,615,219,12.654875283446712,14.02485260770975,7.0,33.0,400,1.0,396
1342,615,598,12.654875283446712,14.55891156462585,7.0,19.0,84,2.0,17
1343,615,745,12.654875283446712,14.55891156462585,7.0,13.0,154,2.0,130
1344,615,650,12.654875283446712,15.301950113378686,7.0,9.0,119,3.0,35
1345,615,846,12.654875283446712,14.55891156462585,7.0,6.0,245,2.0,231
1346,615,825,12.654875283446712,15.32517006802721,7.0,10.0,239,3.0,210
1347,719,242,13.165714285714285,15.789569160997733,9.0,38.0,490,3.0,477
1348,719,598,13.165714285714285,14.55891156462585,9.0,19.0,135,1.0,121
1349,719,410,13.165714285714285,15.743129251700681,9.0,26.0,328,3.0,309
1350,719,483,13.165714285714285,16.114648526077097,9.0,26.0,268,3.0,236
1351,719,745,13.165714285714285,14.55891156462585,9.0,13.0,65,1.0,26
1352,719,650,13.165714285714285,15.301950113378686,9.0,9.0,115,2.0,69
1353,719,846,13.165714285714285,14.55891156462585,9.0,6.0,140,1.0,127
1354,719,825,13.165714285714285,15.32517006802721,9.0,10.0,141,2.0,106
1355,745,300,14.55891156462585,16.904126984126986,13.0,35.0,456,2.0,445
1356,745,410,14.55891156462585,15.743129251700681,13.0,26.0,339,1.0,335
1357,745,483,14.55891156462585,16.114648526077097,13.0,26.0,270,2.0,262
1358,745,411,14.55891156462585,17.2756462585034,13.0,30.0,354,3.0,334
1359,745,616,14.55891156462585,16.393287981859412,13.0,18.0,151,2.0,129
1360,745,852,14.55891156462585,16.416507936507937,13.0,11.0,134,2.0,107
1361,745,826,14.55891156462585,17.507845804988662,13.0,3.0,151,3.0,81
1362,650,172,15.301950113378686,17.507845804988662,9.0,33.0,487,2.0,478
1363,650,300,15.301950113378686,16.904126984126986,9.0,35.0,357,2.0,350
1364,650,246,15.301950113378686,17.925804988662133,9.0,35.0,420,3.0,404
1365,650,411,15.301950113378686,17.2756462585034,9.0,30.0,254,2.0,239
1366,650,616,15.301950113378686,16.393287981859412,9.0,18.0,58,1.0,34
1367,650,659,15.301950113378686,17.925804988662133,9.0,5.0,113,3.0,9
1368,650,615,15.301950113378686,18.018684807256236,9.0,8.0,122,3.0,35
1369,650,852,15.301950113378686,16.416507936507937,9.0,11.0,208,1.0,202
1370,650,826,15.301950113378686,17.507845804988662,9.0,3.0,200,2.0,176
1371,650,850,15.301950113378686,18.22766439909297,9.0,5.0,236,3.0,200
1372,616,172,16.393287981859412,17.507845804988662,18.0,33.0,447,1.0,444
1373,616,171,16.393287981859412,18.3437641723356,18.0,36.0,453,2.0,445
1374,616,170,16.393287981859412,19.040362811791383,18.0,30.0,460,3.0,446
1375,616,246,16.393287981859412,17.925804988662133,18.0,35.0,376,2.0,370
1376,616,208,16.393287981859412,18.854603174603174,18.0,31.0,422,2.0,408
1377,616,485,16.393287981859412,18.808163265306124,18.0,28.0,167,2.0,131
1378,616,475,16.393287981859412,19.272562358276645,18.0,24.0,188,3.0,141
1379,616,659,16.393287981859412,17.925804988662133,18.0,5.0,79,2.0,43
1380,616,615,16.393287981859412,18.018684807256236,18.0,8.0,70,2.0,1
1381,616,806,16.393287981859412,19.272562358276645,18.0,3.0,227,3.0,190
1382,616,826,16.393287981859412,17.507845804988662,18.0,3.0,215,1.0,210
1383,616,850,16.393287981859412,18.22766439909297,18.0,5.0,247,2.0,234
1384,659,170,17.925804988662133,19.040362811791383,5.0,30.0,491,1.0,489
1385,659,184,17.925804988662133,20.433560090702947,5.0,34.0,487,3.0,475
1386,659,246,17.925804988662133,19.82984126984127,5.0,27.0,421,2.0,413
1387,659,308,17.925804988662133,20.387120181405898,5.0,31.0,367,2.0,351
1388,659,475,17.925804988662133,19.272562358276645,5.0,24.0,193,1.0,184
1389,659,428,17.925804988662133,20.456780045351476,5.0,31.0,255,3.0,231
1390,659,806,17.925804988662133,19.272562358276645,5.0,3.0,158,1.0,147
1391,659,615,17.925804988662133,20.89795918367347,5.0,3.0,135,3.0,44
1392,615,170,18.018684807256236,19.040362811791383,8.0,30.0,447,1.0,445
1393,615,184,18.018684807256236,20.433560090702947,8.0,34.0,443,2.0,431
1394,615,246,18.018684807256236,19.82984126984127,8.0,27.0,377,2.0,369
1395,615,308,18.018684807256236,20.387120181405898,8.0,31.0,324,2.0,307
1396,615,475,18.018684807256236,19.272562358276645,8.0,24.0,150,1.0,140
1397,615,428,18.018684807256236,20.456780045351476,8.0,31.0,214,2.0,187
1398,615,806,18.018684807256236,19.272562358276645,8.0,3.0,198,1.0,191
1399,806,308,19.272562358276645,20.387120181405898,3.0,31.0,500,1.0,498
1400,806,428,19.272562358276645,20.456780045351476,3.0,31.0,381,1.0,378
1401,806,417,19.272562358276645,21.966077097505668,3.0,23.0,406,3.0,389
1402,806,615,19.272562358276645,20.89795918367347,3.0,3.0,203,2.0,191
1403,806,772,19.272562358276645,21.5481179138322,3.0,9.0,104,2.0,34
1404,806,615,19.272562358276645,22.01251700680272,3.0,2.0,225,3.0,191
1405,806,860,19.272562358276645,21.61777777777778,3.0,5.0,115,2.0,54
1406,615,183,20.89795918367347,22.244716553287983,3.0,33.0,436,1.0,432
1407,615,193,20.89795918367347,23.823673469387757,3.0,31.0,440,3.0,422
1408,615,409,20.89795918367347,22.50013605442177,3.0,29.0,217,2.0,206
1409,615,221,20.89795918367347,23.823673469387757,3.0,33.0,414,3.0,394
1410,615,417,20.89795918367347,21.966077097505668,3.0,23.0,203,1.0,198
1411,615,411,20.89795918367347,22.546575963718823,3.0,31.0,216,2.0,204
1412,615,430,20.89795918367347,23.127074829931974,3.0,23.0,208,2.0,185
1413,615,809,20.89795918367347,23.84689342403628,3.0,11.0,232,3.0,194
1414,615,848,20.89795918367347,23.84689342403628,3.0,8.0,265,3.0,233
1415,772,430,21.5481179138322,23.127074829931974,9.0,23.0,349,2.0,342
1416,772,417,21.5481179138322,24.380952380952383,9.0,21.0,375,3.0,355
1417,772,809,21.5481179138322,23.84689342403628,9.0,11.0,106,2.0,37
1418,772,848,21.5481179138322,23.84689342403628,9.0,8.0,125,2.0,76
1419,615,193,22.01251700680272,23.823673469387757,2.0,31.0,429,2.0,422
1420,615,221,22.01251700680272,23.823673469387757,2.0,33.0,402,2.0,394
1421,615,230,22.01251700680272,24.380952380952383,2.0,30.0,398,2.0,385
1422,615,430,22.01251700680272,23.127074829931974,2.0,23.0,191,1.0,185
1423,615,417,22.01251700680272,24.380952380952383,2.0,21.0,223,2.0,198
1424,615,809,22.01251700680272,23.84689342403628,2.0,11.0,209,2.0,194
1425,615,806,22.01251700680272,24.752471655328797,2.0,12.0,225,3.0,191
1426,615,848,22.01251700680272,23.84689342403628,2.0,8.0,246,2.0,233
1427,615,853,22.01251700680272,24.79891156462585,2.0,5.0,267,3.0,238
1428,809,410,23.84689342403628,25.774149659863944,11.0,24.0,408,2.0,399
1429,809,410,23.84689342403628,26.076009070294784,11.0,24.0,410,2.0,399
1430,809,637,23.84689342403628,25.123990929705215,11.0,6.0,181,1.0,172
1431,809,847,23.84689342403628,25.123990929705215,11.0,5.0,67,1.0,38
1432,809,879,23.84689342403628,26.23854875283447,11.0,8.0,125,2.0,70
1433,806,410,24.752471655328797,25.774149659863944,12.0,24.0,398,1.0,396
1434,806,410,24.752471655328797,26.076009070294784,12.0,24.0,400,1.0,396
1435,806,411,24.752471655328797,27.00480725623583,12.0,31.0,407,2.0,395
1436,806,809,24.752471655328797,26.21532879818594,12.0,13.0,63,1.0,3
1437,806,812,24.752471655328797,27.445986394557824,12.0,10.0,116,3.0,6
1438,806,879,24.752471655328797,26.23854875283447,12.0,8.0,97,1.0,73
1439,637,183,25.123990929705215,26.656507936507936,6.0,35.0,459,2.0,454
1440,637,171,25.123990929705215,27.00480725623583,6.0,33.0,473,2.0,466
1441,637,306,25.123990929705215,26.63328798185941,6.0,33.0,337,2.0,331
1442,637,307,25.123990929705215,27.840725623582767,6.0,31.0,350,3.0,330
1443,637,411,25.123990929705215,27.00480725623583,6.0,31.0,240,2.0,226
1444,637,809,25.123990929705215,26.21532879818594,6.0,13.0,178,1.0,172
1445,637,812,25.123990929705215,27.445986394557824,6.0,10.0,202,2.0,175
1446,637,879,25.123990929705215,26.23854875283447,6.0,8.0,247,1.0,242
1447,637,827,25.123990929705215,27.747845804988664,6.0,6.0,221,3.0,190
1448,809,417,26.21532879818594,28.699863945578233,13.0,23.0,406,2.0,392
1449,809,812,26.21532879818594,27.445986394557824,13.0,10.0,53,1.0,3
1450,809,772,26.21532879818594,28.676643990929705,13.0,6.0,112,2.0,37
1451,809,770,26.21532879818594,29.1178231292517,13.0,5.0,131,3.0,39
1452,809,827,26.21532879818594,27.747845804988664,13.0,6.0,68,2.0,18
1453,809,848,26.21532879818594,28.676643990929705,13.0,5.0,113,2.0,39
1454,812,417,27.445986394557824,28.699863945578233,10.0,23.0,399,1.0,395
1455,812,427,27.445986394557824,29.95374149659864,10.0,23.0,400,3.0,385
1456,812,419,27.445986394557824,30.25560090702948,10.0,19.0,411,3.0,393
1457,812,772,27.445986394557824,28.676643990929705,10.0,6.0,66,1.0,40
1458,812,770,27.445986394557824,29.1178231292517,10.0,5.0,83,2.0,42
1459,812,625,27.445986394557824,30.325260770975056,10.0,4.0,224,3.0,187
1460,812,848,27.445986394557824,28.676643990929705,10.0,5.0,64,1.0,36
1461,772,301,28.676643990929705,29.744761904761905,6.0,31.0,473,1.0,471
1462,772,427,28.676643990929705,29.95374149659864,6.0,23.0,349,1.0,345
1463,772,419,28.676643990929705,30.25560090702948,6.0,19.0,359,2.0,353
1464,772,625,28.676643990929705,30.325260770975056,6.0,4.0,163,2.0,147
1465,772,866,28.676643990929705,31.068299319727892,6.0,4.0,139,2.0,94
1466,770,308,29.1178231292517,31.74167800453515,5.0,33.0,476,3.0,462
1467,770,419,29.1178231292517,30.25560090702948,5.0,19.0,354,1.0,351
1468,770,428,29.1178231292517,31.880997732426305,5.0,29.0,362,3.0,342
1469,770,420,29.1178231292517,32.08997732426304,5.0,26.0,373,3.0,350
1470,770,625,29.1178231292517,30.325260770975056,5.0,4.0,154,1.0,145
1471,770,772,29.1178231292517,31.045079365079367,5.0,6.0,83,2.0,2
1472,770,866,29.1178231292517,31.068299319727892,5.0,4.0,128,2.0,96
1473,625,184,30.325260770975056,31.880997732426305,4.0,30.0,446,2.0,441
1474,625,182,30.325260770975056,32.298956916099776,4.0,31.0,451,2.0,443
1475,625,308,30.325260770975056,31.74167800453515,4.0,33.0,323,1.0,317
1476,625,272,30.325260770975056,32.55437641723356,4.0,35.0,366,2.0,353
1477,625,428,30.325260770975056,31.880997732426305,4.0,29.0,208,2.0,197
1478,625,420,30.325260770975056,32.08997732426304,4.0,26.0,219,2.0,205
1479,625,819,30.325260770975056,32.15963718820862,4.0,5.0,209,2.0,194
1480,625,820,30.325260770975056,32.15963718820862,4.0,5.0,210,2.0,195
1481,772,290,31.045079365079367,33.715374149659866,6.0,31.0,496,3.0,482
1482,772,420,31.045079365079367,32.08997732426304,6.0,26.0,355,1.0,352
1483,772,410,31.045079365079367,33.90113378684807,6.0,22.0,382,3.0,362
1484,772,819,31.045079365079367,32.15963718820862,6.0,5.0,67,1.0,47
1485,772,618,31.045079365079367,33.8314739229025,6.0,8.0,195,3.0,154
1486,772,820,31.045079365079367,32.15963718820862,6.0,5.0,68,1.0,48
1487,772,866,31.045079365079367,33.436734693877554,6.0,4.0,139,2.0,94
1488,819,326,32.15963718820862,35.131791383219955,5.0,30.0,509,3.0,493
1489,819,410,32.15963718820862,33.90113378684807,5.0,22.0,416,2.0,409
1490,819,410,32.15963718820862,34.04045351473923,5.0,21.0,417,2.0,409
1491,819,618,32.15963718820862,33.8314739229025,5.0,8.0,214,2.0,201
1492,819,744,32.15963718820862,34.62095238095238,5.0,7.0,130,2.0,75
1493,819,866,32.15963718820862,33.436734693877554,5.0,4.0,72,1.0,47
1494,819,854,32.15963718820862,34.04045351473923,5.0,3.0,88,2.0,35
1495,618,138,33.8314739229025,34.89959183673469,8.0,32.0,482,1.0,480
1496,618,185,33.8314739229025,35.062131519274374,8.0,29.0,436,1.0,433
1497,618,172,33.8314739229025,36.73396825396826,8.0,30.0,463,3.0,446
1498,618,326,33.8314739229025,35.131791383219955,8.0,30.0,297,1.0,292
1499,618,231,33.8314739229025,36.26956916099773,8.0,30.0,401,2.0,387
1500,618,411,33.8314739229025,35.898049886621315,8.0,25.0,225,2.0,207
1501,618,632,33.8314739229025,35.80517006802721,8.0,4.0,86,2.0,14
1502,618,638,33.8314739229025,36.26956916099773,8.0,4.0,107,2.0,20
1503,618,860,33.8314739229025,35.71229024943311,8.0,3.0,255,2.0,242
1504,744,411,34.62095238095238,35.898049886621315,7.0,25.0,338,1.0,333
1505,744,410,34.62095238095238,36.91972789115646,7.0,21.0,348,2.0,334
1506,744,632,34.62095238095238,35.80517006802721,7.0,4.0,123,1.0,112
1507,744,638,34.62095238095238,36.26956916099773,7.0,4.0,128,2.0,106
1508,744,772,34.62095238095238,37.430566893424036,7.0,6.0,124,3.0,28
1509,744,860,34.62095238095238,35.71229024943311,7.0,3.0,125,1.0,116
1510,744,855,34.62095238095238,36.87328798185941,7.0,5.0,147,2.0,111
1511,744,846,34.62095238095238,37.45378684807256,7.0,5.0,159,3.0,102
1512,632,184,35.80517006802721,37.45378684807256,4.0,30.0,454,2.0,448
1513,632,305,35.80517006802721,37.871746031746035,4.0,32.0,339,2.0,327
1514,632,275,35.80517006802721,38.42902494331066,4.0,37.0,374,3.0,357
1515,632,410,35.80517006802721,36.91972789115646,4.0,21.0,227,1.0,222
1516,632,427,35.80517006802721,37.89496598639456,4.0,29.0,224,2.0,205
1517,632,423,35.80517006802721,38.730884353741494,4.0,26.0,244,3.0,209
1518,632,772,35.80517006802721,37.430566893424036,4.0,6.0,157,2.0,140
1519,632,631,35.80517006802721,38.31292517006803,4.0,8.0,108,3.0,1
1520,632,855,35.80517006802721,36.87328798185941,4.0,5.0,228,1.0,223
1521,632,846,35.80517006802721,37.45378684807256,4.0,5.0,225,2.0,214
1522,632,825,35.80517006802721,38.42902494331066,4.0,4.0,224,3.0,193
1523,638,184,36.26956916099773,37.45378684807256,4.0,30.0,457,1.0,454
1524,638,305,36.26956916099773,37.871746031746035,4.0,32.0,340,2.0,333
1525,638,275,36.26956916099773,38.42902494331066,4.0,37.0,375,2.0,363
1526,638,427,36.26956916099773,37.89496598639456,4.0,29.0,222,2.0,211
1527,638,423,36.26956916099773,38.730884353741494,4.0,26.0,240,2.0,215
1528,638,772,36.26956916099773,37.430566893424036,4.0,6.0,143,1.0,134
1529,638,631,36.26956916099773,38.31292517006803,4.0,8.0,88,2.0,7
1530,638,846,36.26956916099773,37.45378684807256,4.0,5.0,214,1.0,208
1531,638,825,36.26956916099773,38.42902494331066,4.0,4.0,209,2.0,187
1532,772,307,37.430566893424036,39.31138321995465,6.0,32.0,472,2.0,465
1533,772,279,37.430566893424036,40.00798185941043,6.0,33.0,505,3.0,493
1534,772,423,37.430566893424036,38.730884353741494,6.0,26.0,353,1.0,349
1535,772,410,37.430566893424036,39.31138321995465,6.0,29.0,371,2.0,362
1536,772,418,37.430566893424036,40.00798185941043,6.0,32.0,371,3.0,354
1537,772,726,37.430566893424036,39.2649433106576,6.0,8.0,91,2.0,46
1538,772,805,37.430566893424036,40.28662131519275,6.0,10.0,127,3.0,33
1539,772,829,37.430566893424036,39.2649433106576,6.0,6.0,97,2.0,57
1540,772,862,37.430566893424036,40.03120181405896,6.0,10.0,144,3.0,90
1541,631,172,38.31292517006803,40.03120181405896,8.0,35.0,465,2.0,459
1542,631,279,38.31292517006803,40.00798185941043,8.0,33.0,359,2.0,352
1543,631,418,38.31292517006803,40.00798185941043,8.0,32.0,225,2.0,213
1544,631,417,38.31292517006803,41.02965986394558,8.0,20.0,244,3.0,214
1545,631,805,38.31292517006803,40.28662131519275,8.0,10.0,194,2.0,174
1546,631,862,38.31292517006803,40.03120181405896,8.0,10.0,243,2.0,231
1547,726,327,39.2649433106576,41.67981859410431,8.0,31.0,412,2.0,399
1548,726,257,39.2649433106576,42.21387755102041,8.0,35.0,486,3.0,469
1549,726,417,39.2649433106576,41.02965986394558,8.0,20.0,318,2.0,309
1550,726,805,39.2649433106576,40.28662131519275,8.0,10.0,90,1.0,79
1551,726,627,39.2649433106576,41.65659863945578,8.0,8.0,143,2.0,99
1552,805,327,40.28662131519275,41.67981859410431,10.0,31.0,482,1.0,478
1553,805,417,40.28662131519275,42.956916099773245,10.0,21.0,405,3.0,388
1554,805,627,40.28662131519275,41.65659863945578,10.0,8.0,188,1.0,178
1555,805,744,40.28662131519275,42.4692970521542,10.0,7.0,112,2.0,61
1556,627,184,41.65659863945578,43.39809523809524,8.0,28.0,449,2.0,443
1557,627,184,41.65659863945578,44.11791383219955,8.0,30.0,456,2.0,443
1558,627,231,41.65659863945578,43.39809523809524,8.0,30.0,403,2.0,396
1559,627,231,41.65659863945578,44.14113378684807,8.0,31.0,410,2.0,396
1560,627,417,41.65659863945578,42.956916099773245,8.0,21.0,217,1.0,210
1561,627,417,41.65659863945578,43.39809523809524,8.0,22.0,223,2.0,210
1562,627,417,41.65659863945578,44.58231292517007,8.0,21.0,245,3.0,210
1563,627,772,41.65659863945578,43.37487528344671,8.0,6.0,163,2.0,145
1564,627,772,41.65659863945578,44.11791383219955,8.0,7.0,180,2.0,145
1565,627,847,41.65659863945578,44.11791383219955,8.0,3.0,244,2.0,220
1566,744,417,42.4692970521542,44.58231292517007,7.0,21.0,339,2.0,327
1567,744,772,42.4692970521542,44.11791383219955,7.0,7.0,76,2.0,28
1568,744,847,42.4692970521542,44.11791383219955,7.0,3.0,125,2.0,103
1569,772,278,43.37487528344671,46.11482993197279,6.0,33.0,508,3.0,494
1570,772,417,43.37487528344671,44.58231292517007,6.0,21.0,359,1.0,355
1571,772,417,43.37487528344671,45.7665306122449,6.0,21.0,370,2.0,355
1572,772,771,43.37487528344671,45.7665306122449,6.0,4.0,103,2.0,1
1573,772,278,44.11791383219955,46.11482993197279,7.0,33.0,501,2.0,494
1574,772,417,44.11791383219955,45.7665306122449,7.0,21.0,362,2.0,355
1575,772,417,44.11791383219955,46.509569160997735,7.0,20.0,370,2.0,355
1576,772,771,44.11791383219955,45.7665306122449,7.0,4.0,71,2.0,1
1577,772,773,44.11791383219955,46.95074829931973,7.0,5.0,122,3.0,1
1578,771,414,45.7665306122449,47.94920634920635,4.0,23.0,369,2.0,357
1579,771,429,45.7665306122449,48.645804988662135,4.0,28.0,364,3.0,342
1580,771,773,45.7665306122449,46.95074829931973,4.0,5.0,51,1.0,2
1581,771,638,45.7665306122449,47.69378684807256,4.0,5.0,157,2.0,133
1582,771,865,45.7665306122449,48.13496598639456,4.0,3.0,139,2.0,94
1583,773,305,46.95074829931973,48.78512471655329,5.0,32.0,475,2.0,468
1584,773,288,46.95074829931973,49.11020408163265,5.0,32.0,494,2.0,485
1585,773,429,46.95074829931973,48.645804988662135,5.0,28.0,352,2.0,344
1586,773,411,46.95074829931973,49.22630385487528,5.0,21.0,375,2.0,362
1587,773,772,46.95074829931973,48.87800453514739,5.0,6.0,83,2.0,1
1588,773,619,46.95074829931973,49.73714285714286,5.0,7.0,195,3.0,154
1589,773,865,46.95074829931973,48.13496598639456,5.0,3.0,105,1.0,92
1590,638,164,47.69378684807256,49.22630385487528,5.0,33.0,479,2.0,474
1591,638,145,47.69378684807256,50.31764172335601,5.0,31.0,506,3.0,493
1592,638,305,47.69378684807256,48.78512471655329,5.0,32.0,336,1.0,333
1593,638,288,47.69378684807256,49.11020408163265,5.0,32.0,355,1.0,350
1594,638,231,47.69378684807256,50.08544217687075,5.0,28.0,420,2.0,407
1595,638,411,47.69378684807256,49.22630385487528,5.0,21.0,236,2.0,227
1596,638,417,47.69378684807256,50.52662131519274,5.0,20.0,252,3.0,221
1597,638,772,47.69378684807256,48.87800453514739,5.0,6.0,143,1.0,134
1598,638,619,47.69378684807256,49.73714285714286,5.0,7.0,90,2.0,19
1599,638,813,47.69378684807256,50.45696145124717,5.0,9.0,212,3.0,175
1600,638,850,47.69378684807256,50.43374149659864,5.0,8.0,243,3.0,212
1601,772,273,48.87800453514739,51.50185941043084,6.0,35.0,512,3.0,499
1602,772,417,48.87800453514739,50.52662131519274,6.0,20.0,362,2.0,355
1603,772,410,48.87800453514739,51.50185941043084,6.0,28.0,379,3.0,362
1604,772,813,48.87800453514739,50.45696145124717,6.0,9.0,79,2.0,41
1605,772,615,48.87800453514739,51.24643990929705,6.0,4.0,187,2.0,157
1606,772,850,48.87800453514739,50.43374149659864,6.0,8.0,103,2.0,78
1607,772,847,48.87800453514739,51.26965986394558,6.0,3.0,127,2.0,75
1608,619,184,49.73714285714286,51.710839002267576,7.0,29.0,443,2.0,435
1609,619,184,49.73714285714286,52.45387755102041,7.0,30.0,450,3.0,435
1610,619,273,49.73714285714286,51.50185941043084,7.0,35.0,354,2.0,346
1611,619,231,49.73714285714286,52.45387755102041,7.0,29.0,405,3.0,388
1612,619,410,49.73714285714286,51.50185941043084,7.0,28.0,222,2.0,209
1613,619,417,49.73714285714286,52.45387755102041,7.0,20.0,233,3.0,202
1614,619,615,49.73714285714286,51.24643990929705,7.0,4.0,65,2.0,4
1615,619,847,49.73714285714286,51.26965986394558,7.0,3.0,237,2.0,228
1616,619,866,49.73714285714286,52.45387755102041,7.0,3.0,273,3.0,247
1617,813,410,50.45696145124717,51.50185941043084,9.0,28.0,406,1.0,403
1618,813,417,50.45696145124717,52.45387755102041,9.0,20.0,405,2.0,396
1619,813,694,50.45696145124717,52.895056689342404,9.0,4.0,159,2.0,119
1620,813,646,50.45696145124717,53.127256235827666,9.0,12.0,203,3.0,167
1621,813,866,50.45696145124717,52.45387755102041,9.0,3.0,101,2.0,53
1622,615,184,51.24643990929705,52.45387755102041,4.0,30.0,434,1.0,431
1623,615,184,51.24643990929705,53.63809523809524,4.0,31.0,443,2.0,431
1624,615,184,51.24643990929705,54.07927437641723,4.0,29.0,448,3.0,431
1625,615,231,51.24643990929705,52.45387755102041,4.0,29.0,388,1.0,384
1626,615,231,51.24643990929705,53.63809523809524,4.0,31.0,398,2.0,384
1627,615,216,51.24643990929705,54.14893424036281,4.0,34.0,418,3.0,399
1628,615,417,51.24643990929705,52.45387755102041,4.0,20.0,205,1.0,198
1629,615,417,51.24643990929705,53.63809523809524,4.0,21.0,223,2.0,198
1630,615,694,51.24643990929705,52.895056689342404,4.0,4.0,106,2.0,79
1631,615,646,51.24643990929705,53.127256235827666,4.0,12.0,87,2.0,31
1632,615,866,51.24643990929705,52.45387755102041,4.0,3.0,256,1.0,251
1633,615,866,51.24643990929705,53.63809523809524,4.0,4.0,271,2.0,251
1634,694,216,52.895056689342404,54.14893424036281,4.0,34.0,481,1.0,478
1635,694,231,52.895056689342404,55.263492063492066,4.0,29.0,474,2.0,463
1636,694,413,52.895056689342404,54.659773242630386,4.0,23.0,291,2.0,281
1637,694,417,52.895056689342404,55.28671201814059,4.0,20.0,296,2.0,277
1638,694,615,52.895056689342404,54.07927437641723,4.0,5.0,94,1.0,79
1639,694,673,52.895056689342404,55.49569160997733,4.0,11.0,114,3.0,21
1640,694,857,52.895056689342404,55.472471655328796,4.0,6.0,197,3.0,163
1641,646,216,53.127256235827666,54.14893424036281,12.0,34.0,432,1.0,430
1642,646,231,53.127256235827666,55.263492063492066,12.0,29.0,425,2.0,415
1643,646,231,53.127256235827666,56.0065306122449,12.0,29.0,433,3.0,415
1644,646,413,53.127256235827666,54.659773242630386,12.0,23.0,242,2.0,233
1645,646,417,53.127256235827666,55.28671201814059,12.0,20.0,247,2.0,229
1646,646,673,53.127256235827666,55.49569160997733,12.0,11.0,106,2.0,27
1647,646,857,53.127256235827666,55.472471655328796,12.0,6.0,234,2.0,211
1648,615,184,54.07927437641723,56.447709750566894,5.0,28.0,443,2.0,431
1649,615,231,54.07927437641723,55.263492063492066,5.0,29.0,387,1.0,384
1650,615,231,54.07927437641723,56.0065306122449,5.0,29.0,393,2.0,384
1651,615,417,54.07927437641723,55.28671201814059,5.0,20.0,205,1.0,198
1652,615,417,54.07927437641723,56.47092970521542,5.0,21.0,223,2.0,198
1653,615,673,54.07927437641723,55.49569160997733,5.0,11.0,84,1.0,58
1654,615,632,54.07927437641723,56.447709750566894,5.0,6.0,103,2.0,17
1655,615,857,54.07927437641723,55.472471655328796,5.0,6.0,249,1.0,242
1656,615,847,54.07927437641723,56.447709750566894,5.0,6.0,253,2.0,232
1657,673,183,55.49569160997733,57.79446712018141,11.0,31.0,500,2.0,490
1658,673,183,55.49569160997733,58.42140589569161,11.0,32.0,506,3.0,490
1659,673,214,55.49569160997733,57.09786848072562,11.0,31.0,464,2.0,459
1660,673,246,55.49569160997733,58.28208616780046,11.0,31.0,444,3.0,427
1661,673,427,55.49569160997733,57.0746485260771,11.0,30.0,255,2.0,246
1662,673,434,55.49569160997733,58.18920634920635,11.0,28.0,266,3.0,239
1663,673,671,55.49569160997733,57.213968253968254,11.0,5.0,74,2.0,2
1664,632,183,56.447709750566894,57.79446712018141,6.0,31.0,453,1.0,449
1665,632,183,56.447709750566894,58.42140589569161,6.0,32.0,457,2.0,449
1666,632,246,56.447709750566894,58.28208616780046,6.0,31.0,394,2.0,386
1667,632,220,56.447709750566894,59.16444444444445,6.0,30.0,428,3.0,412
1668,632,434,56.447709750566894,58.18920634920635,6.0,28.0,212,2.0,198
1669,632,439,56.447709750566894,59.16444444444445,6.0,27.0,226,3.0,193
1670,632,637,56.447709750566894,58.83936507936508,6.0,4.0,103,2.0,5
1671,632,847,56.447709750566894,58.83936507936508,6.0,3.0,238,2.0,215
1672,671,183,57.213968253968254,58.42140589569161,5.0,32.0,491,1.0,488
1673,671,246,57.213968253968254,58.28208616780046,5.0,31.0,427,1.0,425
1674,671,220,57.213968253968254,59.16444444444445,5.0,30.0,459,2.0,451
1675,671,439,57.213968253968254,59.16444444444445,5.0,27.0,247,2.0,232
1676,671,637,57.213968253968254,58.83936507936508,5.0,4.0,78,2.0,34
1677,671,805,57.213968253968254,59.90748299319728,5.0,3.0,177,3.0,134
1678,671,847,57.213968253968254,58.83936507936508,5.0,3.0,189,2.0,176
1679,637,805,58.83936507936508,59.90748299319728,4.0,3.0,174,1.0,168
1680,860,485,1.8575963718820863,3.9706122448979593,5.0,30.0,386,2.0,375
1681,860,430,1.8575963718820863,4.272471655328799,5.0,28.0,442,2.0,430
1682,860,658,1.8575963718820863,3.6687528344671203,5.0,10.0,217,2.0,202
1683,860,694,1.8575963718820863,3.9938321995464854,5.0,4.0,190,2.0,166
1684,860,825,1.8575963718820863,3.6919727891156464,5.0,6.0,86,2.0,35
1685,825,431,3.6919727891156464,5.38702947845805,6.0,23.0,401,2.0,394
1686,825,484,3.6919727891156464,6.640907029478458,6.0,27.0,364,3.0,341
1687,825,615,3.6919727891156464,6.339047619047619,6.0,9.0,239,3.0,210
1688,824,348,8.382403628117913,9.659501133786849,3.0,30.0,479,1.0,476
1689,824,431,8.382403628117913,10.147120181405896,3.0,27.0,400,2.0,393
1690,824,619,8.382403628117913,10.518639455782314,3.0,13.0,225,2.0,205
1691,824,626,8.382403628117913,10.983038548752834,3.0,10.0,227,3.0,198
1692,824,856,8.382403628117913,11.331337868480725,3.0,6.0,131,3.0,32
1693,856,435,11.331337868480725,12.701315192743765,6.0,24.0,425,1.0,421
1694,856,483,11.331337868480725,13.421133786848072,6.0,25.0,384,2.0,373
1695,856,615,11.331337868480725,12.654875283446712,6.0,7.0,248,1.0,241
1696,856,719,11.331337868480725,13.165714285714285,6.0,9.0,158,2.0,137
1697,856,861,11.331337868480725,13.14249433106576,6.0,4.0,78,2.0,5
1698,861,598,13.14249433106576,14.55891156462585,4.0,19.0,270,1.0,263
1699,861,410,13.14249433106576,15.743129251700681,4.0,26.0,465,3.0,451
1700,861,483,13.14249433106576,16.114648526077097,4.0,26.0,399,3.0,378
1701,861,745,13.14249433106576,14.55891156462585,4.0,13.0,131,1.0,116
1702,861,650,13.14249433106576,15.301950113378686,4.0,9.0,231,2.0,211
1703,861,846,13.14249433106576,14.55891156462585,4.0,6.0,63,1.0,15
1704,861,825,13.14249433106576,15.32517006802721,4.0,10.0,101,2.0,36
1705,846,410,14.55891156462585,15.743129251700681,6.0,26.0,439,1.0,436
1706,846,483,14.55891156462585,16.114648526077097,6.0,26.0,369,2.0,363
1707,846,411,14.55891156462585,17.2756462585034,6.0,30.0,450,3.0,435
1708,846,616,14.55891156462585,16.393287981859412,6.0,18.0,243,2.0,230
1709,846,852,14.55891156462585,16.416507936507937,6.0,11.0,80,2.0,6
1710,846,826,14.55891156462585,17.507845804988662,6.0,3.0,129,3.0,20
1711,825,411,15.32517006802721,17.2756462585034,10.0,30.0,422,2.0,414
1712,825,616,15.32517006802721,16.393287981859412,10.0,18.0,214,1.0,209
1713,825,659,15.32517006802721,17.925804988662133,10.0,5.0,200,3.0,166
1714,825,615,15.32517006802721,18.018684807256236,10.0,8.0,240,3.0,210
1715,825,852,15.32517006802721,16.416507936507937,10.0,11.0,54,1.0,27
1716,825,826,15.32517006802721,17.507845804988662,10.0,3.0,94,2.0,1
1717,825,850,15.32517006802721,18.22766439909297,10.0,5.0,127,3.0,25
1718,852,485,16.416507936507937,18.808163265306124,11.0,28.0,381,2.0,367
1719,852,475,16.416507936507937,19.272562358276645,11.0,24.0,397,3.0,377
1720,852,659,16.416507936507937,17.925804988662133,11.0,5.0,204,2.0,193
1721,852,615,16.416507936507937,18.018684807256236,11.0,8.0,247,2.0,237
1722,852,806,16.416507936507937,19.272562358276645,11.0,3.0,131,3.0,46
1723,852,826,16.416507936507937,17.507845804988662,11.0,3.0,54,1.0,26
1724,852,850,16.416507936507937,18.22766439909297,11.0,5.0,78,2.0,2
1725,826,485,17.507845804988662,18.808163265306124,3.0,28.0,346,1.0,341
1726,826,475,17.507845804988662,19.272562358276645,3.0,24.0,359,2.0,351
1727,826,428,17.507845804988662,20.456780045351476,3.0,31.0,418,3.0,398
1728,826,806,17.507845804988662,19.272562358276645,3.0,3.0,79,2.0,20
1729,850,475,18.22766439909297,19.272562358276645,5.0,24.0,378,1.0,375
1730,850,428,18.22766439909297,20.456780045351476,5.0,31.0,433,2.0,422
1731,850,806,18.22766439909297,19.272562358276645,5.0,3.0,63,1.0,44
1732,850,615,18.22766439909297,20.89795918367347,5.0,3.0,262,3.0,235
1733,860,430,21.61777777777778,23.127074829931974,5.0,23.0,435,2.0,430
1734,860,417,21.61777777777778,24.380952380952383,5.0,21.0,459,3.0,443
1735,860,809,21.61777777777778,23.84689342403628,5.0,11.0,109,2.0,51
1736,860,848,21.61777777777778,23.84689342403628,5.0,8.0,97,2.0,12
1737,848,410,23.84689342403628,25.774149659863944,8.0,24.0,446,2.0,438
1738,848,410,23.84689342403628,26.076009070294784,8.0,24.0,448,2.0,438
1739,848,637,23.84689342403628,25.123990929705215,8.0,6.0,218,1.0,211
1740,848,809,23.84689342403628,26.21532879818594,8.0,13.0,109,2.0,39
1741,848,847,23.84689342403628,25.123990929705215,8.0,5.0,55,1.0,1
1742,848,879,23.84689342403628,26.23854875283447,8.0,8.0,108,2.0,31
1743,853,410,24.79891156462585,26.076009070294784,5.0,24.0,446,1.0,443
1744,853,411,24.79891156462585,27.00480725623583,5.0,31.0,452,2.0,442
1745,853,809,24.79891156462585,26.21532879818594,5.0,13.0,75,1.0,44
1746,853,812,24.79891156462585,27.445986394557824,5.0,10.0,121,3.0,41
1747,853,879,24.79891156462585,26.23854875283447,5.0,8.0,67,1.0,26
1748,853,827,24.79891156462585,27.747845804988664,5.0,6.0,130,3.0,26
1749,847,411,25.123990929705215,27.00480725623583,5.0,31.0,443,2.0,436
1750,847,809,25.123990929705215,26.21532879818594,5.0,13.0,60,1.0,38
1751,847,812,25.123990929705215,27.445986394557824,5.0,10.0,106,2.0,35
1752,847,879,25.123990929705215,26.23854875283447,5.0,8.0,58,1.0,32
1753,847,827,25.123990929705215,27.747845804988664,5.0,6.0,115,3.0,20
1754,879,417,26.23854875283447,28.699863945578233,8.0,23.0,474,2.0,462
1755,879,812,26.23854875283447,27.445986394557824,8.0,10.0,85,1.0,67
1756,879,772,26.23854875283447,28.676643990929705,8.0,6.0,150,2.0,107
1757,879,770,26.23854875283447,29.1178231292517,8.0,5.0,165,3.0,109
1758,879,827,26.23854875283447,27.747845804988664,8.0,6.0,83,2.0,52
1759,879,848,26.23854875283447,28.676643990929705,8.0,5.0,109,2.0,31
1760,827,427,27.747845804988664,29.95374149659864,6.0,23.0,411,2.0,400
1761,827,419,27.747845804988664,30.25560090702948,6.0,19.0,422,3.0,408
1762,827,770,27.747845804988664,29.1178231292517,6.0,5.0,82,1.0,57
1763,827,625,27.747845804988664,30.325260770975056,6.0,4.0,230,3.0,202
1764,848,427,28.676643990929705,29.95374149659864,5.0,23.0,425,1.0,421
1765,848,419,28.676643990929705,30.25560090702948,5.0,19.0,434,2.0,429
1766,848,625,28.676643990929705,30.325260770975056,5.0,4.0,234,2.0,223
1767,848,772,28.676643990929705,31.045079365079367,5.0,6.0,127,2.0,76
1768,848,866,28.676643990929705,31.068299319727892,5.0,4.0,105,2.0,18
1769,866,420,31.068299319727892,32.08997732426304,4.0,26.0,448,1.0,446
1770,866,410,31.068299319727892,33.90113378684807,4.0,22.0,472,3.0,456
1771,866,410,31.068299319727892,34.04045351473923,4.0,21.0,474,3.0,456
1772,866,819,31.068299319727892,32.15963718820862,4.0,5.0,66,1.0,47
1773,866,618,31.068299319727892,33.8314739229025,4.0,8.0,275,3.0,248
1774,866,820,31.068299319727892,32.15963718820862,4.0,5.0,66,1.0,46
1775,866,854,31.068299319727892,34.04045351473923,4.0,3.0,129,3.0,12
1776,820,326,32.15963718820862,35.131791383219955,5.0,30.0,510,3.0,494
1777,820,410,32.15963718820862,33.90113378684807,5.0,22.0,417,2.0,410
1778,820,410,32.15963718820862,34.04045351473923,5.0,21.0,418,2.0,410
1779,820,618,32.15963718820862,33.8314739229025,5.0,8.0,214,2.0,202
1780,820,744,32.15963718820862,34.62095238095238,5.0,7.0,130,2.0,76
1781,820,866,32.15963718820862,33.436734693877554,5.0,4.0,72,1.0,46
1782,820,854,32.15963718820862,34.04045351473923,5.0,3.0,88,2.0,34
1783,866,411,33.436734693877554,35.898049886621315,4.0,25.0,467,2.0,455
1784,866,744,33.436734693877554,34.62095238095238,4.0,7.0,132,1.0,122
1785,866,632,33.436734693877554,35.80517006802721,4.0,4.0,255,2.0,234
1786,866,638,33.436734693877554,36.26956916099773,4.0,4.0,259,3.0,228
1787,866,860,33.436734693877554,35.71229024943311,4.0,3.0,98,2.0,6
1788,854,411,34.04045351473923,35.898049886621315,3.0,25.0,450,2.0,443
1789,854,410,34.04045351473923,36.91972789115646,3.0,21.0,461,3.0,444
1790,854,632,34.04045351473923,35.80517006802721,3.0,4.0,235,2.0,222
1791,854,638,34.04045351473923,36.26956916099773,3.0,4.0,236,2.0,216
1792,854,860,34.04045351473923,35.71229024943311,3.0,3.0,72,2.0,6
1793,854,855,34.04045351473923,36.87328798185941,3.0,5.0,122,3.0,1
1794,860,410,35.71229024943311,36.91972789115646,3.0,21.0,453,1.0,450
1795,860,427,35.71229024943311,37.89496598639456,3.0,29.0,443,2.0,433
1796,860,772,35.71229024943311,37.430566893424036,3.0,6.0,115,2.0,88
1797,860,631,35.71229024943311,38.31292517006803,3.0,8.0,255,3.0,229
1798,860,855,35.71229024943311,36.87328798185941,3.0,5.0,50,1.0,5
1799,860,846,35.71229024943311,37.45378684807256,3.0,5.0,76,2.0,14
1800,860,825,35.71229024943311,38.42902494331066,3.0,4.0,122,3.0,35
1801,855,427,36.87328798185941,37.89496598639456,5.0,29.0,430,1.0,428
1802,855,423,36.87328798185941,38.730884353741494,5.0,26.0,439,2.0,432
1803,855,410,36.87328798185941,39.31138321995465,5.0,29.0,457,2.0,445
1804,855,631,36.87328798185941,38.31292517006803,5.0,8.0,232,1.0,224
1805,855,726,36.87328798185941,39.2649433106576,5.0,8.0,165,2.0,129
1806,855,825,36.87328798185941,38.42902494331066,5.0,4.0,73,2.0,30
1807,855,829,36.87328798185941,39.2649433106576,5.0,6.0,106,2.0,26
1808,846,423,37.45378684807256,38.730884353741494,5.0,26.0,427,1.0,423
1809,846,410,37.45378684807256,39.31138321995465,5.0,29.0,443,2.0,436
1810,846,418,37.45378684807256,40.00798185941043,5.0,32.0,442,3.0,428
1811,846,726,37.45378684807256,39.2649433106576,5.0,8.0,143,2.0,120
1812,846,805,37.45378684807256,40.28662131519275,5.0,10.0,129,3.0,41
1813,846,829,37.45378684807256,39.2649433106576,5.0,6.0,80,2.0,17
1814,846,862,37.45378684807256,40.03120181405896,5.0,10.0,112,3.0,16
1815,825,418,38.42902494331066,40.00798185941043,4.0,32.0,413,2.0,407
1816,825,417,38.42902494331066,41.02965986394558,4.0,20.0,423,3.0,408
1817,825,805,38.42902494331066,40.28662131519275,4.0,10.0,82,2.0,20
1818,825,862,38.42902494331066,40.03120181405896,4.0,10.0,78,2.0,37
1819,829,417,39.2649433106576,41.02965986394558,6.0,20.0,419,2.0,412
1820,829,805,39.2649433106576,40.28662131519275,6.0,10.0,50,1.0,24
1821,829,627,39.2649433106576,41.65659863945578,6.0,8.0,227,2.0,202
1822,862,417,40.03120181405896,42.956916099773245,10.0,21.0,462,3.0,445
1823,862,627,40.03120181405896,41.65659863945578,10.0,8.0,245,2.0,235
1824,862,744,40.03120181405896,42.4692970521542,10.0,7.0,158,2.0,118
1825,847,417,44.11791383219955,45.7665306122449,3.0,21.0,436,2.0,430
1826,847,417,44.11791383219955,46.509569160997735,3.0,20.0,442,2.0,430
1827,847,771,44.11791383219955,45.7665306122449,3.0,4.0,104,2.0,76
1828,847,773,44.11791383219955,46.95074829931973,3.0,5.0,143,3.0,74
1829,865,411,48.13496598639456,49.22630385487528,3.0,21.0,456,1.0,454
1830,865,417,48.13496598639456,50.52662131519274,3.0,20.0,460,2.0,448
1831,865,619,48.13496598639456,49.73714285714286,3.0,7.0,255,2.0,246
1832,865,813,48.13496598639456,50.45696145124717,3.0,9.0,113,2.0,52
1833,865,850,48.13496598639456,50.43374149659864,3.0,8.0,100,2.0,15
1834,850,410,50.43374149659864,51.50185941043084,8.0,28.0,442,1.0,440
1835,850,417,50.43374149659864,52.45387755102041,8.0,20.0,442,2.0,433
1836,850,694,50.43374149659864,52.895056689342404,8.0,4.0,189,2.0,156
1837,850,646,50.43374149659864,53.127256235827666,8.0,12.0,235,3.0,204
1838,850,866,50.43374149659864,52.45387755102041,8.0,3.0,88,2.0,16
1839,847,417,51.26965986394558,52.45387755102041,3.0,20.0,433,1.0,430
1840,847,417,51.26965986394558,53.63809523809524,3.0,21.0,442,2.0,430
1841,847,694,51.26965986394558,52.895056689342404,3.0,4.0,168,2.0,153
1842,847,646,51.26965986394558,53.127256235827666,3.0,12.0,216,2.0,201
1843,847,615,51.26965986394558,54.07927437641723,3.0,5.0,262,3.0,232
1844,847,866,51.26965986394558,52.45387755102041,3.0,3.0,54,1.0,19
1845,847,866,51.26965986394558,53.63809523809524,3.0,4.0,104,2.0,19
1846,866,417,52.45387755102041,53.63809523809524,3.0,21.0,452,1.0,449
1847,866,413,52.45387755102041,54.659773242630386,3.0,23.0,463,2.0,453
1848,866,417,52.45387755102041,55.28671201814059,3.0,20.0,465,3.0,449
1849,866,615,52.45387755102041,54.07927437641723,3.0,5.0,261,2.0,251
1850,866,413,53.63809523809524,54.659773242630386,4.0,23.0,455,1.0,453
1851,866,417,53.63809523809524,55.28671201814059,4.0,20.0,455,2.0,449
1852,866,417,53.63809523809524,56.47092970521542,4.0,21.0,465,3.0,449
1853,866,673,53.63809523809524,55.49569160997733,4.0,11.0,209,2.0,193
1854,866,632,53.63809523809524,56.447709750566894,4.0,6.0,263,3.0,234
1855,866,857,53.63809523809524,55.472471655328796,4.0,6.0,80,2.0,9
1856,866,847,53.63809523809524,56.447709750566894,4.0,6.0,122,3.0,19
1857,857,427,55.472471655328796,57.0746485260771,6.0,30.0,436,2.0,430
1858,857,434,55.472471655328796,58.18920634920635,6.0,28.0,439,3.0,423
1859,857,671,55.472471655328796,57.213968253968254,6.0,5.0,201,2.0,186
1860,847,434,56.447709750566894,58.18920634920635,6.0,28.0,420,2.0,413
1861,847,439,56.447709750566894,59.16444444444445,6.0,27.0,424,3.0,408
1862,847,637,56.447709750566894,58.83936507936508,6.0,4.0,234,2.0,210
1863,847,805,58.83936507936508,59.90748299319728,3.0,3.0,62,1.0,42
