,f0,f1,t0,t1,dB0,dB1,dist,utime,ufreq
0,156,123,0.9752380952380952,2.113015873015873,24.0,33.0,59,1.0,33
1,156,61,0.9752380952380952,3.506213151927437,24.0,29.0,145,3.0,95
2,156,245,0.9752380952380952,2.6238548752834467,24.0,30.0,114,2.0,89
3,156,308,0.9752380952380952,3.5758730158730163,24.0,34.0,189,3.0,152
4,156,489,0.9752380952380952,3.7616326530612247,24.0,17.0,354,3.0,333
5,156,637,0.9752380952380952,3.9473922902494327,24.0,6.0,498,3.0,481
6,145,61,1.486077097505669,3.506213151927437,29.0,29.0,121,2.0,84
7,145,245,1.486077097505669,2.6238548752834467,29.0,30.0,111,1.0,100
8,145,308,1.486077097505669,3.5758730158730163,29.0,34.0,186,2.0,163
9,145,489,1.486077097505669,3.7616326530612247,29.0,17.0,358,2.0,344
10,145,637,1.486077097505669,3.9473922902494327,29.0,6.0,503,2.0,492
11,123,61,2.113015873015873,3.506213151927437,33.0,29.0,86,1.0,62
12,123,65,2.113015873015873,4.96907029478458,33.0,29.0,136,3.0,58
13,123,308,2.113015873015873,3.5758730158730163,33.0,34.0,195,1.0,185
14,123,243,2.113015873015873,4.96907029478458,33.0,37.0,172,3.0,120
15,123,243,2.113015873015873,5.085170068027211,33.0,36.0,175,3.0,120
16,123,489,2.113015873015873,3.7616326530612247,33.0,17.0,373,2.0,366
17,123,501,2.113015873015873,4.945850340136055,33.0,21.0,397,3.0,378
18,123,486,2.113015873015873,5.0155102040816315,33.0,19.0,384,3.0,363
19,61,65,3.506213151927437,4.96907029478458,29.0,29.0,63,1.0,4
20,61,65,3.506213151927437,5.8978684807256245,29.0,31.0,103,2.0,4
21,61,243,3.506213151927437,4.96907029478458,29.0,37.0,193,1.0,182
22,61,243,3.506213151927437,5.085170068027211,29.0,36.0,194,2.0,182
23,61,501,3.506213151927437,4.945850340136055,29.0,21.0,444,1.0,440
24,61,486,3.506213151927437,5.0155102040816315,29.0,19.0,430,2.0,425
25,61,482,3.506213151927437,6.106848072562357,29.0,22.0,436,3.0,421
26,65,142,4.96907029478458,6.687346938775511,29.0,30.0,107,2.0,77
27,65,143,4.96907029478458,7.476825396825397,29.0,29.0,133,3.0,78
28,65,247,4.96907029478458,6.5712471655328795,29.0,36.0,195,2.0,182
29,65,244,4.96907029478458,7.7090249433106575,29.0,33.0,214,3.0,179
30,65,482,4.96907029478458,6.106848072562357,29.0,22.0,420,1.0,417
31,65,492,4.96907029478458,7.058866213151928,29.0,25.0,436,2.0,427
32,65,143,5.8978684807256245,7.476825396825397,31.0,29.0,103,2.0,78
33,65,81,5.8978684807256245,8.219863945578231,31.0,29.0,101,2.0,16
34,65,244,5.8978684807256245,7.7090249433106575,31.0,33.0,195,2.0,179
35,65,215,5.8978684807256245,8.684263038548753,31.0,36.0,192,3.0,150
36,65,492,5.8978684807256245,7.058866213151928,31.0,25.0,430,1.0,427
37,65,502,5.8978684807256245,8.196643990929706,31.0,20.0,448,2.0,437
38,142,81,6.687346938775511,8.219863945578231,30.0,29.0,90,2.0,61
39,142,244,6.687346938775511,7.7090249433106575,30.0,33.0,111,1.0,102
40,142,215,6.687346938775511,8.684263038548753,30.0,36.0,113,2.0,73
41,142,502,6.687346938775511,8.196643990929706,30.0,20.0,366,2.0,360
42,143,76,7.476825396825397,9.775600907029476,29.0,27.0,120,2.0,67
43,143,215,7.476825396825397,8.684263038548753,29.0,36.0,89,1.0,72
44,143,231,7.476825396825397,9.775600907029476,29.0,29.0,132,2.0,88
45,143,498,7.476825396825397,9.961360544217689,29.0,22.0,371,2.0,355
46,143,497,7.476825396825397,9.984580498866212,29.0,22.0,370,3.0,354
47,81,76,8.219863945578231,9.775600907029476,29.0,27.0,67,2.0,5
48,81,198,8.219863945578231,10.959818594104311,29.0,28.0,166,3.0,117
49,81,179,8.219863945578231,11.168798185941043,29.0,28.0,160,3.0,98
50,81,231,8.219863945578231,9.775600907029476,29.0,29.0,164,2.0,150
51,81,311,8.219863945578231,10.820498866213152,29.0,35.0,256,3.0,230
52,81,228,8.219863945578231,11.168798185941043,29.0,34.0,194,3.0,147
53,81,498,8.219863945578231,9.961360544217689,29.0,22.0,424,2.0,417
54,81,497,8.219863945578231,9.984580498866212,29.0,22.0,423,2.0,416
55,76,198,9.775600907029476,10.959818594104311,27.0,28.0,132,1.0,122
56,76,179,9.775600907029476,11.168798185941043,27.0,28.0,119,1.0,103
57,76,54,9.775600907029476,12.538775510204086,27.0,23.0,121,3.0,22
58,76,311,9.775600907029476,10.820498866213152,27.0,35.0,239,1.0,235
59,76,228,9.775600907029476,11.168798185941043,27.0,34.0,163,1.0,152
60,76,216,9.775600907029476,11.981496598639454,27.0,32.0,169,2.0,140
61,76,483,9.775600907029476,11.795736961451249,27.0,21.0,416,2.0,407
62,76,493,9.775600907029476,12.469115646258507,27.0,22.0,433,3.0,417
63,198,54,10.959818594104311,12.538775510204086,28.0,23.0,159,2.0,144
64,198,140,10.959818594104311,13.74621315192744,28.0,27.0,133,3.0,58
65,198,216,10.959818594104311,11.981496598639454,28.0,32.0,48,1.0,18
66,198,303,10.959818594104311,13.444353741496599,28.0,30.0,150,2.0,105
67,198,493,10.959818594104311,12.469115646258507,28.0,22.0,302,2.0,295
68,198,442,10.959818594104311,13.653333333333334,28.0,21.0,270,3.0,244
69,198,632,10.959818594104311,12.213696145124715,28.0,9.0,437,1.0,434
70,198,636,10.959818594104311,13.653333333333334,28.0,11.0,453,3.0,438
71,179,54,11.168798185941043,12.538775510204086,28.0,23.0,138,1.0,125
72,179,140,11.168798185941043,13.74621315192744,28.0,27.0,118,3.0,39
73,179,303,11.168798185941043,13.444353741496599,28.0,30.0,158,2.0,124
74,179,493,11.168798185941043,12.469115646258507,28.0,22.0,319,1.0,314
75,179,442,11.168798185941043,13.653333333333334,28.0,21.0,284,2.0,263
76,179,632,11.168798185941043,12.213696145124715,28.0,9.0,455,1.0,453
77,179,636,11.168798185941043,13.653333333333334,28.0,11.0,469,2.0,457
78,54,140,12.538775510204086,13.74621315192744,23.0,27.0,100,1.0,86
79,54,194,12.538775510204086,14.419591836734696,23.0,30.0,162,2.0,140
80,54,130,12.538775510204086,15.023310657596374,23.0,29.0,131,2.0,76
81,54,225,12.538775510204086,14.489251700680272,23.0,37.0,191,2.0,171
82,54,442,12.538775510204086,13.653333333333334,23.0,21.0,391,1.0,388
83,54,499,12.538775510204086,14.55891156462585,23.0,24.0,453,2.0,445
84,54,490,12.538775510204086,15.301950113378684,23.0,19.0,452,3.0,436
85,140,130,13.74621315192744,15.023310657596374,27.0,29.0,56,1.0,10
86,140,215,13.74621315192744,15.650249433106575,27.0,36.0,111,2.0,75
87,140,226,13.74621315192744,16.091428571428573,27.0,32.0,133,2.0,86
88,140,490,13.74621315192744,15.301950113378684,27.0,19.0,356,2.0,350
89,140,486,13.74621315192744,16.137868480725626,27.0,23.0,361,2.0,346
90,194,150,14.419591836734696,16.880907029478458,30.0,30.0,115,2.0,44
91,194,215,14.419591836734696,15.650249433106575,30.0,36.0,57,1.0,21
92,194,226,14.419591836734696,16.091428571428573,30.0,32.0,79,2.0,32
93,194,486,14.419591836734696,16.137868480725626,30.0,23.0,301,2.0,292
94,194,504,14.419591836734696,17.020226757369613,30.0,23.0,330,3.0,310
95,194,616,14.419591836734696,16.99700680272109,30.0,8.0,436,3.0,422
96,130,150,15.023310657596374,16.880907029478458,29.0,30.0,82,2.0,20
97,130,123,15.023310657596374,17.972244897959186,29.0,23.0,127,3.0,7
98,130,226,15.023310657596374,16.091428571428573,29.0,32.0,106,1.0,96
99,130,308,15.023310657596374,17.484625850340134,29.0,34.0,207,2.0,178
100,130,486,15.023310657596374,16.137868480725626,29.0,23.0,359,1.0,356
101,130,504,15.023310657596374,17.020226757369613,29.0,23.0,384,2.0,374
102,130,616,15.023310657596374,16.99700680272109,29.0,8.0,493,2.0,486
103,150,123,16.880907029478458,17.972244897959186,30.0,23.0,54,1.0,27
104,150,182,16.880907029478458,18.784943310657603,30.0,29.0,88,2.0,32
105,150,204,16.880907029478458,19.319002267573694,30.0,28.0,118,2.0,54
106,150,243,16.880907029478458,18.784943310657603,30.0,33.0,124,2.0,93
107,150,205,16.880907029478458,19.295782312925173,30.0,32.0,118,2.0,55
108,150,515,16.880907029478458,18.22766439909297,30.0,19.0,370,1.0,365
109,123,204,17.972244897959186,19.319002267573694,23.0,28.0,100,1.0,81
110,123,81,17.972244897959186,20.66575963718821,23.0,27.0,123,3.0,42
111,123,205,17.972244897959186,19.295782312925173,23.0,32.0,100,1.0,82
112,123,469,17.972244897959186,19.899501133786853,23.0,24.0,356,2.0,346
113,123,469,17.972244897959186,20.363900226757373,23.0,25.0,361,2.0,346
114,182,81,18.784943310657603,20.66575963718821,29.0,27.0,129,2.0,101
115,182,185,18.784943310657603,21.315918367346942,29.0,26.0,109,3.0,3
116,182,328,18.784943310657603,20.967619047619053,29.0,30.0,174,2.0,146
117,182,249,18.784943310657603,21.40879818594105,29.0,28.0,131,3.0,67
118,182,469,18.784943310657603,19.899501133786853,29.0,24.0,291,1.0,287
119,182,469,18.784943310657603,20.363900226757373,29.0,25.0,295,2.0,287
120,182,468,18.784943310657603,21.40879818594105,29.0,23.0,308,3.0,286
121,204,81,19.319002267573694,20.66575963718821,28.0,27.0,136,1.0,123
122,204,185,19.319002267573694,21.315918367346942,28.0,26.0,88,2.0,19
123,204,328,19.319002267573694,20.967619047619053,28.0,30.0,143,2.0,124
124,204,249,19.319002267573694,21.40879818594105,28.0,28.0,101,2.0,45
125,204,469,19.319002267573694,20.363900226757373,28.0,25.0,269,1.0,265
126,204,468,19.319002267573694,21.40879818594105,28.0,23.0,279,2.0,264
127,204,469,19.319002267573694,22.19827664399093,28.0,22.0,293,3.0,265
128,204,637,19.319002267573694,22.15183673469388,28.0,13.0,450,3.0,433
129,81,65,20.66575963718821,22.964535147392287,27.0,26.0,100,2.0,16
130,81,308,20.66575963718821,22.63945578231293,27.0,29.0,242,2.0,227
131,81,249,20.66575963718821,23.591473922902487,27.0,27.0,210,3.0,168
132,81,469,20.66575963718821,22.19827664399093,27.0,22.0,394,2.0,388
133,81,469,20.66575963718821,23.591473922902487,27.0,24.0,408,3.0,388
134,185,65,21.315918367346942,22.964535147392287,26.0,26.0,139,2.0,120
135,185,81,21.315918367346942,23.89333333333333,26.0,28.0,152,3.0,104
136,185,308,21.315918367346942,22.63945578231293,26.0,29.0,136,1.0,123
137,185,249,21.315918367346942,23.591473922902487,26.0,27.0,117,2.0,64
138,185,469,21.315918367346942,23.591473922902487,26.0,24.0,300,2.0,284
139,185,469,21.315918367346942,24.05587301587301,26.0,25.0,308,3.0,284
140,65,66,22.964535147392287,24.845351473922907,26.0,27.0,81,2.0,1
141,65,195,22.964535147392287,25.936689342403632,26.0,30.0,182,3.0,130
142,65,327,22.964535147392287,24.636371882086173,26.0,29.0,272,2.0,262
143,65,249,22.964535147392287,25.44907029478458,26.0,27.0,213,2.0,184
144,65,469,22.964535147392287,24.05587301587301,26.0,25.0,407,1.0,404
145,65,469,22.964535147392287,25.890249433106572,26.0,23.0,423,3.0,404
146,81,195,23.89333333333333,25.936689342403632,28.0,30.0,144,2.0,114
147,81,161,23.89333333333333,26.029569160997728,28.0,27.0,122,2.0,80
148,81,249,23.89333333333333,25.44907029478458,28.0,27.0,181,2.0,168
149,81,469,23.89333333333333,25.890249433106572,28.0,23.0,397,2.0,388
150,66,195,24.845351473922907,25.936689342403632,27.0,30.0,137,1.0,129
151,66,161,24.845351473922907,26.029569160997728,27.0,27.0,108,1.0,95
152,66,144,24.845351473922907,27.747845804988664,27.0,23.0,147,3.0,78
153,66,249,24.845351473922907,26.935147392290247,27.0,28.0,204,2.0,183
154,66,249,24.845351473922907,27.747845804988664,27.0,28.0,222,3.0,183
155,66,469,24.845351473922907,25.890249433106572,27.0,23.0,406,1.0,403
156,66,469,24.845351473922907,26.935147392290247,27.0,23.0,413,2.0,403
157,66,469,24.845351473922907,27.28344671201814,27.0,24.0,416,2.0,403
158,195,144,25.936689342403632,27.747845804988664,30.0,23.0,93,2.0,51
159,195,144,25.936689342403632,28.792743764172336,30.0,23.0,133,3.0,51
160,195,249,25.936689342403632,27.747845804988664,30.0,28.0,95,2.0,54
161,195,311,25.936689342403632,28.258684807256238,30.0,28.0,153,2.0,116
162,195,469,25.936689342403632,27.28344671201814,30.0,24.0,280,1.0,274
163,195,469,25.936689342403632,28.44444444444445,30.0,23.0,295,3.0,274
164,195,626,25.936689342403632,28.630204081632648,30.0,7.0,446,3.0,431
165,161,144,26.029569160997728,27.747845804988664,27.0,23.0,76,2.0,17
166,161,144,26.029569160997728,28.792743764172336,27.0,23.0,120,3.0,17
167,161,249,26.029569160997728,27.747845804988664,27.0,28.0,115,2.0,88
168,161,311,26.029569160997728,28.258684807256238,27.0,28.0,178,2.0,150
169,161,469,26.029569160997728,27.28344671201814,27.0,24.0,313,1.0,308
170,161,469,26.029569160997728,28.44444444444445,27.0,23.0,325,2.0,308
171,161,626,26.029569160997728,28.630204081632648,27.0,7.0,478,3.0,465
172,144,129,27.747845804988664,29.41968253968254,23.0,28.0,74,2.0,15
173,144,249,27.747845804988664,29.141043083900232,23.0,27.0,121,1.0,105
174,144,469,27.747845804988664,29.582222222222228,23.0,23.0,334,2.0,325
175,144,469,27.747845804988664,30.627120181405893,23.0,23.0,348,3.0,325
176,144,65,28.792743764172336,30.81287981859411,23.0,28.0,118,2.0,79
177,144,249,28.792743764172336,30.97541950113379,23.0,27.0,141,2.0,105
178,144,249,28.792743764172336,31.43981859410431,23.0,28.0,155,3.0,105
179,144,469,28.792743764172336,30.627120181405893,23.0,23.0,334,2.0,325
180,144,469,28.792743764172336,31.43981859410431,23.0,23.0,344,3.0,325
181,144,628,28.792743764172336,31.695238095238093,23.0,8.0,500,3.0,484
182,129,65,29.41968253968254,30.81287981859411,28.0,28.0,88,1.0,64
183,129,91,29.41968253968254,31.950657596371883,28.0,25.0,115,3.0,38
184,129,249,29.41968253968254,30.97541950113379,28.0,27.0,137,2.0,120
185,129,249,29.41968253968254,31.43981859410431,28.0,28.0,148,2.0,120
186,129,249,29.41968253968254,32.13641723356009,28.0,28.0,168,3.0,120
187,129,469,29.41968253968254,30.627120181405893,28.0,23.0,344,1.0,340
188,129,469,29.41968253968254,31.43981859410431,28.0,23.0,351,2.0,340
189,129,628,29.41968253968254,31.695238095238093,28.0,8.0,509,2.0,499
190,65,91,30.81287981859411,31.950657596371883,28.0,25.0,55,1.0,26
191,65,77,30.81287981859411,32.43827664399093,28.0,26.0,71,2.0,12
192,65,249,30.81287981859411,32.13641723356009,28.0,28.0,193,1.0,184
193,65,243,30.81287981859411,33.2974149659864,28.0,29.0,208,2.0,178
194,65,469,30.81287981859411,32.80979591836735,28.0,22.0,413,2.0,404
195,65,484,30.81287981859411,33.529614512471646,28.0,21.0,435,3.0,419
196,91,61,31.950657596371883,33.90113378684807,25.0,29.0,89,2.0,30
197,91,122,31.950657596371883,34.29587301587301,25.0,27.0,106,2.0,31
198,91,243,31.950657596371883,33.2974149659864,25.0,29.0,163,1.0,152
199,91,214,31.950657596371883,34.574512471655325,25.0,28.0,167,3.0,123
200,91,484,31.950657596371883,33.529614512471646,25.0,21.0,399,2.0,393
201,91,470,31.950657596371883,34.66739229024943,25.0,23.0,397,3.0,379
202,77,61,32.43827664399093,33.90113378684807,26.0,29.0,65,1.0,16
203,77,122,32.43827664399093,34.29587301587301,26.0,27.0,92,2.0,45
204,77,214,32.43827664399093,34.574512471655325,26.0,28.0,165,2.0,137
205,77,249,32.43827664399093,35.131791383219955,26.0,26.0,207,3.0,172
206,77,484,32.43827664399093,33.529614512471646,26.0,21.0,410,1.0,407
207,77,470,32.43827664399093,34.66739229024943,26.0,23.0,405,2.0,393
208,77,469,32.43827664399093,35.131791383219955,26.0,24.0,409,3.0,392
209,61,146,33.90113378684807,35.898049886621315,29.0,26.0,121,2.0,85
210,61,122,33.90113378684807,36.13024943310658,29.0,27.0,114,2.0,61
211,61,249,33.90113378684807,35.131791383219955,29.0,26.0,195,1.0,188
212,61,213,33.90113378684807,36.43210884353741,29.0,27.0,187,3.0,152
213,61,469,33.90113378684807,35.131791383219955,29.0,24.0,411,1.0,408
214,61,469,33.90113378684807,36.176689342403634,29.0,23.0,420,2.0,408
215,122,146,34.29587301587301,35.898049886621315,27.0,26.0,73,2.0,24
216,122,213,34.29587301587301,36.43210884353741,27.0,27.0,129,2.0,91
217,122,249,34.29587301587301,36.98938775510205,27.0,26.0,172,3.0,127
218,122,469,34.29587301587301,36.176689342403634,27.0,23.0,356,2.0,347
219,122,460,34.29587301587301,36.98938775510205,27.0,22.0,357,3.0,338
220,146,61,35.898049886621315,37.593106575963716,26.0,27.0,112,2.0,85
221,146,122,35.898049886621315,37.987845804988666,26.0,27.0,93,2.0,24
222,146,249,35.898049886621315,36.98938775510205,26.0,26.0,113,1.0,103
223,146,214,35.898049886621315,38.26648526077098,26.0,28.0,123,2.0,68
224,146,460,35.898049886621315,36.98938775510205,26.0,22.0,317,1.0,314
225,146,469,35.898049886621315,38.35936507936508,26.0,23.0,340,2.0,323
226,146,627,35.898049886621315,36.98938775510205,26.0,7.0,483,1.0,481
227,146,627,35.898049886621315,38.35936507936508,26.0,7.0,493,2.0,481
228,122,61,36.13024943310658,37.593106575963716,27.0,27.0,88,1.0,61
229,122,214,36.13024943310658,38.26648526077098,27.0,28.0,130,2.0,92
230,122,469,36.13024943310658,38.35936507936508,27.0,23.0,360,2.0,347
231,61,122,37.593106575963716,39.822222222222216,27.0,27.0,114,2.0,61
232,61,213,37.593106575963716,39.19528344671202,27.0,28.0,167,2.0,152
233,61,214,37.593106575963716,40.124081632653066,27.0,28.0,188,3.0,153
234,61,469,37.593106575963716,39.86866213151927,27.0,23.0,420,2.0,408
235,61,469,37.593106575963716,40.21696145124717,27.0,24.0,423,3.0,408
236,122,213,37.987845804988666,39.19528344671202,27.0,28.0,105,1.0,91
237,122,214,37.987845804988666,40.124081632653066,27.0,28.0,130,2.0,92
238,122,469,37.987845804988666,39.86866213151927,27.0,23.0,356,2.0,347
239,122,469,37.987845804988666,40.21696145124717,27.0,24.0,360,2.0,347
240,122,185,39.822222222222216,42.44607709750567,27.0,27.0,129,3.0,63
241,122,215,39.822222222222216,41.958458049886616,27.0,28.0,131,2.0,93
242,122,249,39.822222222222216,42.05133786848072,27.0,27.0,159,2.0,127
243,122,469,39.822222222222216,41.70303854875284,27.0,24.0,356,2.0,347
244,122,469,39.822222222222216,42.05133786848072,27.0,24.0,360,2.0,347
245,122,185,40.751020408163264,42.44607709750567,26.0,27.0,96,2.0,63
246,122,215,40.751020408163264,41.958458049886616,26.0,28.0,107,1.0,93
247,122,249,40.751020408163264,42.05133786848072,26.0,27.0,139,1.0,127
248,122,469,40.751020408163264,42.05133786848072,26.0,24.0,351,1.0,347
249,122,213,41.67981859410431,43.81605442176871,28.0,28.0,129,2.0,91
250,122,249,41.67981859410431,44.37333333333334,28.0,25.0,172,3.0,127
251,122,470,41.67981859410431,43.90893424036282,28.0,23.0,361,2.0,348
252,122,470,41.67981859410431,44.35011337868482,28.0,22.0,367,3.0,348
253,185,122,42.44607709750567,43.51419501133787,27.0,28.0,78,1.0,63
254,185,122,42.44607709750567,44.44299319727891,27.0,25.0,107,2.0,63
255,185,142,42.44607709750567,45.39501133786848,27.0,32.0,134,3.0,43
256,185,213,42.44607709750567,43.81605442176871,27.0,28.0,65,1.0,28
257,185,249,42.44607709750567,44.37333333333334,27.0,25.0,105,2.0,64
258,185,470,42.44607709750567,43.90893424036282,27.0,23.0,292,1.0,285
259,185,470,42.44607709750567,44.35011337868482,27.0,22.0,297,2.0,285
260,185,627,42.44607709750567,43.560634920634925,27.0,7.0,445,1.0,442
261,122,142,43.51419501133787,45.39501133786848,28.0,32.0,83,2.0,20
262,122,213,43.51419501133787,45.650430839002276,28.0,29.0,129,2.0,91
263,122,470,43.51419501133787,45.743310657596375,28.0,24.0,361,2.0,348
264,122,469,43.51419501133787,46.20770975056689,28.0,24.0,366,3.0,347
265,122,65,44.44299319727891,46.834648526077096,25.0,25.0,118,2.0,57
266,122,142,44.44299319727891,47.20616780045352,25.0,29.0,121,3.0,20
267,122,213,44.44299319727891,45.650430839002276,25.0,29.0,105,1.0,91
268,122,214,44.44299319727891,46.57922902494332,25.0,27.0,130,2.0,92
269,122,231,44.44299319727891,47.25260770975056,25.0,29.0,163,3.0,109
270,122,470,44.44299319727891,45.743310657596375,25.0,24.0,352,1.0,348
271,122,469,44.44299319727891,46.20770975056689,25.0,24.0,355,2.0,347
272,142,65,45.39501133786848,46.834648526077096,32.0,25.0,99,1.0,77
273,142,214,45.39501133786848,46.57922902494332,32.0,27.0,88,1.0,72
274,142,231,45.39501133786848,47.25260770975056,32.0,29.0,120,2.0,89
275,142,469,45.39501133786848,47.60090702947846,32.0,22.0,341,2.0,327
276,142,470,45.39501133786848,48.04208616780046,32.0,23.0,347,3.0,328
277,142,632,45.39501133786848,46.46312925170068,32.0,6.0,492,1.0,490
278,65,181,46.834648526077096,48.785124716553284,25.0,26.0,143,2.0,116
279,65,250,46.834648526077096,48.76190476190477,25.0,27.0,203,2.0,185
280,65,470,46.834648526077096,48.04208616780046,25.0,23.0,408,1.0,405
281,65,469,46.834648526077096,49.43528344671203,25.0,23.0,419,3.0,404
282,142,181,47.20616780045352,48.785124716553284,29.0,26.0,78,2.0,39
283,142,129,47.20616780045352,49.96934240362812,29.0,25.0,120,3.0,13
284,142,250,47.20616780045352,48.76190476190477,29.0,27.0,127,2.0,108
285,142,249,47.20616780045352,49.899682539682544,29.0,28.0,158,3.0,107
286,142,469,47.20616780045352,49.43528344671203,29.0,23.0,341,2.0,327
287,142,637,47.20616780045352,48.4368253968254,29.0,10.0,498,1.0,495
288,181,129,48.785124716553284,49.96934240362812,26.0,25.0,73,1.0,52
289,181,64,48.785124716553284,50.71238095238096,26.0,25.0,143,2.0,117
290,181,68,48.785124716553284,51.1071201814059,26.0,25.0,151,2.0,113
291,181,249,48.785124716553284,49.899682539682544,26.0,28.0,83,1.0,68
292,181,220,48.785124716553284,50.89814058956916,26.0,30.0,99,2.0,39
293,181,257,48.785124716553284,51.75727891156463,26.0,26.0,149,3.0,76
294,181,468,48.785124716553284,50.596281179138316,26.0,25.0,297,2.0,287
295,181,468,48.785124716553284,51.2928798185941,26.0,22.0,307,3.0,287
296,181,631,48.785124716553284,50.57306122448979,26.0,12.0,457,2.0,450
297,129,68,49.96934240362812,51.1071201814059,25.0,25.0,78,1.0,61
298,129,163,49.96934240362812,52.8021768707483,25.0,31.0,127,3.0,34
299,129,257,49.96934240362812,51.75727891156463,25.0,26.0,149,2.0,128
300,129,257,49.96934240362812,51.98947845804989,25.0,27.0,155,2.0,128
301,129,468,49.96934240362812,51.2928798185941,25.0,22.0,344,1.0,339
302,129,469,49.96934240362812,52.43065759637188,25.0,23.0,356,2.0,340
303,64,163,50.71238095238096,52.8021768707483,25.0,31.0,134,2.0,99
304,64,146,50.71238095238096,53.080816326530616,25.0,31.0,131,2.0,82
305,64,257,50.71238095238096,51.75727891156463,25.0,26.0,198,1.0,193
306,64,257,50.71238095238096,51.98947845804989,25.0,27.0,201,1.0,193
307,64,239,50.71238095238096,53.429115646258495,25.0,26.0,211,3.0,175
308,64,469,50.71238095238096,52.43065759637188,25.0,23.0,412,2.0,405
309,64,518,50.71238095238096,53.080816326530616,25.0,24.0,465,2.0,454
310,68,163,51.1071201814059,52.8021768707483,25.0,31.0,120,2.0,95
311,68,146,51.1071201814059,53.080816326530616,25.0,31.0,115,2.0,78
312,68,239,51.1071201814059,53.429115646258495,25.0,26.0,198,2.0,171
313,68,469,51.1071201814059,52.43065759637188,25.0,23.0,405,1.0,401
314,68,518,51.1071201814059,53.080816326530616,25.0,24.0,458,2.0,450
315,163,164,52.8021768707483,54.63655328798186,31.0,30.0,79,2.0,1
316,163,67,52.8021768707483,55.70467120181406,31.0,33.0,158,3.0,96
317,163,225,52.8021768707483,54.91519274376417,31.0,30.0,110,2.0,62
318,163,231,52.8021768707483,55.727891156462576,31.0,27.0,143,3.0,68
319,163,468,52.8021768707483,54.28825396825397,31.0,24.0,312,1.0,305
320,163,525,52.8021768707483,55.51891156462585,31.0,22.0,380,3.0,362
321,163,616,52.8021768707483,54.125714285714295,31.0,8.0,457,1.0,453
322,163,629,52.8021768707483,55.51891156462585,31.0,8.0,480,3.0,466
323,146,164,53.080816326530616,54.63655328798186,31.0,30.0,69,2.0,18
324,146,67,53.080816326530616,55.70467120181406,31.0,33.0,138,3.0,79
325,146,225,53.080816326530616,54.91519274376417,31.0,30.0,112,2.0,79
326,146,231,53.080816326530616,55.727891156462576,31.0,27.0,142,3.0,85
327,146,468,53.080816326530616,54.28825396825397,31.0,24.0,326,1.0,322
328,146,525,53.080816326530616,55.51891156462585,31.0,22.0,393,2.0,379
329,146,616,53.080816326530616,54.125714285714295,31.0,8.0,472,1.0,470
330,146,629,53.080816326530616,55.51891156462585,31.0,8.0,494,2.0,483
331,164,67,54.63655328798186,55.70467120181406,30.0,33.0,107,1.0,97
332,164,76,54.63655328798186,56.21551020408163,30.0,25.0,111,2.0,88
333,164,78,54.63655328798186,57.26040816326531,30.0,26.0,142,3.0,86
334,164,231,54.63655328798186,55.727891156462576,30.0,27.0,82,1.0,67
335,164,250,54.63655328798186,56.470929705215426,30.0,28.0,117,2.0,86
336,164,246,54.63655328798186,57.23718820861678,30.0,29.0,139,3.0,82
337,164,469,54.63655328798186,56.81922902494331,30.0,24.0,319,2.0,305
338,164,469,54.63655328798186,57.28362811791385,30.0,25.0,326,3.0,305
339,164,615,54.63655328798186,56.81922902494331,30.0,7.0,461,2.0,451
340,67,78,55.70467120181406,57.26040816326531,33.0,26.0,68,2.0,11
341,67,191,55.70467120181406,58.514285714285705,33.0,29.0,173,3.0,124
342,67,246,55.70467120181406,57.23718820861678,33.0,29.0,191,2.0,179
343,67,233,55.70467120181406,58.25886621315193,33.0,32.0,199,3.0,166
344,67,469,55.70467120181406,56.81922902494331,33.0,24.0,405,1.0,402
345,67,469,55.70467120181406,57.28362811791385,33.0,25.0,408,2.0,402
346,67,469,55.70467120181406,58.328526077097514,33.0,24.0,418,3.0,402
347,76,78,56.21551020408163,57.26040816326531,25.0,26.0,45,1.0,2
348,76,191,56.21551020408163,58.514285714285705,25.0,29.0,152,2.0,115
349,76,145,56.21551020408163,59.141224489795924,25.0,26.0,144,3.0,69
350,76,246,56.21551020408163,57.23718820861678,25.0,29.0,176,1.0,170
351,76,233,56.21551020408163,58.25886621315193,25.0,32.0,180,2.0,157
352,76,249,56.21551020408163,59.141224489795924,25.0,28.0,214,3.0,173
353,76,469,56.21551020408163,57.28362811791385,25.0,25.0,396,1.0,393
354,76,469,56.21551020408163,58.328526077097514,25.0,24.0,403,2.0,393
355,76,470,56.21551020408163,59.11800453514739,25.0,24.0,413,3.0,394
356,78,191,57.26040816326531,58.514285714285705,26.0,29.0,125,1.0,113
357,78,145,57.26040816326531,59.141224489795924,26.0,26.0,105,2.0,67
358,78,249,57.26040816326531,59.141224489795924,26.0,28.0,189,2.0,171
359,78,469,57.26040816326531,58.328526077097514,26.0,24.0,394,1.0,391
360,78,470,57.26040816326531,59.11800453514739,26.0,24.0,400,2.0,392
361,254,123,0.9752380952380952,2.113015873015873,9.0,33.0,140,1.0,131
362,254,61,0.9752380952380952,3.506213151927437,9.0,29.0,222,3.0,193
363,254,245,0.9752380952380952,2.6238548752834467,9.0,30.0,72,2.0,9
364,254,308,0.9752380952380952,3.5758730158730163,9.0,34.0,124,3.0,54
365,254,489,0.9752380952380952,3.7616326530612247,9.0,17.0,264,3.0,235
366,254,637,0.9752380952380952,3.9473922902494327,9.0,6.0,404,3.0,383
367,237,61,1.18421768707483,3.506213151927437,27.0,29.0,202,2.0,176
368,237,245,1.18421768707483,2.6238548752834467,27.0,30.0,63,1.0,8
369,237,308,1.18421768707483,3.5758730158730163,27.0,34.0,125,2.0,71
370,237,489,1.18421768707483,3.7616326530612247,27.0,17.0,275,3.0,252
371,237,637,1.18421768707483,3.9473922902494327,27.0,6.0,417,3.0,400
372,245,65,2.6238548752834467,4.96907029478458,30.0,29.0,206,2.0,180
373,245,243,2.6238548752834467,4.96907029478458,30.0,37.0,101,2.0,2
374,245,243,2.6238548752834467,5.085170068027211,30.0,36.0,106,2.0,2
375,245,489,2.6238548752834467,3.7616326530612247,30.0,17.0,249,1.0,244
376,245,501,2.6238548752834467,4.945850340136055,30.0,21.0,275,2.0,256
377,245,486,2.6238548752834467,5.0155102040816315,30.0,19.0,262,2.0,241
378,245,637,2.6238548752834467,3.9473922902494327,30.0,6.0,396,1.0,392
379,245,630,2.6238548752834467,4.945850340136055,30.0,6.0,398,2.0,385
380,308,65,3.5758730158730163,4.96907029478458,34.0,29.0,250,1.0,243
381,308,65,3.5758730158730163,5.8978684807256245,34.0,31.0,263,2.0,243
382,308,243,3.5758730158730163,4.96907029478458,34.0,37.0,88,1.0,65
383,308,243,3.5758730158730163,5.085170068027211,34.0,36.0,92,2.0,65
384,308,501,3.5758730158730163,4.945850340136055,34.0,21.0,202,1.0,193
385,308,486,3.5758730158730163,5.0155102040816315,34.0,19.0,188,1.0,178
386,308,482,3.5758730158730163,6.106848072562357,34.0,22.0,205,3.0,174
387,308,630,3.5758730158730163,4.945850340136055,34.0,6.0,327,1.0,322
388,308,645,3.5758730158730163,6.1532879818594095,34.0,9.0,355,3.0,337
389,243,142,4.96907029478458,6.687346938775511,37.0,30.0,125,2.0,101
390,243,143,4.96907029478458,7.476825396825397,37.0,29.0,147,3.0,100
391,243,247,4.96907029478458,6.5712471655328795,37.0,36.0,69,2.0,4
392,243,244,4.96907029478458,7.7090249433106575,37.0,33.0,118,3.0,1
393,243,482,4.96907029478458,6.106848072562357,37.0,22.0,244,1.0,239
394,243,492,4.96907029478458,7.058866213151928,37.0,25.0,265,2.0,249
395,243,645,4.96907029478458,6.1532879818594095,37.0,9.0,405,1.0,402
396,243,142,5.085170068027211,6.687346938775511,36.0,30.0,122,2.0,101
397,243,143,5.085170068027211,7.476825396825397,36.0,29.0,144,2.0,100
398,243,247,5.085170068027211,6.5712471655328795,36.0,36.0,64,1.0,4
399,243,244,5.085170068027211,7.7090249433106575,36.0,33.0,113,3.0,1
400,243,482,5.085170068027211,6.106848072562357,36.0,22.0,243,1.0,239
401,243,492,5.085170068027211,7.058866213151928,36.0,25.0,263,2.0,249
402,243,645,5.085170068027211,6.1532879818594095,36.0,9.0,405,1.0,402
403,247,81,6.5712471655328795,8.219863945578231,36.0,29.0,181,2.0,166
404,247,244,6.5712471655328795,7.7090249433106575,36.0,33.0,49,1.0,3
405,247,215,6.5712471655328795,8.684263038548753,36.0,36.0,96,2.0,32
406,247,502,6.5712471655328795,8.196643990929706,36.0,20.0,264,2.0,255
407,244,76,7.7090249433106575,9.775600907029476,33.0,27.0,190,2.0,168
408,244,231,7.7090249433106575,9.775600907029476,33.0,29.0,90,2.0,13
409,244,498,7.7090249433106575,9.961360544217689,33.0,22.0,272,2.0,254
410,244,497,7.7090249433106575,9.984580498866212,33.0,22.0,271,2.0,253
411,244,644,7.7090249433106575,9.961360544217689,33.0,13.0,412,2.0,400
412,244,645,7.7090249433106575,9.984580498866212,33.0,11.0,413,2.0,401
413,215,76,8.684263038548753,9.775600907029476,36.0,27.0,147,1.0,139
414,215,198,8.684263038548753,10.959818594104311,36.0,28.0,99,2.0,17
415,215,179,8.684263038548753,11.168798185941043,36.0,28.0,113,2.0,36
416,215,231,8.684263038548753,9.775600907029476,36.0,29.0,50,1.0,16
417,215,311,8.684263038548753,10.820498866213152,36.0,35.0,133,2.0,96
418,215,228,8.684263038548753,11.168798185941043,36.0,34.0,108,2.0,13
419,215,498,8.684263038548753,9.961360544217689,36.0,22.0,288,1.0,283
420,215,497,8.684263038548753,9.984580498866212,36.0,22.0,288,1.0,282
421,215,644,8.684263038548753,9.961360544217689,36.0,13.0,433,1.0,429
422,215,645,8.684263038548753,9.984580498866212,36.0,11.0,434,1.0,430
423,231,198,9.775600907029476,10.959818594104311,29.0,28.0,61,1.0,33
424,231,179,9.775600907029476,11.168798185941043,29.0,28.0,79,1.0,52
425,231,54,9.775600907029476,12.538775510204086,29.0,23.0,213,3.0,177
426,231,311,9.775600907029476,10.820498866213152,29.0,35.0,92,1.0,80
427,231,228,9.775600907029476,11.168798185941043,29.0,34.0,60,1.0,3
428,231,216,9.775600907029476,11.981496598639454,29.0,32.0,96,2.0,15
429,231,483,9.775600907029476,11.795736961451249,29.0,21.0,267,2.0,252
430,231,493,9.775600907029476,12.469115646258507,29.0,22.0,287,3.0,262
431,231,631,9.775600907029476,11.818956916099776,29.0,11.0,410,2.0,400
432,231,632,9.775600907029476,12.213696145124715,29.0,9.0,415,2.0,401
433,311,54,10.820498866213152,12.538775510204086,35.0,23.0,267,2.0,257
434,311,140,10.820498866213152,13.74621315192744,35.0,27.0,212,3.0,171
435,311,216,10.820498866213152,11.981496598639454,35.0,32.0,107,1.0,95
436,311,303,10.820498866213152,13.444353741496599,35.0,30.0,113,3.0,8
437,311,493,10.820498866213152,12.469115646258507,35.0,22.0,195,2.0,182
438,311,442,10.820498866213152,13.653333333333334,35.0,21.0,179,3.0,131
439,311,632,10.820498866213152,12.213696145124715,35.0,9.0,327,1.0,321
440,311,636,10.820498866213152,13.653333333333334,35.0,11.0,347,3.0,325
441,228,54,11.168798185941043,12.538775510204086,34.0,23.0,184,1.0,174
442,228,140,11.168798185941043,13.74621315192744,34.0,27.0,142,3.0,88
443,228,303,11.168798185941043,13.444353741496599,34.0,30.0,123,2.0,75
444,228,493,11.168798185941043,12.469115646258507,34.0,22.0,271,1.0,265
445,228,442,11.168798185941043,13.653333333333334,34.0,21.0,239,2.0,214
446,228,632,11.168798185941043,12.213696145124715,34.0,9.0,406,1.0,404
447,228,636,11.168798185941043,13.653333333333334,34.0,11.0,422,2.0,408
448,216,140,11.981496598639454,13.74621315192744,32.0,27.0,107,2.0,76
449,216,194,11.981496598639454,14.419591836734696,32.0,30.0,107,2.0,22
450,216,303,11.981496598639454,13.444353741496599,32.0,30.0,107,1.0,87
451,216,225,11.981496598639454,14.489251700680272,32.0,37.0,108,3.0,9
452,216,442,11.981496598639454,13.653333333333334,32.0,21.0,237,2.0,226
453,216,499,11.981496598639454,14.55891156462585,32.0,24.0,304,3.0,283
454,216,636,11.981496598639454,13.653333333333334,32.0,11.0,426,2.0,420
455,303,130,13.444353741496599,15.023310657596374,30.0,29.0,186,2.0,173
456,303,225,13.444353741496599,14.489251700680272,30.0,37.0,90,1.0,78
457,303,215,13.444353741496599,15.650249433106575,30.0,36.0,129,2.0,88
458,303,226,13.444353741496599,16.091428571428573,30.0,32.0,138,3.0,77
459,303,499,13.444353741496599,14.55891156462585,30.0,24.0,202,1.0,196
460,303,490,13.444353741496599,15.301950113378684,30.0,19.0,203,2.0,187
461,303,486,13.444353741496599,16.137868480725626,30.0,23.0,217,3.0,183
462,225,150,14.489251700680272,16.880907029478458,37.0,30.0,127,2.0,75
463,225,215,14.489251700680272,15.650249433106575,37.0,36.0,51,1.0,10
464,225,226,14.489251700680272,16.091428571428573,37.0,32.0,69,2.0,1
465,225,486,14.489251700680272,16.137868480725626,37.0,23.0,270,2.0,261
466,225,504,14.489251700680272,17.020226757369613,37.0,23.0,300,3.0,279
467,225,616,14.489251700680272,16.99700680272109,37.0,8.0,406,3.0,391
468,215,150,15.650249433106575,16.880907029478458,36.0,30.0,84,1.0,65
469,215,123,15.650249433106575,17.972244897959186,36.0,23.0,136,2.0,92
470,215,308,15.650249433106575,17.484625850340134,36.0,34.0,122,2.0,93
471,215,504,15.650249433106575,17.020226757369613,36.0,23.0,295,1.0,289
472,215,515,15.650249433106575,18.22766439909297,36.0,19.0,320,3.0,300
473,215,616,15.650249433106575,16.99700680272109,36.0,8.0,405,1.0,401
474,226,123,16.091428571428573,17.972244897959186,32.0,23.0,131,2.0,103
475,226,182,16.091428571428573,18.784943310657603,32.0,29.0,124,3.0,44
476,226,308,16.091428571428573,17.484625850340134,32.0,34.0,102,1.0,82
477,226,243,16.091428571428573,18.784943310657603,32.0,33.0,117,3.0,17
478,226,515,16.091428571428573,18.22766439909297,32.0,19.0,303,2.0,289
479,308,182,17.484625850340134,18.784943310657603,34.0,29.0,138,1.0,126
480,308,204,17.484625850340134,19.319002267573694,34.0,28.0,131,2.0,104
481,308,243,17.484625850340134,18.784943310657603,34.0,33.0,86,1.0,65
482,308,205,17.484625850340134,19.295782312925173,34.0,32.0,129,2.0,103
483,308,469,17.484625850340134,19.899501133786853,34.0,24.0,192,2.0,161
484,308,469,17.484625850340134,20.363900226757373,34.0,25.0,203,3.0,161
485,308,807,17.484625850340134,19.899501133786853,34.0,7.0,510,2.0,499
486,243,81,18.784943310657603,20.66575963718821,33.0,27.0,181,2.0,162
487,243,185,18.784943310657603,21.315918367346942,33.0,26.0,123,3.0,58
488,243,328,18.784943310657603,20.967619047619053,33.0,30.0,127,2.0,85
489,243,249,18.784943310657603,21.40879818594105,33.0,28.0,113,3.0,6
490,243,469,18.784943310657603,19.899501133786853,33.0,24.0,231,1.0,226
491,243,469,18.784943310657603,20.363900226757373,33.0,25.0,236,2.0,226
492,243,468,18.784943310657603,21.40879818594105,33.0,23.0,252,3.0,225
493,205,81,19.295782312925173,20.66575963718821,32.0,27.0,137,1.0,124
494,205,185,19.295782312925173,21.315918367346942,32.0,26.0,89,2.0,20
495,205,328,19.295782312925173,20.967619047619053,32.0,30.0,143,2.0,123
496,205,249,19.295782312925173,21.40879818594105,32.0,28.0,101,2.0,44
497,205,469,19.295782312925173,20.363900226757373,32.0,25.0,268,1.0,264
498,205,468,19.295782312925173,21.40879818594105,32.0,23.0,278,2.0,263
499,205,469,19.295782312925173,22.19827664399093,32.0,22.0,292,3.0,264
500,205,637,19.295782312925173,22.15183673469388,32.0,13.0,449,3.0,432
501,328,65,20.967619047619053,22.964535147392287,30.0,26.0,277,2.0,263
502,328,81,20.967619047619053,23.89333333333333,30.0,28.0,277,3.0,247
503,328,308,20.967619047619053,22.63945578231293,30.0,29.0,75,2.0,20
504,328,249,20.967619047619053,23.591473922902487,30.0,27.0,138,3.0,79
505,328,469,20.967619047619053,22.19827664399093,30.0,22.0,151,1.0,141
506,328,469,20.967619047619053,23.591473922902487,30.0,24.0,181,3.0,141
507,328,637,20.967619047619053,22.15183673469388,30.0,13.0,313,1.0,309
508,328,825,20.967619047619053,23.243174603174605,30.0,7.0,507,2.0,497
509,249,65,21.40879818594105,22.964535147392287,28.0,26.0,196,2.0,184
510,249,81,21.40879818594105,23.89333333333333,28.0,28.0,199,2.0,168
511,249,308,21.40879818594105,22.63945578231293,28.0,29.0,79,1.0,59
512,249,469,21.40879818594105,23.591473922902487,28.0,24.0,239,2.0,220
513,249,469,21.40879818594105,24.05587301587301,28.0,25.0,248,3.0,220
514,308,81,22.63945578231293,23.89333333333333,29.0,28.0,233,1.0,227
515,308,66,22.63945578231293,24.845351473922907,29.0,27.0,260,2.0,242
516,308,327,22.63945578231293,24.636371882086173,29.0,29.0,88,2.0,19
517,308,249,22.63945578231293,25.44907029478458,29.0,27.0,135,3.0,59
518,308,469,22.63945578231293,24.05587301587301,29.0,25.0,172,1.0,161
519,249,66,23.591473922902487,24.845351473922907,27.0,27.0,191,1.0,183
520,249,195,23.591473922902487,25.936689342403632,27.0,30.0,115,2.0,54
521,249,161,23.591473922902487,26.029569160997728,27.0,27.0,137,2.0,88
522,249,327,23.591473922902487,24.636371882086173,27.0,29.0,90,1.0,78
523,249,469,23.591473922902487,25.890249433106572,27.0,23.0,241,2.0,220
524,249,615,23.591473922902487,26.493968253968248,27.0,13.0,387,3.0,366
525,327,195,24.636371882086173,25.936689342403632,29.0,30.0,143,1.0,132
526,327,161,24.636371882086173,26.029569160997728,29.0,27.0,177,1.0,166
527,327,249,24.636371882086173,26.935147392290247,29.0,28.0,126,2.0,78
528,327,469,24.636371882086173,25.890249433106572,29.0,23.0,152,1.0,142
529,327,469,24.636371882086173,26.935147392290247,29.0,23.0,173,2.0,142
530,327,469,24.636371882086173,27.28344671201814,29.0,24.0,182,3.0,142
531,327,615,24.636371882086173,26.493968253968248,29.0,13.0,299,2.0,288
532,327,808,24.636371882086173,27.28344671201814,29.0,8.0,494,3.0,481
533,249,144,25.44907029478458,27.747845804988664,27.0,23.0,144,2.0,105
534,249,311,25.44907029478458,28.258684807256238,27.0,28.0,136,3.0,62
535,249,469,25.44907029478458,26.935147392290247,27.0,23.0,229,1.0,220
536,249,469,25.44907029478458,27.28344671201814,27.0,24.0,234,2.0,220
537,249,615,25.44907029478458,26.493968253968248,27.0,13.0,369,1.0,366
538,249,144,26.935147392290247,28.792743764172336,28.0,23.0,132,2.0,105
539,249,129,26.935147392290247,29.41968253968254,28.0,28.0,161,2.0,120
540,249,311,26.935147392290247,28.258684807256238,28.0,28.0,84,1.0,62
541,249,469,26.935147392290247,28.44444444444445,28.0,23.0,229,2.0,220
542,249,469,26.935147392290247,29.582222222222228,28.0,23.0,248,3.0,220
543,249,626,26.935147392290247,28.630204081632648,28.0,7.0,384,2.0,377
544,249,144,27.747845804988664,28.792743764172336,28.0,23.0,114,1.0,105
545,249,129,27.747845804988664,29.41968253968254,28.0,28.0,140,2.0,120
546,249,469,27.747845804988664,29.582222222222228,28.0,23.0,234,2.0,220
547,249,469,27.747845804988664,30.627120181405893,28.0,23.0,253,3.0,220
548,311,129,28.258684807256238,29.41968253968254,28.0,28.0,189,1.0,182
549,311,65,28.258684807256238,30.81287981859411,28.0,28.0,269,3.0,246
550,311,249,28.258684807256238,30.97541950113379,28.0,27.0,132,3.0,62
551,311,469,28.258684807256238,29.582222222222228,28.0,23.0,168,1.0,158
552,311,469,28.258684807256238,30.627120181405893,28.0,23.0,188,2.0,158
553,249,65,29.141043083900232,30.81287981859411,27.0,28.0,198,2.0,184
554,249,91,29.141043083900232,31.950657596371883,27.0,25.0,199,3.0,158
555,249,469,29.141043083900232,30.627120181405893,27.0,23.0,229,1.0,220
556,249,469,29.141043083900232,31.43981859410431,27.0,23.0,241,2.0,220
557,249,628,29.141043083900232,31.695238095238093,27.0,8.0,395,3.0,379
558,249,77,30.97541950113379,32.43827664399093,27.0,26.0,183,1.0,172
559,249,61,30.97541950113379,33.90113378684807,27.0,29.0,226,3.0,188
560,249,243,30.97541950113379,33.2974149659864,27.0,29.0,100,2.0,6
561,249,469,30.97541950113379,32.80979591836735,27.0,22.0,234,2.0,220
562,249,484,30.97541950113379,33.529614512471646,27.0,21.0,259,3.0,235
563,249,61,31.43981859410431,33.90113378684807,28.0,29.0,216,2.0,188
564,249,122,31.43981859410431,34.29587301587301,28.0,27.0,177,3.0,127
565,249,243,31.43981859410431,33.2974149659864,28.0,29.0,80,2.0,6
566,249,469,31.43981859410431,32.80979591836735,28.0,22.0,228,1.0,220
567,249,484,31.43981859410431,33.529614512471646,28.0,21.0,252,2.0,235
568,249,61,32.13641723356009,33.90113378684807,28.0,29.0,203,2.0,188
569,249,122,32.13641723356009,34.29587301587301,28.0,27.0,157,2.0,127
570,249,243,32.13641723356009,33.2974149659864,28.0,29.0,50,1.0,6
571,249,214,32.13641723356009,34.574512471655325,28.0,28.0,111,2.0,35
572,249,484,32.13641723356009,33.529614512471646,28.0,21.0,243,1.0,235
573,249,470,32.13641723356009,34.66739229024943,28.0,23.0,246,3.0,221
574,249,627,32.13641723356009,34.69061224489796,28.0,7.0,394,3.0,378
575,243,146,33.2974149659864,35.898049886621315,29.0,26.0,148,3.0,97
576,243,122,33.2974149659864,36.13024943310658,29.0,27.0,172,3.0,121
577,243,214,33.2974149659864,34.574512471655325,29.0,28.0,62,1.0,29
578,243,249,33.2974149659864,35.131791383219955,29.0,26.0,79,2.0,6
579,243,470,33.2974149659864,34.66739229024943,29.0,23.0,235,1.0,227
580,243,469,33.2974149659864,35.131791383219955,29.0,24.0,239,2.0,226
581,243,469,33.2974149659864,36.176689342403634,29.0,23.0,258,3.0,226
582,243,627,33.2974149659864,34.69061224489796,29.0,7.0,389,1.0,384
583,243,627,33.2974149659864,35.15501133786848,29.0,8.0,392,2.0,384
584,214,146,34.574512471655325,35.898049886621315,28.0,26.0,89,1.0,68
585,214,122,34.574512471655325,36.13024943310658,28.0,27.0,114,2.0,92
586,214,213,34.574512471655325,36.43210884353741,28.0,27.0,80,2.0,1
587,214,249,34.574512471655325,36.98938775510205,28.0,26.0,110,2.0,35
588,214,469,34.574512471655325,36.176689342403634,28.0,23.0,264,2.0,255
589,214,460,34.574512471655325,36.98938775510205,28.0,22.0,267,2.0,246
590,214,627,34.574512471655325,36.52498866213153,28.0,6.0,421,2.0,413
591,214,627,34.574512471655325,36.98938775510205,28.0,7.0,426,2.0,413
592,249,61,35.131791383219955,37.593106575963716,26.0,27.0,216,2.0,188
593,249,122,35.131791383219955,37.987845804988666,26.0,27.0,177,3.0,127
594,249,213,35.131791383219955,36.43210884353741,26.0,27.0,67,1.0,36
595,249,469,35.131791383219955,36.176689342403634,26.0,23.0,225,1.0,220
596,249,460,35.131791383219955,36.98938775510205,26.0,22.0,226,2.0,211
597,249,627,35.131791383219955,36.52498866213153,26.0,6.0,383,1.0,378
598,249,627,35.131791383219955,36.98938775510205,26.0,7.0,386,2.0,378
599,213,61,36.43210884353741,37.593106575963716,27.0,27.0,160,1.0,152
600,213,122,36.43210884353741,37.987845804988666,27.0,27.0,113,2.0,91
601,213,214,36.43210884353741,38.26648526077098,27.0,28.0,79,2.0,1
602,213,469,36.43210884353741,38.35936507936508,27.0,23.0,269,2.0,256
603,213,627,36.43210884353741,38.35936507936508,27.0,7.0,422,2.0,414
604,249,122,36.98938775510205,39.822222222222216,26.0,27.0,176,3.0,127
605,249,214,36.98938775510205,38.26648526077098,26.0,28.0,65,1.0,35
606,249,213,36.98938775510205,39.19528344671202,26.0,28.0,102,2.0,36
607,249,469,36.98938775510205,38.35936507936508,26.0,23.0,228,1.0,220
608,249,469,36.98938775510205,39.86866213151927,26.0,23.0,253,3.0,220
609,249,627,36.98938775510205,38.35936507936508,26.0,7.0,383,1.0,378
610,249,627,36.98938775510205,39.86866213151927,26.0,8.0,398,3.0,378
611,214,122,38.26648526077098,39.822222222222216,28.0,27.0,114,2.0,92
612,214,122,38.26648526077098,40.751020408163264,28.0,26.0,141,2.0,92
613,214,469,38.26648526077098,39.86866213151927,28.0,23.0,264,2.0,255
614,214,469,38.26648526077098,40.21696145124717,28.0,24.0,268,2.0,255
615,214,627,38.26648526077098,39.86866213151927,28.0,8.0,419,2.0,413
616,214,627,38.26648526077098,40.68136054421769,28.0,8.0,426,2.0,413
617,213,122,39.19528344671202,40.751020408163264,28.0,26.0,113,2.0,91
618,213,122,39.19528344671202,41.67981859410431,28.0,28.0,140,2.0,91
619,213,215,39.19528344671202,41.958458049886616,28.0,28.0,119,3.0,2
620,213,249,39.19528344671202,42.05133786848072,28.0,27.0,128,3.0,36
621,213,469,39.19528344671202,40.21696145124717,28.0,24.0,260,1.0,256
622,213,469,39.19528344671202,41.70303854875284,28.0,24.0,278,3.0,256
623,213,469,39.19528344671202,42.05133786848072,28.0,24.0,284,3.0,256
624,213,627,39.19528344671202,40.68136054421769,28.0,8.0,419,1.0,414
625,213,627,39.19528344671202,42.05133786848072,28.0,8.0,432,3.0,414
626,214,122,40.124081632653066,41.67981859410431,28.0,28.0,114,2.0,92
627,214,185,40.124081632653066,42.44607709750567,28.0,27.0,104,2.0,29
628,214,215,40.124081632653066,41.958458049886616,28.0,28.0,79,2.0,1
629,214,249,40.124081632653066,42.05133786848072,28.0,27.0,90,2.0,35
630,214,469,40.124081632653066,41.70303854875284,28.0,24.0,264,2.0,255
631,214,469,40.124081632653066,42.05133786848072,28.0,24.0,268,2.0,255
632,214,627,40.124081632653066,42.05133786848072,28.0,8.0,421,2.0,413
633,215,122,41.958458049886616,43.51419501133787,28.0,28.0,115,2.0,93
634,215,122,41.958458049886616,44.44299319727891,28.0,25.0,142,2.0,93
635,215,213,41.958458049886616,43.81605442176871,28.0,28.0,80,2.0,2
636,215,249,41.958458049886616,44.37333333333334,28.0,25.0,109,2.0,34
637,215,470,41.958458049886616,43.90893424036282,28.0,23.0,268,2.0,255
638,215,470,41.958458049886616,44.35011337868482,28.0,22.0,275,2.0,255
639,215,627,41.958458049886616,43.560634920634925,28.0,7.0,418,2.0,412
640,249,122,42.05133786848072,43.51419501133787,27.0,28.0,142,1.0,127
641,249,122,42.05133786848072,44.44299319727891,27.0,25.0,164,2.0,127
642,249,213,42.05133786848072,43.81605442176871,27.0,28.0,84,2.0,36
643,249,470,42.05133786848072,43.90893424036282,27.0,23.0,235,2.0,221
644,249,470,42.05133786848072,44.35011337868482,27.0,22.0,242,2.0,221
645,249,627,42.05133786848072,43.560634920634925,27.0,7.0,384,2.0,378
646,213,142,43.81605442176871,45.39501133786848,28.0,32.0,98,2.0,71
647,213,214,43.81605442176871,46.57922902494332,28.0,27.0,119,3.0,1
648,213,470,43.81605442176871,45.743310657596375,28.0,24.0,270,2.0,257
649,213,469,43.81605442176871,46.20770975056689,28.0,24.0,276,2.0,256
650,213,631,43.81605442176871,45.7665306122449,28.0,7.0,426,2.0,418
651,213,632,43.81605442176871,46.46312925170068,28.0,6.0,434,3.0,419
652,249,142,44.37333333333334,45.39501133786848,25.0,32.0,116,1.0,107
653,249,65,44.37333333333334,46.834648526077096,25.0,25.0,212,2.0,184
654,249,142,44.37333333333334,47.20616780045352,25.0,29.0,162,3.0,107
655,249,213,44.37333333333334,45.650430839002276,25.0,29.0,66,1.0,36
656,249,214,44.37333333333334,46.57922902494332,25.0,27.0,101,2.0,35
657,249,231,44.37333333333334,47.25260770975056,25.0,29.0,125,3.0,18
658,249,470,44.37333333333334,45.743310657596375,25.0,24.0,229,1.0,221
659,249,469,44.37333333333334,46.20770975056689,25.0,24.0,234,2.0,220
660,249,631,44.37333333333334,45.7665306122449,25.0,7.0,387,1.0,382
661,249,632,44.37333333333334,46.46312925170068,25.0,6.0,393,2.0,383
662,213,65,45.650430839002276,46.834648526077096,29.0,25.0,157,1.0,148
663,213,142,45.650430839002276,47.20616780045352,29.0,29.0,98,2.0,71
664,213,231,45.650430839002276,47.25260770975056,29.0,29.0,71,2.0,18
665,213,469,45.650430839002276,47.60090702947846,29.0,22.0,269,2.0,256
666,213,470,45.650430839002276,48.04208616780046,29.0,23.0,277,2.0,257
667,213,637,45.650430839002276,48.4368253968254,29.0,10.0,441,3.0,424
668,214,181,46.57922902494332,48.785124716553284,27.0,26.0,101,2.0,33
669,214,250,46.57922902494332,48.76190476190477,27.0,27.0,101,2.0,36
670,214,469,46.57922902494332,47.60090702947846,27.0,22.0,259,1.0,255
671,214,470,46.57922902494332,48.04208616780046,27.0,23.0,264,1.0,256
672,214,469,46.57922902494332,49.43528344671203,27.0,23.0,283,3.0,255
673,214,637,46.57922902494332,48.4368253968254,27.0,10.0,430,2.0,423
674,231,181,47.25260770975056,48.785124716553284,29.0,26.0,83,2.0,50
675,231,129,47.25260770975056,49.96934240362812,29.0,25.0,155,3.0,102
676,231,250,47.25260770975056,48.76190476190477,29.0,27.0,68,2.0,19
677,231,249,47.25260770975056,49.899682539682544,29.0,28.0,115,3.0,18
678,231,469,47.25260770975056,49.43528344671203,29.0,23.0,256,2.0,238
679,231,637,47.25260770975056,48.4368253968254,29.0,10.0,409,1.0,406
680,250,129,48.76190476190477,49.96934240362812,27.0,25.0,132,1.0,121
681,250,64,48.76190476190477,50.71238095238096,27.0,25.0,204,2.0,186
682,250,68,48.76190476190477,51.1071201814059,27.0,25.0,208,2.0,182
683,250,249,48.76190476190477,49.899682539682544,27.0,28.0,49,1.0,1
684,250,220,48.76190476190477,50.89814058956916,27.0,30.0,97,2.0,30
685,250,468,48.76190476190477,50.596281179138316,27.0,25.0,232,2.0,218
686,250,468,48.76190476190477,51.2928798185941,27.0,22.0,244,3.0,218
687,250,631,48.76190476190477,50.57306122448979,27.0,12.0,389,2.0,381
688,249,68,49.899682539682544,51.1071201814059,28.0,25.0,188,1.0,181
689,249,163,49.899682539682544,52.8021768707483,28.0,31.0,152,3.0,86
690,249,257,49.899682539682544,51.75727891156463,28.0,26.0,80,2.0,8
691,249,257,49.899682539682544,51.98947845804989,28.0,27.0,90,2.0,8
692,249,468,49.899682539682544,51.2928798185941,28.0,22.0,227,1.0,219
693,249,469,49.899682539682544,52.43065759637188,28.0,23.0,246,3.0,220
694,249,648,49.899682539682544,52.314557823129256,28.0,9.0,412,2.0,399
695,220,163,50.89814058956916,52.8021768707483,30.0,31.0,100,2.0,57
696,220,146,50.89814058956916,53.080816326530616,30.0,31.0,120,2.0,74
697,220,257,50.89814058956916,51.98947845804989,30.0,27.0,60,1.0,37
698,220,239,50.89814058956916,53.429115646258495,30.0,26.0,111,3.0,19
699,220,469,50.89814058956916,52.43065759637188,30.0,23.0,258,2.0,249
700,220,518,50.89814058956916,53.080816326530616,30.0,24.0,312,2.0,298
701,220,648,50.89814058956916,52.314557823129256,30.0,9.0,432,1.0,428
702,220,627,50.89814058956916,53.777414965986395,30.0,8.0,425,3.0,407
703,257,163,51.75727891156463,52.8021768707483,26.0,31.0,104,1.0,94
704,257,146,51.75727891156463,53.080816326530616,26.0,31.0,125,1.0,111
705,257,164,51.75727891156463,54.63655328798186,26.0,30.0,155,3.0,93
706,257,239,51.75727891156463,53.429115646258495,26.0,26.0,74,2.0,18
707,257,518,51.75727891156463,53.080816326530616,26.0,24.0,267,1.0,261
708,257,468,51.75727891156463,54.28825396825397,26.0,24.0,237,3.0,211
709,257,627,51.75727891156463,53.777414965986395,26.0,8.0,380,2.0,370
710,257,616,51.75727891156463,54.125714285714295,26.0,8.0,373,2.0,359
711,257,146,51.98947845804989,53.080816326530616,27.0,31.0,121,1.0,111
712,257,164,51.98947845804989,54.63655328798186,27.0,30.0,147,3.0,93
713,257,239,51.98947845804989,53.429115646258495,27.0,26.0,65,1.0,18
714,257,225,51.98947845804989,54.91519274376417,27.0,30.0,130,3.0,32
715,257,518,51.98947845804989,53.080816326530616,27.0,24.0,265,1.0,261
716,257,468,51.98947845804989,54.28825396825397,27.0,24.0,233,2.0,211
717,257,627,51.98947845804989,53.777414965986395,27.0,8.0,378,2.0,370
718,257,616,51.98947845804989,54.125714285714295,27.0,8.0,371,2.0,359
719,239,164,53.429115646258495,54.63655328798186,26.0,30.0,91,1.0,75
720,239,67,53.429115646258495,55.70467120181406,26.0,33.0,198,2.0,172
721,239,76,53.429115646258495,56.21551020408163,26.0,25.0,202,3.0,163
722,239,225,53.429115646258495,54.91519274376417,26.0,30.0,66,1.0,14
723,239,231,53.429115646258495,55.727891156462576,26.0,27.0,99,2.0,8
724,239,525,53.429115646258495,55.51891156462585,26.0,22.0,300,2.0,286
725,239,629,53.429115646258495,55.51891156462585,26.0,8.0,400,2.0,390
726,225,76,54.91519274376417,56.21551020408163,30.0,25.0,159,1.0,149
727,225,78,54.91519274376417,57.26040816326531,30.0,26.0,178,2.0,147
728,225,250,54.91519274376417,56.470929705215426,30.0,28.0,72,2.0,25
729,225,246,54.91519274376417,57.23718820861678,30.0,29.0,102,2.0,21
730,225,469,54.91519274376417,56.81922902494331,30.0,24.0,257,2.0,244
731,225,469,54.91519274376417,57.28362811791385,30.0,25.0,264,2.0,244
732,225,615,54.91519274376417,56.81922902494331,30.0,7.0,399,2.0,390
733,231,78,55.727891156462576,57.26040816326531,27.0,26.0,167,2.0,153
734,231,191,55.727891156462576,58.514285714285705,27.0,29.0,126,3.0,40
735,231,246,55.727891156462576,57.23718820861678,27.0,29.0,67,2.0,15
736,231,233,55.727891156462576,58.25886621315193,27.0,32.0,109,3.0,2
737,231,469,55.727891156462576,56.81922902494331,27.0,24.0,243,1.0,238
738,231,469,55.727891156462576,57.28362811791385,27.0,25.0,247,2.0,238
739,231,469,55.727891156462576,58.328526077097514,27.0,24.0,263,3.0,238
740,231,615,55.727891156462576,56.81922902494331,27.0,7.0,387,1.0,384
741,250,191,56.470929705215426,58.514285714285705,28.0,29.0,106,2.0,59
742,250,145,56.470929705215426,59.141224489795924,28.0,26.0,156,3.0,105
743,250,233,56.470929705215426,58.25886621315193,28.0,32.0,79,2.0,17
744,250,249,56.470929705215426,59.141224489795924,28.0,28.0,115,3.0,1
745,250,469,56.470929705215426,58.328526077097514,28.0,24.0,233,2.0,219
746,250,470,56.470929705215426,59.11800453514739,28.0,24.0,248,3.0,220
747,246,191,57.23718820861678,58.514285714285705,29.0,29.0,78,1.0,55
748,246,145,57.23718820861678,59.141224489795924,29.0,26.0,130,2.0,101
749,246,233,57.23718820861678,58.25886621315193,29.0,32.0,46,1.0,13
750,246,249,57.23718820861678,59.141224489795924,29.0,28.0,82,2.0,3
751,246,469,57.23718820861678,58.328526077097514,29.0,24.0,228,1.0,223
752,246,470,57.23718820861678,59.11800453514739,29.0,24.0,238,2.0,224
753,450,61,1.9504761904761905,3.506213151927437,18.0,29.0,395,2.0,389
754,450,308,1.9504761904761905,3.5758730158730163,18.0,34.0,158,2.0,142
755,450,489,1.9504761904761905,3.7616326530612247,18.0,17.0,87,2.0,39
756,450,637,1.9504761904761905,3.9473922902494327,18.0,6.0,206,2.0,187
757,489,65,3.7616326530612247,4.96907029478458,17.0,29.0,427,1.0,424
758,489,65,3.7616326530612247,5.8978684807256245,17.0,31.0,434,2.0,424
759,489,142,3.7616326530612247,6.687346938775511,17.0,30.0,369,3.0,347
760,489,243,3.7616326530612247,4.96907029478458,17.0,37.0,251,1.0,246
761,489,243,3.7616326530612247,5.085170068027211,17.0,36.0,253,1.0,246
762,489,247,3.7616326530612247,6.5712471655328795,17.0,36.0,271,3.0,242
763,489,501,3.7616326530612247,4.945850340136055,17.0,21.0,52,1.0,12
764,489,486,3.7616326530612247,5.0155102040816315,17.0,19.0,54,1.0,3
765,489,482,3.7616326530612247,6.106848072562357,17.0,22.0,101,2.0,7
766,489,630,3.7616326530612247,4.945850340136055,17.0,6.0,150,1.0,141
767,489,645,3.7616326530612247,6.1532879818594095,17.0,9.0,187,2.0,156
768,501,142,4.945850340136055,6.687346938775511,21.0,30.0,367,2.0,359
769,501,143,4.945850340136055,7.476825396825397,21.0,29.0,374,3.0,358
770,501,247,4.945850340136055,6.5712471655328795,21.0,36.0,263,2.0,254
771,501,244,4.945850340136055,7.7090249433106575,21.0,33.0,283,3.0,257
772,501,482,4.945850340136055,6.106848072562357,21.0,22.0,53,1.0,19
773,501,492,4.945850340136055,7.058866213151928,21.0,25.0,91,2.0,9
774,501,645,4.945850340136055,6.1532879818594095,21.0,9.0,153,1.0,144
775,501,775,4.945850340136055,7.012426303854876,21.0,7.0,288,2.0,274
776,486,142,5.0155102040816315,6.687346938775511,19.0,30.0,351,2.0,344
777,486,143,5.0155102040816315,7.476825396825397,19.0,29.0,359,2.0,343
778,486,247,5.0155102040816315,6.5712471655328795,19.0,36.0,248,2.0,239
779,486,244,5.0155102040816315,7.7090249433106575,19.0,33.0,268,3.0,242
780,486,482,5.0155102040816315,6.106848072562357,19.0,22.0,47,1.0,4
781,486,492,5.0155102040816315,7.058866213151928,19.0,25.0,88,2.0,6
782,486,645,5.0155102040816315,6.1532879818594095,19.0,9.0,166,1.0,159
783,486,775,5.0155102040816315,7.012426303854876,19.0,7.0,302,2.0,289
784,482,143,6.106848072562357,7.476825396825397,22.0,29.0,344,1.0,339
785,482,81,6.106848072562357,8.219863945578231,22.0,29.0,411,2.0,401
786,482,244,6.106848072562357,7.7090249433106575,22.0,33.0,248,2.0,238
787,482,215,6.106848072562357,8.684263038548753,22.0,36.0,289,3.0,267
788,482,502,6.106848072562357,8.196643990929706,22.0,20.0,92,2.0,20
789,482,812,6.106848072562357,8.70748299319728,22.0,9.0,348,3.0,330
790,482,838,6.106848072562357,8.452063492063493,22.0,9.0,370,2.0,356
791,492,81,7.058866213151928,8.219863945578231,25.0,29.0,414,1.0,411
792,492,76,7.058866213151928,9.775600907029476,25.0,27.0,432,3.0,416
793,492,215,7.058866213151928,8.684263038548753,25.0,36.0,286,2.0,277
794,492,231,7.058866213151928,9.775600907029476,25.0,29.0,286,3.0,261
795,492,502,7.058866213151928,8.196643990929706,25.0,20.0,50,1.0,10
796,492,498,7.058866213151928,9.961360544217689,25.0,22.0,125,3.0,6
797,492,497,7.058866213151928,9.984580498866212,25.0,22.0,126,3.0,5
798,492,812,7.058866213151928,8.70748299319728,25.0,9.0,328,2.0,320
799,492,644,7.058866213151928,9.961360544217689,25.0,13.0,197,3.0,152
800,492,645,7.058866213151928,9.984580498866212,25.0,11.0,198,3.0,153
801,492,838,7.058866213151928,8.452063492063493,25.0,9.0,351,1.0,346
802,492,827,7.058866213151928,9.914920634920636,25.0,8.0,357,3.0,335
803,502,76,8.196643990929706,9.775600907029476,20.0,27.0,431,2.0,426
804,502,198,8.196643990929706,10.959818594104311,20.0,28.0,326,3.0,304
805,502,179,8.196643990929706,11.168798185941043,20.0,28.0,347,3.0,323
806,502,231,8.196643990929706,9.775600907029476,20.0,29.0,279,2.0,271
807,502,311,8.196643990929706,10.820498866213152,20.0,35.0,222,3.0,191
808,502,228,8.196643990929706,11.168798185941043,20.0,34.0,302,3.0,274
809,502,498,8.196643990929706,9.961360544217689,20.0,22.0,76,2.0,4
810,502,497,8.196643990929706,9.984580498866212,20.0,22.0,77,2.0,5
811,502,644,8.196643990929706,9.961360544217689,20.0,13.0,161,2.0,142
812,502,645,8.196643990929706,9.984580498866212,20.0,11.0,162,2.0,143
813,502,827,8.196643990929706,9.914920634920636,20.0,8.0,333,2.0,325
814,498,179,9.961360544217689,11.168798185941043,22.0,28.0,323,1.0,319
815,498,54,9.961360544217689,12.538775510204086,22.0,23.0,458,3.0,444
816,498,228,9.961360544217689,11.168798185941043,22.0,34.0,275,1.0,270
817,498,216,9.961360544217689,11.981496598639454,22.0,32.0,295,2.0,282
818,498,483,9.961360544217689,11.795736961451249,22.0,21.0,80,2.0,15
819,498,493,9.961360544217689,12.469115646258507,22.0,22.0,108,3.0,5
820,498,631,9.961360544217689,11.818956916099776,22.0,11.0,155,2.0,133
821,498,632,9.961360544217689,12.213696145124715,22.0,9.0,165,2.0,134
822,498,848,9.961360544217689,11.77251700680272,22.0,6.0,359,2.0,350
823,497,179,9.984580498866212,11.168798185941043,22.0,28.0,322,1.0,318
824,497,54,9.984580498866212,12.538775510204086,22.0,23.0,456,3.0,443
825,497,228,9.984580498866212,11.168798185941043,22.0,34.0,274,1.0,269
826,497,216,9.984580498866212,11.981496598639454,22.0,32.0,294,2.0,281
827,497,483,9.984580498866212,11.795736961451249,22.0,21.0,79,2.0,14
828,497,493,9.984580498866212,12.469115646258507,22.0,22.0,107,2.0,4
829,497,631,9.984580498866212,11.818956916099776,22.0,11.0,156,2.0,134
830,497,632,9.984580498866212,12.213696145124715,22.0,9.0,166,2.0,135
831,497,848,9.984580498866212,11.77251700680272,22.0,6.0,359,2.0,351
832,483,140,11.795736961451249,13.74621315192744,21.0,27.0,353,2.0,343
833,483,194,11.795736961451249,14.419591836734696,21.0,30.0,310,3.0,289
834,483,303,11.795736961451249,13.444353741496599,21.0,30.0,193,2.0,180
835,483,225,11.795736961451249,14.489251700680272,21.0,37.0,283,3.0,258
836,483,442,11.795736961451249,13.653333333333334,21.0,21.0,90,2.0,41
837,483,499,11.795736961451249,14.55891156462585,21.0,24.0,120,3.0,16
838,483,636,11.795736961451249,13.653333333333334,21.0,11.0,173,2.0,153
839,493,140,12.469115646258507,13.74621315192744,22.0,27.0,357,1.0,353
840,493,194,12.469115646258507,14.419591836734696,22.0,30.0,311,2.0,299
841,493,130,12.469115646258507,15.023310657596374,22.0,29.0,379,3.0,363
842,493,225,12.469115646258507,14.489251700680272,22.0,37.0,282,2.0,268
843,493,442,12.469115646258507,13.653333333333334,22.0,21.0,72,1.0,51
844,493,499,12.469115646258507,14.55891156462585,22.0,24.0,90,2.0,6
845,493,490,12.469115646258507,15.301950113378684,22.0,19.0,122,3.0,3
846,493,636,12.469115646258507,13.653333333333334,22.0,11.0,152,1.0,143
847,442,130,13.653333333333334,15.023310657596374,21.0,29.0,318,1.0,312
848,442,215,13.653333333333334,15.650249433106575,21.0,36.0,243,2.0,227
849,442,226,13.653333333333334,16.091428571428573,21.0,32.0,240,2.0,216
850,442,490,13.653333333333334,15.301950113378684,21.0,19.0,86,2.0,48
851,442,486,13.653333333333334,16.137868480725626,21.0,23.0,116,2.0,44
852,499,150,14.55891156462585,16.880907029478458,24.0,30.0,363,2.0,349
853,499,215,14.55891156462585,15.650249433106575,24.0,36.0,288,1.0,284
854,499,226,14.55891156462585,16.091428571428573,24.0,32.0,281,2.0,273
855,499,308,14.55891156462585,17.484625850340134,24.0,34.0,229,3.0,191
856,499,486,14.55891156462585,16.137868480725626,24.0,23.0,69,2.0,13
857,499,504,14.55891156462585,17.020226757369613,24.0,23.0,106,2.0,5
858,499,616,14.55891156462585,16.99700680272109,24.0,8.0,157,2.0,117
859,490,150,15.301950113378684,16.880907029478458,19.0,30.0,347,2.0,340
860,490,123,15.301950113378684,17.972244897959186,19.0,23.0,385,3.0,367
861,490,308,15.301950113378684,17.484625850340134,19.0,34.0,205,2.0,182
862,490,504,15.301950113378684,17.020226757369613,19.0,23.0,75,2.0,14
863,490,515,15.301950113378684,18.22766439909297,19.0,19.0,128,3.0,25
864,490,616,15.301950113378684,16.99700680272109,19.0,8.0,146,2.0,126
865,486,123,16.137868480725626,17.972244897959186,23.0,23.0,371,2.0,363
866,486,182,16.137868480725626,18.784943310657603,23.0,29.0,325,3.0,304
867,486,308,16.137868480725626,17.484625850340134,23.0,34.0,187,1.0,178
868,486,243,16.137868480725626,18.784943310657603,23.0,33.0,268,3.0,243
869,486,515,16.137868480725626,18.22766439909297,23.0,19.0,95,2.0,29
870,504,182,17.020226757369613,18.784943310657603,23.0,29.0,331,2.0,322
871,504,204,17.020226757369613,19.319002267573694,23.0,28.0,316,2.0,300
872,504,243,17.020226757369613,18.784943310657603,23.0,33.0,272,2.0,261
873,504,205,17.020226757369613,19.295782312925173,23.0,32.0,315,2.0,299
874,504,515,17.020226757369613,18.22766439909297,23.0,19.0,53,1.0,11
875,504,469,17.020226757369613,19.899501133786853,23.0,24.0,129,3.0,35
876,504,807,17.020226757369613,19.899501133786853,23.0,7.0,327,3.0,303
877,515,204,18.22766439909297,19.319002267573694,19.0,28.0,315,1.0,311
878,515,81,18.22766439909297,20.66575963718821,19.0,27.0,447,2.0,434
879,515,205,18.22766439909297,19.295782312925173,19.0,32.0,313,1.0,310
880,515,328,18.22766439909297,20.967619047619053,19.0,30.0,221,3.0,187
881,515,469,18.22766439909297,19.899501133786853,19.0,24.0,85,2.0,46
882,515,469,18.22766439909297,20.363900226757373,19.0,25.0,103,2.0,46
883,515,807,18.22766439909297,19.899501133786853,19.0,7.0,301,2.0,292
884,469,185,19.899501133786853,21.315918367346942,24.0,26.0,290,1.0,284
885,469,328,19.899501133786853,20.967619047619053,24.0,30.0,148,1.0,141
886,469,249,19.899501133786853,21.40879818594105,24.0,28.0,229,2.0,220
887,469,308,19.899501133786853,22.63945578231293,24.0,29.0,200,3.0,161
888,469,468,19.899501133786853,21.40879818594105,24.0,23.0,65,2.0,1
889,469,637,19.899501133786853,22.15183673469388,24.0,13.0,194,2.0,168
890,469,841,19.899501133786853,21.757097505668934,24.0,9.0,381,2.0,372
891,469,858,19.899501133786853,22.15183673469388,24.0,7.0,401,2.0,389
892,469,65,20.363900226757373,22.964535147392287,25.0,26.0,419,3.0,404
893,469,249,20.363900226757373,21.40879818594105,25.0,28.0,225,1.0,220
894,469,308,20.363900226757373,22.63945578231293,25.0,29.0,188,2.0,161
895,469,468,20.363900226757373,21.40879818594105,25.0,23.0,45,1.0,1
896,469,637,20.363900226757373,22.15183673469388,25.0,13.0,185,2.0,168
897,469,841,20.363900226757373,21.757097505668934,25.0,9.0,377,1.0,372
898,469,858,20.363900226757373,22.15183673469388,25.0,7.0,397,2.0,389
899,469,825,20.363900226757373,23.243174603174605,25.0,7.0,377,3.0,356
900,468,65,21.40879818594105,22.964535147392287,23.0,26.0,409,2.0,403
901,468,81,21.40879818594105,23.89333333333333,23.0,28.0,402,2.0,387
902,468,308,21.40879818594105,22.63945578231293,23.0,29.0,169,1.0,160
903,468,249,21.40879818594105,23.591473922902487,23.0,27.0,238,2.0,219
904,468,469,21.40879818594105,23.591473922902487,23.0,24.0,94,2.0,1
905,468,469,21.40879818594105,24.05587301587301,23.0,25.0,114,3.0,1
906,468,825,21.40879818594105,23.243174603174605,23.0,7.0,366,2.0,357
907,468,842,21.40879818594105,24.05587301587301,23.0,6.0,391,3.0,374
908,469,81,22.19827664399093,23.89333333333333,22.0,28.0,395,2.0,388
909,469,66,22.19827664399093,24.845351473922907,22.0,27.0,419,3.0,403
910,469,249,22.19827664399093,23.591473922902487,22.0,27.0,228,1.0,220
911,469,327,22.19827664399093,24.636371882086173,22.0,29.0,177,2.0,142
912,469,825,22.19827664399093,23.243174603174605,22.0,7.0,359,1.0,356
913,469,842,22.19827664399093,24.05587301587301,22.0,6.0,381,2.0,373
914,469,66,23.591473922902487,24.845351473922907,24.0,27.0,407,1.0,403
915,469,195,23.591473922902487,25.936689342403632,24.0,30.0,292,2.0,274
916,469,161,23.591473922902487,26.029569160997728,24.0,27.0,325,2.0,308
917,469,327,23.591473922902487,24.636371882086173,24.0,29.0,149,1.0,142
918,469,249,23.591473922902487,25.44907029478458,24.0,27.0,234,2.0,220
919,469,615,23.591473922902487,26.493968253968248,24.0,13.0,192,3.0,146
920,469,827,23.591473922902487,26.51718820861678,24.0,7.0,380,3.0,358
921,469,195,24.05587301587301,25.936689342403632,25.0,30.0,286,2.0,274
922,469,161,24.05587301587301,26.029569160997728,25.0,27.0,320,2.0,308
923,469,249,24.05587301587301,25.44907029478458,25.0,27.0,228,1.0,220
924,469,249,24.05587301587301,26.935147392290247,25.0,28.0,253,3.0,220
925,469,615,24.05587301587301,26.493968253968248,25.0,13.0,180,2.0,146
926,469,827,24.05587301587301,26.51718820861678,25.0,7.0,373,2.0,358
927,469,144,25.890249433106572,27.747845804988664,23.0,23.0,335,2.0,325
928,469,144,25.890249433106572,28.792743764172336,23.0,23.0,348,3.0,325
929,469,249,25.890249433106572,26.935147392290247,23.0,28.0,225,1.0,220
930,469,249,25.890249433106572,27.747845804988664,23.0,28.0,234,2.0,220
931,469,311,25.890249433106572,28.258684807256238,23.0,28.0,188,2.0,158
932,469,808,25.890249433106572,27.28344671201814,23.0,8.0,344,1.0,339
933,469,626,25.890249433106572,28.630204081632648,23.0,7.0,196,3.0,157
934,469,144,26.935147392290247,28.792743764172336,23.0,23.0,335,2.0,325
935,469,129,26.935147392290247,29.41968253968254,23.0,28.0,356,2.0,340
936,469,311,26.935147392290247,28.258684807256238,23.0,28.0,168,1.0,158
937,469,249,26.935147392290247,29.141043083900232,23.0,27.0,240,2.0,220
938,469,626,26.935147392290247,28.630204081632648,23.0,7.0,173,2.0,157
939,469,144,27.28344671201814,28.792743764172336,24.0,23.0,331,2.0,325
940,469,129,27.28344671201814,29.41968253968254,24.0,28.0,352,2.0,340
941,469,249,27.28344671201814,29.141043083900232,24.0,27.0,234,2.0,220
942,469,626,27.28344671201814,28.630204081632648,24.0,7.0,167,1.0,157
943,469,65,28.44444444444445,30.81287981859411,23.0,28.0,417,2.0,404
944,469,249,28.44444444444445,30.97541950113379,23.0,27.0,246,3.0,220
945,469,853,28.44444444444445,30.627120181405893,23.0,6.0,395,2.0,384
946,469,65,29.582222222222228,30.81287981859411,23.0,28.0,407,1.0,404
947,469,91,29.582222222222228,31.950657596371883,23.0,25.0,392,2.0,378
948,469,77,29.582222222222228,32.43827664399093,23.0,26.0,411,3.0,392
949,469,249,29.582222222222228,30.97541950113379,23.0,27.0,228,1.0,220
950,469,249,29.582222222222228,31.43981859410431,23.0,28.0,234,2.0,220
951,469,249,29.582222222222228,32.13641723356009,23.0,28.0,246,3.0,220
952,469,628,29.582222222222228,31.695238095238093,23.0,8.0,183,2.0,159
953,469,853,29.582222222222228,30.627120181405893,23.0,6.0,387,1.0,384
954,469,91,30.627120181405893,31.950657596371883,23.0,25.0,382,1.0,378
955,469,77,30.627120181405893,32.43827664399093,23.0,26.0,400,2.0,392
956,469,249,30.627120181405893,32.13641723356009,23.0,28.0,229,2.0,220
957,469,243,30.627120181405893,33.2974149659864,23.0,29.0,254,3.0,226
958,469,484,30.627120181405893,33.529614512471646,23.0,21.0,126,3.0,15
959,469,628,30.627120181405893,31.695238095238093,23.0,8.0,166,1.0,159
960,469,804,30.627120181405893,32.80979591836735,23.0,6.0,348,2.0,335
961,469,61,31.43981859410431,33.90113378684807,23.0,29.0,422,2.0,408
962,469,122,31.43981859410431,34.29587301587301,23.0,27.0,368,3.0,347
963,469,243,31.43981859410431,33.2974149659864,23.0,29.0,240,2.0,226
964,469,484,31.43981859410431,33.529614512471646,23.0,21.0,91,2.0,15
965,469,804,31.43981859410431,32.80979591836735,23.0,6.0,340,1.0,335
966,469,846,31.43981859410431,34.319092970521545,23.0,6.0,397,3.0,377
967,469,61,32.80979591836735,33.90113378684807,22.0,29.0,411,1.0,408
968,469,122,32.80979591836735,34.29587301587301,22.0,27.0,353,1.0,347
969,469,214,32.80979591836735,34.574512471655325,22.0,28.0,266,2.0,255
970,469,249,32.80979591836735,35.131791383219955,22.0,26.0,242,2.0,220
971,469,470,32.80979591836735,34.66739229024943,22.0,23.0,80,2.0,1
972,469,627,32.80979591836735,34.69061224489796,22.0,7.0,178,2.0,158
973,469,627,32.80979591836735,35.15501133786848,22.0,8.0,188,2.0,158
974,469,846,32.80979591836735,34.319092970521545,22.0,6.0,383,2.0,377
975,484,146,33.529614512471646,35.898049886621315,21.0,26.0,353,2.0,338
976,484,122,33.529614512471646,36.13024943310658,21.0,27.0,379,3.0,362
977,484,214,33.529614512471646,34.574512471655325,21.0,28.0,274,1.0,270
978,484,249,33.529614512471646,35.131791383219955,21.0,26.0,245,2.0,235
979,484,213,33.529614512471646,36.43210884353741,21.0,27.0,298,3.0,271
980,484,470,33.529614512471646,34.66739229024943,21.0,23.0,51,1.0,14
981,484,469,33.529614512471646,35.131791383219955,21.0,24.0,71,2.0,15
982,484,469,33.529614512471646,36.176689342403634,21.0,23.0,115,3.0,15
983,484,627,33.529614512471646,34.69061224489796,21.0,7.0,151,1.0,143
984,484,627,33.529614512471646,35.15501133786848,21.0,8.0,159,2.0,143
985,484,846,33.529614512471646,36.176689342403634,21.0,6.0,380,3.0,362
986,470,146,34.66739229024943,35.898049886621315,23.0,26.0,328,1.0,324
987,470,122,34.66739229024943,36.13024943310658,23.0,27.0,354,1.0,348
988,470,61,34.66739229024943,37.593106575963716,23.0,27.0,428,3.0,409
989,470,213,34.66739229024943,36.43210884353741,23.0,27.0,268,2.0,257
990,470,249,34.66739229024943,36.98938775510205,23.0,26.0,243,2.0,221
991,470,469,34.66739229024943,36.176689342403634,23.0,23.0,65,2.0,1
992,470,460,34.66739229024943,36.98938775510205,23.0,22.0,100,2.0,10
993,470,627,34.66739229024943,36.52498866213153,23.0,6.0,176,2.0,157
994,470,627,34.66739229024943,36.98938775510205,23.0,7.0,186,2.0,157
995,470,846,34.66739229024943,36.176689342403634,23.0,6.0,382,2.0,376
996,469,61,35.131791383219955,37.593106575963716,24.0,27.0,422,2.0,408
997,469,122,35.131791383219955,37.987845804988666,24.0,27.0,368,3.0,347
998,469,213,35.131791383219955,36.43210884353741,24.0,27.0,262,1.0,256
999,469,249,35.131791383219955,36.98938775510205,24.0,26.0,234,2.0,220
1000,469,460,35.131791383219955,36.98938775510205,24.0,22.0,81,2.0,9
1001,469,627,35.131791383219955,36.52498866213153,24.0,6.0,169,1.0,158
1002,469,627,35.131791383219955,36.98938775510205,24.0,7.0,177,2.0,158
1003,469,846,35.131791383219955,36.176689342403634,24.0,6.0,380,1.0,377
1004,469,61,36.176689342403634,37.593106575963716,23.0,27.0,413,1.0,408
1005,469,122,36.176689342403634,37.987845804988666,23.0,27.0,356,2.0,347
1006,469,214,36.176689342403634,38.26648526077098,23.0,28.0,270,2.0,255
1007,469,627,36.176689342403634,38.35936507936508,23.0,7.0,184,2.0,158
1008,460,122,36.98938775510205,39.822222222222216,22.0,27.0,359,3.0,338
1009,460,214,36.98938775510205,38.26648526077098,22.0,28.0,252,1.0,246
1010,460,213,36.98938775510205,39.19528344671202,22.0,28.0,265,2.0,247
1011,460,469,36.98938775510205,38.35936507936508,22.0,23.0,60,1.0,9
1012,460,469,36.98938775510205,39.86866213151927,22.0,23.0,124,3.0,9
1013,460,627,36.98938775510205,38.35936507936508,22.0,7.0,177,1.0,167
1014,460,627,36.98938775510205,39.86866213151927,22.0,8.0,208,3.0,167
1015,469,122,38.35936507936508,39.822222222222216,23.0,27.0,353,1.0,347
1016,469,122,38.35936507936508,40.751020408163264,23.0,26.0,362,2.0,347
1017,469,214,38.35936507936508,40.124081632653066,23.0,28.0,266,2.0,255
1018,469,627,38.35936507936508,39.86866213151927,23.0,8.0,171,2.0,158
1019,469,627,38.35936507936508,40.68136054421769,23.0,8.0,187,2.0,158
1020,469,122,39.86866213151927,41.67981859410431,23.0,28.0,356,2.0,347
1021,469,185,39.86866213151927,42.44607709750567,23.0,27.0,305,3.0,284
1022,469,215,39.86866213151927,41.958458049886616,23.0,28.0,269,2.0,254
1023,469,249,39.86866213151927,42.05133786848072,23.0,27.0,239,2.0,220
1024,469,627,39.86866213151927,42.05133786848072,23.0,8.0,184,2.0,158
1025,469,122,40.21696145124717,41.67981859410431,24.0,28.0,353,1.0,347
1026,469,185,40.21696145124717,42.44607709750567,24.0,27.0,300,2.0,284
1027,469,215,40.21696145124717,41.958458049886616,24.0,28.0,265,2.0,254
1028,469,249,40.21696145124717,42.05133786848072,24.0,27.0,234,2.0,220
1029,469,627,40.21696145124717,42.05133786848072,24.0,8.0,177,2.0,158
1030,469,122,41.70303854875284,43.51419501133787,24.0,28.0,356,2.0,347
1031,469,122,41.70303854875284,44.44299319727891,24.0,25.0,367,3.0,347
1032,469,213,41.70303854875284,43.81605442176871,24.0,28.0,272,2.0,256
1033,469,249,41.70303854875284,44.37333333333334,24.0,25.0,248,3.0,220
1034,469,470,41.70303854875284,43.90893424036282,24.0,23.0,95,2.0,1
1035,469,470,41.70303854875284,44.35011337868482,24.0,22.0,114,3.0,1
1036,469,627,41.70303854875284,43.560634920634925,24.0,7.0,177,2.0,158
1037,469,122,42.05133786848072,43.51419501133787,24.0,28.0,353,1.0,347
1038,469,122,42.05133786848072,44.44299319727891,24.0,25.0,362,2.0,347
1039,469,213,42.05133786848072,43.81605442176871,24.0,28.0,267,2.0,256
1040,469,249,42.05133786848072,44.37333333333334,24.0,25.0,242,2.0,220
1041,469,470,42.05133786848072,43.90893424036282,24.0,23.0,80,2.0,1
1042,469,470,42.05133786848072,44.35011337868482,24.0,22.0,99,2.0,1
1043,469,627,42.05133786848072,43.560634920634925,24.0,7.0,171,2.0,158
1044,470,142,43.90893424036282,45.39501133786848,23.0,32.0,334,1.0,328
1045,470,65,43.90893424036282,46.834648526077096,23.0,25.0,424,3.0,405
1046,470,213,43.90893424036282,45.650430839002276,23.0,29.0,268,2.0,257
1047,470,214,43.90893424036282,46.57922902494332,23.0,27.0,281,3.0,256
1048,470,469,43.90893424036282,46.20770975056689,23.0,24.0,99,2.0,1
1049,470,631,43.90893424036282,45.7665306122449,23.0,7.0,180,2.0,161
1050,470,632,43.90893424036282,46.46312925170068,23.0,6.0,196,3.0,162
1051,470,142,44.35011337868482,45.39501133786848,22.0,32.0,331,1.0,328
1052,470,65,44.35011337868482,46.834648526077096,22.0,25.0,419,2.0,405
1053,470,142,44.35011337868482,47.20616780045352,22.0,29.0,350,3.0,328
1054,470,213,44.35011337868482,45.650430839002276,22.0,29.0,263,1.0,257
1055,470,214,44.35011337868482,46.57922902494332,22.0,27.0,273,2.0,256
1056,470,231,44.35011337868482,47.25260770975056,22.0,29.0,270,3.0,239
1057,470,469,44.35011337868482,46.20770975056689,22.0,24.0,80,2.0,1
1058,470,631,44.35011337868482,45.7665306122449,22.0,7.0,172,1.0,161
1059,470,632,44.35011337868482,46.46312925170068,22.0,6.0,186,2.0,162
1060,470,65,45.743310657596375,46.834648526077096,24.0,25.0,408,1.0,405
1061,470,142,45.743310657596375,47.20616780045352,24.0,29.0,334,1.0,328
1062,470,231,45.743310657596375,47.25260770975056,24.0,29.0,248,2.0,239
1063,470,469,45.743310657596375,47.60090702947846,24.0,22.0,80,2.0,1
1064,470,637,45.743310657596375,48.4368253968254,24.0,10.0,203,3.0,167
1065,469,181,46.20770975056689,48.785124716553284,24.0,26.0,309,3.0,288
1066,469,231,46.20770975056689,47.25260770975056,24.0,29.0,242,1.0,238
1067,469,250,46.20770975056689,48.76190476190477,24.0,27.0,245,3.0,219
1068,469,470,46.20770975056689,48.04208616780046,24.0,23.0,79,2.0,1
1069,469,637,46.20770975056689,48.4368253968254,24.0,10.0,193,2.0,168
1070,469,181,47.60090702947846,48.785124716553284,22.0,26.0,292,1.0,288
1071,469,129,47.60090702947846,49.96934240362812,22.0,25.0,355,2.0,340
1072,469,250,47.60090702947846,48.76190476190477,22.0,27.0,225,1.0,219
1073,469,249,47.60090702947846,49.899682539682544,22.0,28.0,241,2.0,220
1074,469,631,47.60090702947846,50.57306122448979,22.0,12.0,206,3.0,162
1075,470,129,48.04208616780046,49.96934240362812,23.0,25.0,351,2.0,341
1076,470,64,48.04208616780046,50.71238095238096,23.0,25.0,422,3.0,406
1077,470,249,48.04208616780046,49.899682539682544,23.0,28.0,235,2.0,221
1078,470,220,48.04208616780046,50.89814058956916,23.0,30.0,279,3.0,250
1079,470,469,48.04208616780046,49.43528344671203,23.0,23.0,60,1.0,1
1080,470,468,48.04208616780046,50.596281179138316,23.0,25.0,110,3.0,2
1081,470,631,48.04208616780046,50.57306122448979,23.0,12.0,194,3.0,161
1082,469,64,49.43528344671203,50.71238095238096,23.0,25.0,409,1.0,405
1083,469,68,49.43528344671203,51.1071201814059,23.0,25.0,407,2.0,401
1084,469,220,49.43528344671203,50.89814058956916,23.0,30.0,257,1.0,249
1085,469,257,49.43528344671203,51.75727891156463,23.0,26.0,234,2.0,212
1086,469,257,49.43528344671203,51.98947845804989,23.0,27.0,239,3.0,212
1087,469,468,49.43528344671203,50.596281179138316,23.0,25.0,50,1.0,1
1088,469,468,49.43528344671203,51.2928798185941,23.0,22.0,80,2.0,1
1089,469,631,49.43528344671203,50.57306122448979,23.0,12.0,169,1.0,162
1090,469,648,49.43528344671203,52.314557823129256,23.0,9.0,218,3.0,179
1091,468,163,50.596281179138316,52.8021768707483,25.0,31.0,319,2.0,305
1092,468,146,50.596281179138316,53.080816326530616,25.0,31.0,339,2.0,322
1093,468,257,50.596281179138316,51.75727891156463,25.0,26.0,217,1.0,211
1094,468,257,50.596281179138316,51.98947845804989,25.0,27.0,219,1.0,211
1095,468,239,50.596281179138316,53.429115646258495,25.0,26.0,259,3.0,229
1096,468,469,50.596281179138316,52.43065759637188,25.0,23.0,79,2.0,1
1097,468,518,50.596281179138316,53.080816326530616,25.0,24.0,118,2.0,50
1098,468,648,50.596281179138316,52.314557823129256,25.0,9.0,195,2.0,180
1099,468,163,51.2928798185941,52.8021768707483,22.0,31.0,312,2.0,305
1100,468,146,51.2928798185941,53.080816326530616,22.0,31.0,331,2.0,322
1101,468,239,51.2928798185941,53.429115646258495,22.0,26.0,247,2.0,229
1102,468,469,51.2928798185941,52.43065759637188,22.0,23.0,49,1.0,1
1103,468,518,51.2928798185941,53.080816326530616,22.0,24.0,92,2.0,50
1104,468,648,51.2928798185941,52.314557823129256,22.0,9.0,185,1.0,180
1105,468,627,51.2928798185941,53.777414965986395,22.0,8.0,192,2.0,159
1106,468,616,51.2928798185941,54.125714285714295,22.0,8.0,192,3.0,148
1107,469,164,52.43065759637188,54.63655328798186,23.0,30.0,319,2.0,305
1108,469,225,52.43065759637188,54.91519274376417,23.0,30.0,266,2.0,244
1109,469,468,52.43065759637188,54.28825396825397,23.0,24.0,80,2.0,1
1110,469,627,52.43065759637188,53.777414965986395,23.0,8.0,168,1.0,158
1111,469,616,52.43065759637188,54.125714285714295,23.0,8.0,164,2.0,147
1112,518,164,53.080816326530616,54.63655328798186,24.0,30.0,360,2.0,354
1113,518,67,53.080816326530616,55.70467120181406,24.0,33.0,465,3.0,451
1114,518,225,53.080816326530616,54.91519274376417,24.0,30.0,303,2.0,293
1115,518,231,53.080816326530616,55.727891156462576,24.0,27.0,309,3.0,287
1116,518,468,53.080816326530616,54.28825396825397,24.0,24.0,72,1.0,50
1117,518,525,53.080816326530616,55.51891156462585,24.0,22.0,105,2.0,7
1118,518,616,53.080816326530616,54.125714285714295,24.0,8.0,108,1.0,98
1119,518,629,53.080816326530616,55.51891156462585,24.0,8.0,153,2.0,111
1120,468,67,54.28825396825397,55.70467120181406,24.0,33.0,406,1.0,401
1121,468,76,54.28825396825397,56.21551020408163,24.0,25.0,401,2.0,392
1122,468,78,54.28825396825397,57.26040816326531,24.0,26.0,410,3.0,390
1123,468,231,54.28825396825397,55.727891156462576,24.0,27.0,245,1.0,237
1124,468,250,54.28825396825397,56.470929705215426,24.0,28.0,237,2.0,218
1125,468,246,54.28825396825397,57.23718820861678,24.0,29.0,256,3.0,222
1126,468,525,54.28825396825397,55.51891156462585,24.0,22.0,78,1.0,57
1127,468,469,54.28825396825397,56.81922902494331,24.0,24.0,109,3.0,1
1128,468,629,54.28825396825397,55.51891156462585,24.0,8.0,169,1.0,161
1129,468,615,54.28825396825397,56.81922902494331,24.0,7.0,183,3.0,147
1130,525,78,55.51891156462585,57.26040816326531,22.0,26.0,453,2.0,447
1131,525,246,55.51891156462585,57.23718820861678,22.0,29.0,289,2.0,279
1132,525,233,55.51891156462585,58.25886621315193,22.0,32.0,315,3.0,292
1133,525,469,55.51891156462585,56.81922902494331,22.0,24.0,79,1.0,56
1134,525,469,55.51891156462585,57.28362811791385,22.0,25.0,94,2.0,56
1135,525,469,55.51891156462585,58.328526077097514,22.0,24.0,133,3.0,56
1136,525,615,55.51891156462585,56.81922902494331,22.0,7.0,106,1.0,90
1137,525,842,55.51891156462585,57.28362811791385,22.0,7.0,326,2.0,317
1138,469,191,56.81922902494331,58.514285714285705,24.0,29.0,287,2.0,278
1139,469,145,56.81922902494331,59.141224489795924,24.0,26.0,339,2.0,324
1140,469,233,56.81922902494331,58.25886621315193,24.0,32.0,244,1.0,236
1141,469,249,56.81922902494331,59.141224489795924,24.0,28.0,242,2.0,220
1142,469,470,56.81922902494331,59.11800453514739,24.0,24.0,99,2.0,1
1143,469,191,57.28362811791385,58.514285714285705,25.0,29.0,283,1.0,278
1144,469,145,57.28362811791385,59.141224489795924,25.0,26.0,334,2.0,324
1145,469,249,57.28362811791385,59.141224489795924,25.0,28.0,234,2.0,220
1146,469,470,57.28362811791385,59.11800453514739,25.0,24.0,79,2.0,1
1147,637,142,3.9473922902494327,6.687346938775511,6.0,30.0,509,3.0,495
1148,637,243,3.9473922902494327,4.96907029478458,6.0,37.0,396,1.0,394
1149,637,243,3.9473922902494327,5.085170068027211,6.0,36.0,397,1.0,394
1150,637,247,3.9473922902494327,6.5712471655328795,6.0,36.0,406,3.0,390
1151,637,486,3.9473922902494327,5.0155102040816315,6.0,19.0,158,1.0,151
1152,637,482,3.9473922902494327,6.106848072562357,6.0,22.0,181,2.0,155
1153,637,645,3.9473922902494327,6.1532879818594095,6.0,9.0,95,2.0,8
1154,630,142,4.945850340136055,6.687346938775511,6.0,30.0,494,2.0,488
1155,630,143,4.945850340136055,7.476825396825397,6.0,29.0,499,3.0,487
1156,630,247,4.945850340136055,6.5712471655328795,6.0,36.0,389,2.0,383
1157,630,244,4.945850340136055,7.7090249433106575,6.0,33.0,404,3.0,386
1158,630,482,4.945850340136055,6.106848072562357,6.0,22.0,156,1.0,148
1159,630,492,4.945850340136055,7.058866213151928,6.0,25.0,165,2.0,138
1160,630,645,4.945850340136055,6.1532879818594095,6.0,9.0,54,1.0,15
1161,630,775,4.945850340136055,7.012426303854876,6.0,7.0,170,2.0,145
1162,645,244,6.1532879818594095,7.7090249433106575,9.0,33.0,407,2.0,401
1163,645,215,6.1532879818594095,8.684263038548753,9.0,36.0,444,3.0,430
1164,645,502,6.1532879818594095,8.196643990929706,9.0,20.0,168,2.0,143
1165,645,812,6.1532879818594095,8.70748299319728,9.0,9.0,200,3.0,167
1166,645,838,6.1532879818594095,8.452063492063493,9.0,9.0,217,2.0,193
1167,775,502,7.012426303854876,8.196643990929706,7.0,20.0,278,1.0,273
1168,775,498,7.012426303854876,9.961360544217689,7.0,22.0,305,3.0,277
1169,775,497,7.012426303854876,9.984580498866212,7.0,22.0,306,3.0,278
1170,775,812,7.012426303854876,8.70748299319728,7.0,9.0,82,2.0,37
1171,775,644,7.012426303854876,9.961360544217689,7.0,13.0,182,3.0,131
1172,775,645,7.012426303854876,9.984580498866212,7.0,11.0,182,3.0,130
1173,775,838,7.012426303854876,8.452063492063493,7.0,9.0,88,1.0,63
1174,775,827,7.012426303854876,9.914920634920636,7.0,8.0,135,3.0,52
1175,812,498,8.70748299319728,9.961360544217689,9.0,22.0,319,1.0,314
1176,812,497,8.70748299319728,9.984580498866212,9.0,22.0,320,1.0,315
1177,812,644,8.70748299319728,9.961360544217689,9.0,13.0,176,1.0,168
1178,812,645,8.70748299319728,9.984580498866212,9.0,11.0,176,1.0,167
1179,812,827,8.70748299319728,9.914920634920636,9.0,8.0,54,1.0,15
1180,644,179,9.961360544217689,11.168798185941043,13.0,28.0,468,1.0,465
1181,644,228,9.961360544217689,11.168798185941043,13.0,34.0,419,1.0,416
1182,644,216,9.961360544217689,11.981496598639454,13.0,32.0,437,2.0,428
1183,644,483,9.961360544217689,11.795736961451249,13.0,21.0,179,2.0,161
1184,644,493,9.961360544217689,12.469115646258507,13.0,22.0,186,3.0,151
1185,644,631,9.961360544217689,11.818956916099776,13.0,11.0,81,2.0,13
1186,644,632,9.961360544217689,12.213696145124715,13.0,9.0,98,2.0,12
1187,644,848,9.961360544217689,11.77251700680272,13.0,6.0,218,2.0,204
1188,645,179,9.984580498866212,11.168798185941043,11.0,28.0,469,1.0,466
1189,645,228,9.984580498866212,11.168798185941043,11.0,34.0,420,1.0,417
1190,645,216,9.984580498866212,11.981496598639454,11.0,32.0,438,2.0,429
1191,645,483,9.984580498866212,11.795736961451249,11.0,21.0,180,2.0,162
1192,645,493,9.984580498866212,12.469115646258507,11.0,22.0,186,2.0,152
1193,645,631,9.984580498866212,11.818956916099776,11.0,11.0,80,2.0,14
1194,645,632,9.984580498866212,12.213696145124715,11.0,9.0,97,2.0,13
1195,645,848,9.984580498866212,11.77251700680272,11.0,6.0,217,2.0,203
1196,631,140,11.818956916099776,13.74621315192744,11.0,27.0,498,2.0,491
1197,631,194,11.818956916099776,14.419591836734696,11.0,30.0,451,3.0,437
1198,631,303,11.818956916099776,13.444353741496599,11.0,30.0,335,2.0,328
1199,631,225,11.818956916099776,14.489251700680272,11.0,37.0,422,3.0,406
1200,631,442,11.818956916099776,13.653333333333334,11.0,21.0,205,2.0,189
1201,631,499,11.818956916099776,14.55891156462585,11.0,24.0,177,3.0,132
1202,631,636,11.818956916099776,13.653333333333334,11.0,11.0,79,2.0,5
1203,632,140,12.213696145124715,13.74621315192744,9.0,27.0,496,2.0,492
1204,632,194,12.213696145124715,14.419591836734696,9.0,30.0,448,2.0,438
1205,632,303,12.213696145124715,13.444353741496599,9.0,30.0,333,1.0,329
1206,632,225,12.213696145124715,14.489251700680272,9.0,37.0,419,2.0,407
1207,632,442,12.213696145124715,13.653333333333334,9.0,21.0,200,1.0,190
1208,632,499,12.213696145124715,14.55891156462585,9.0,24.0,167,2.0,133
1209,632,636,12.213696145124715,13.653333333333334,9.0,11.0,62,1.0,4
1210,636,215,13.653333333333334,15.650249433106575,11.0,36.0,430,2.0,421
1211,636,226,13.653333333333334,16.091428571428573,11.0,32.0,423,2.0,410
1212,636,490,13.653333333333334,15.301950113378684,11.0,19.0,162,2.0,146
1213,636,486,13.653333333333334,16.137868480725626,11.0,23.0,184,2.0,150
1214,616,182,16.99700680272109,18.784943310657603,8.0,29.0,441,2.0,434
1215,616,204,16.99700680272109,19.319002267573694,8.0,28.0,424,2.0,412
1216,616,243,16.99700680272109,18.784943310657603,8.0,33.0,381,2.0,373
1217,616,205,16.99700680272109,19.295782312925173,8.0,32.0,423,2.0,411
1218,616,515,16.99700680272109,18.22766439909297,8.0,19.0,114,1.0,101
1219,616,469,16.99700680272109,19.899501133786853,8.0,24.0,193,3.0,147
1220,616,807,16.99700680272109,19.899501133786853,8.0,7.0,228,3.0,191
1221,807,328,19.899501133786853,20.967619047619053,7.0,30.0,481,1.0,479
1222,807,308,19.899501133786853,22.63945578231293,7.0,29.0,513,3.0,499
1223,807,468,19.899501133786853,21.40879818594105,7.0,23.0,345,2.0,339
1224,807,469,19.899501133786853,22.19827664399093,7.0,22.0,352,2.0,338
1225,807,637,19.899501133786853,22.15183673469388,7.0,13.0,196,2.0,170
1226,807,841,19.899501133786853,21.757097505668934,7.0,9.0,87,2.0,34
1227,807,858,19.899501133786853,22.15183673469388,7.0,7.0,110,2.0,51
1228,637,249,22.15183673469388,23.591473922902487,13.0,27.0,393,1.0,388
1229,637,327,22.15183673469388,24.636371882086173,13.0,29.0,328,2.0,310
1230,637,469,22.15183673469388,23.591473922902487,13.0,24.0,179,1.0,168
1231,637,469,22.15183673469388,24.05587301587301,13.0,25.0,187,2.0,168
1232,637,825,22.15183673469388,23.243174603174605,13.0,7.0,194,1.0,188
1233,637,842,22.15183673469388,24.05587301587301,13.0,6.0,221,2.0,205
1234,615,144,26.493968253968248,27.747845804988664,13.0,23.0,474,1.0,471
1235,615,144,26.493968253968248,28.792743764172336,13.0,23.0,481,2.0,471
1236,615,129,26.493968253968248,29.41968253968254,13.0,28.0,502,3.0,486
1237,615,249,26.493968253968248,27.747845804988664,13.0,28.0,370,1.0,366
1238,615,311,26.493968253968248,28.258684807256238,13.0,28.0,313,2.0,304
1239,615,249,26.493968253968248,29.141043083900232,13.0,27.0,383,3.0,366
1240,615,469,26.493968253968248,28.44444444444445,13.0,23.0,168,2.0,146
1241,615,626,26.493968253968248,28.630204081632648,13.0,7.0,93,2.0,11
1242,808,469,27.28344671201814,28.44444444444445,8.0,23.0,343,1.0,339
1243,808,469,27.28344671201814,29.582222222222228,8.0,23.0,353,2.0,339
1244,808,626,27.28344671201814,28.630204081632648,8.0,7.0,191,1.0,182
1245,626,249,28.630204081632648,30.97541950113379,7.0,27.0,390,2.0,377
1246,626,249,28.630204081632648,31.43981859410431,7.0,28.0,396,3.0,377
1247,626,469,28.630204081632648,30.627120181405893,7.0,23.0,179,2.0,157
1248,626,469,28.630204081632648,31.43981859410431,7.0,23.0,198,3.0,157
1249,626,853,28.630204081632648,30.627120181405893,7.0,6.0,243,2.0,227
1250,628,243,31.695238095238093,33.2974149659864,8.0,29.0,391,2.0,385
1251,628,214,31.695238095238093,34.574512471655325,8.0,28.0,432,3.0,414
1252,628,469,31.695238095238093,32.80979591836735,8.0,22.0,166,1.0,159
1253,628,484,31.695238095238093,33.529614512471646,8.0,21.0,164,2.0,144
1254,628,470,31.695238095238093,34.66739229024943,8.0,23.0,203,3.0,158
1255,628,804,31.695238095238093,32.80979591836735,8.0,6.0,182,1.0,176
1256,628,846,31.695238095238093,34.319092970521545,8.0,6.0,246,3.0,218
1257,804,470,32.80979591836735,34.66739229024943,6.0,23.0,343,2.0,334
1258,804,469,32.80979591836735,35.131791383219955,6.0,24.0,350,2.0,335
1259,804,627,32.80979591836735,34.69061224489796,6.0,7.0,195,2.0,177
1260,804,627,32.80979591836735,35.15501133786848,6.0,8.0,204,2.0,177
1261,804,846,32.80979591836735,34.319092970521545,6.0,6.0,77,2.0,42
1262,627,146,34.69061224489796,35.898049886621315,7.0,26.0,484,1.0,481
1263,627,213,34.69061224489796,36.43210884353741,7.0,27.0,421,2.0,414
1264,627,249,34.69061224489796,36.98938775510205,7.0,26.0,391,2.0,378
1265,627,469,34.69061224489796,36.176689342403634,7.0,23.0,170,1.0,158
1266,627,460,34.69061224489796,36.98938775510205,7.0,22.0,194,2.0,167
1267,627,846,34.69061224489796,36.176689342403634,7.0,6.0,228,1.0,219
1268,627,213,35.15501133786848,36.43210884353741,8.0,27.0,418,1.0,414
1269,627,249,35.15501133786848,36.98938775510205,8.0,26.0,386,2.0,378
1270,627,469,35.15501133786848,36.176689342403634,8.0,23.0,164,1.0,158
1271,627,460,35.15501133786848,36.98938775510205,8.0,22.0,185,2.0,167
1272,627,846,35.15501133786848,36.176689342403634,8.0,6.0,223,1.0,219
1273,627,214,36.52498866213153,38.26648526077098,6.0,28.0,420,2.0,413
1274,627,213,36.52498866213153,39.19528344671202,6.0,28.0,430,3.0,414
1275,627,469,36.52498866213153,38.35936507936508,6.0,23.0,177,2.0,158
1276,627,214,36.98938775510205,38.26648526077098,7.0,28.0,417,1.0,413
1277,627,213,36.98938775510205,39.19528344671202,7.0,28.0,425,2.0,414
1278,627,469,36.98938775510205,38.35936507936508,7.0,23.0,169,1.0,158
1279,627,469,36.98938775510205,39.86866213151927,7.0,23.0,201,3.0,158
1280,627,214,38.35936507936508,40.124081632653066,7.0,28.0,420,2.0,413
1281,627,469,38.35936507936508,39.86866213151927,7.0,23.0,171,2.0,158
1282,627,469,38.35936507936508,40.21696145124717,7.0,24.0,177,2.0,158
1283,627,185,39.86866213151927,42.44607709750567,8.0,27.0,456,3.0,442
1284,627,215,39.86866213151927,41.958458049886616,8.0,28.0,422,2.0,412
1285,627,249,39.86866213151927,42.05133786848072,8.0,27.0,390,2.0,378
1286,627,469,39.86866213151927,41.70303854875284,8.0,24.0,177,2.0,158
1287,627,469,39.86866213151927,42.05133786848072,8.0,24.0,184,2.0,158
1288,627,185,40.68136054421769,42.44607709750567,8.0,27.0,448,2.0,442
1289,627,215,40.68136054421769,41.958458049886616,8.0,28.0,416,1.0,412
1290,627,249,40.68136054421769,42.05133786848072,8.0,27.0,383,1.0,378
1291,627,469,40.68136054421769,41.70303854875284,8.0,24.0,164,1.0,158
1292,627,469,40.68136054421769,42.05133786848072,8.0,24.0,169,1.0,158
1293,627,213,42.05133786848072,43.81605442176871,8.0,28.0,421,2.0,414
1294,627,249,42.05133786848072,44.37333333333334,8.0,25.0,391,2.0,378
1295,627,470,42.05133786848072,43.90893424036282,8.0,23.0,176,2.0,157
1296,627,470,42.05133786848072,44.35011337868482,8.0,22.0,186,2.0,157
1297,627,142,43.560634920634925,45.39501133786848,7.0,32.0,491,2.0,485
1298,627,213,43.560634920634925,45.650430839002276,7.0,29.0,424,2.0,414
1299,627,470,43.560634920634925,45.743310657596375,7.0,24.0,183,2.0,157
1300,627,469,43.560634920634925,46.20770975056689,7.0,24.0,195,3.0,158
1301,627,631,43.560634920634925,45.7665306122449,7.0,7.0,95,2.0,4
1302,627,632,43.560634920634925,46.46312925170068,7.0,6.0,125,3.0,5
1303,631,142,45.7665306122449,47.20616780045352,7.0,29.0,493,1.0,489
1304,631,231,45.7665306122449,47.25260770975056,7.0,29.0,405,1.0,400
1305,631,469,45.7665306122449,47.60090702947846,7.0,22.0,180,2.0,162
1306,631,470,45.7665306122449,48.04208616780046,7.0,23.0,188,2.0,161
1307,631,637,45.7665306122449,48.4368253968254,7.0,10.0,115,3.0,6
1308,632,181,46.46312925170068,48.785124716553284,6.0,26.0,462,2.0,451
1309,632,250,46.46312925170068,48.76190476190477,6.0,27.0,395,2.0,382
1310,632,469,46.46312925170068,47.60090702947846,6.0,22.0,170,1.0,163
1311,632,470,46.46312925170068,48.04208616780046,6.0,23.0,176,2.0,162
1312,632,469,46.46312925170068,49.43528344671203,6.0,23.0,207,3.0,163
1313,632,637,46.46312925170068,48.4368253968254,6.0,10.0,85,2.0,5
1314,637,249,48.4368253968254,49.899682539682544,10.0,28.0,393,1.0,388
1315,637,220,48.4368253968254,50.89814058956916,10.0,30.0,430,2.0,417
1316,637,468,48.4368253968254,50.596281179138316,10.0,25.0,193,2.0,169
1317,637,468,48.4368253968254,51.2928798185941,10.0,22.0,209,3.0,169
1318,637,631,48.4368253968254,50.57306122448979,10.0,12.0,92,2.0,6
1319,631,163,50.57306122448979,52.8021768707483,12.0,31.0,478,2.0,468
1320,631,146,50.57306122448979,53.080816326530616,12.0,31.0,497,3.0,485
1321,631,257,50.57306122448979,51.75727891156463,12.0,26.0,377,1.0,374
1322,631,257,50.57306122448979,51.98947845804989,12.0,27.0,379,1.0,374
1323,631,239,50.57306122448979,53.429115646258495,12.0,26.0,411,3.0,392
1324,631,469,50.57306122448979,52.43065759637188,12.0,23.0,181,2.0,162
1325,631,518,50.57306122448979,53.080816326530616,12.0,24.0,156,3.0,113
1326,631,648,50.57306122448979,52.314557823129256,12.0,9.0,77,2.0,17
1327,648,164,52.314557823129256,54.63655328798186,9.0,30.0,494,2.0,484
1328,648,239,52.314557823129256,53.429115646258495,9.0,26.0,412,1.0,409
1329,648,225,52.314557823129256,54.91519274376417,9.0,30.0,438,3.0,423
1330,648,468,52.314557823129256,54.28825396825397,9.0,24.0,199,2.0,180
1331,648,627,52.314557823129256,53.777414965986395,9.0,8.0,66,1.0,21
1332,648,616,52.314557823129256,54.125714285714295,9.0,8.0,84,2.0,32
1333,627,225,53.777414965986395,54.91519274376417,8.0,30.0,405,1.0,402
1334,627,231,53.777414965986395,55.727891156462576,8.0,27.0,405,2.0,396
1335,627,250,53.777414965986395,56.470929705215426,8.0,28.0,394,3.0,377
1336,627,525,53.777414965986395,55.51891156462585,8.0,22.0,127,2.0,102
1337,627,629,53.777414965986395,55.51891156462585,8.0,8.0,75,2.0,2
1338,616,231,54.125714285714295,55.727891156462576,8.0,27.0,391,2.0,385
1339,616,250,54.125714285714295,56.470929705215426,8.0,28.0,380,2.0,366
1340,616,525,54.125714285714295,55.51891156462585,8.0,22.0,109,1.0,91
1341,616,469,54.125714285714295,56.81922902494331,8.0,24.0,187,3.0,147
1342,616,629,54.125714285714295,55.51891156462585,8.0,8.0,61,1.0,13
1343,616,615,54.125714285714295,56.81922902494331,8.0,7.0,116,3.0,1
1344,629,246,55.51891156462585,57.23718820861678,8.0,29.0,390,2.0,383
1345,629,233,55.51891156462585,58.25886621315193,8.0,32.0,413,3.0,396
1346,629,469,55.51891156462585,56.81922902494331,8.0,24.0,170,1.0,160
1347,629,469,55.51891156462585,57.28362811791385,8.0,25.0,177,2.0,160
1348,629,469,55.51891156462585,58.328526077097514,8.0,24.0,201,3.0,160
1349,629,615,55.51891156462585,56.81922902494331,8.0,7.0,58,1.0,14
1350,629,842,55.51891156462585,57.28362811791385,8.0,7.0,226,2.0,213
1351,615,191,56.81922902494331,58.514285714285705,7.0,29.0,430,2.0,424
1352,615,145,56.81922902494331,59.141224489795924,7.0,26.0,481,2.0,470
1353,615,233,56.81922902494331,58.25886621315193,7.0,32.0,387,1.0,382
1354,615,249,56.81922902494331,59.141224489795924,7.0,28.0,379,2.0,366
1355,615,469,56.81922902494331,58.328526077097514,7.0,24.0,160,2.0,146
1356,615,470,56.81922902494331,59.11800453514739,7.0,24.0,176,2.0,145
1357,838,498,8.452063492063493,9.961360544217689,9.0,22.0,346,2.0,340
1358,838,497,8.452063492063493,9.984580498866212,9.0,22.0,347,2.0,341
1359,838,644,8.452063492063493,9.961360544217689,9.0,13.0,205,2.0,194
1360,838,645,8.452063492063493,9.984580498866212,9.0,11.0,204,2.0,193
1361,838,827,8.452063492063493,9.914920634920636,9.0,8.0,64,1.0,11
1362,827,483,9.914920634920636,11.795736961451249,8.0,21.0,353,2.0,344
1363,827,493,9.914920634920636,12.469115646258507,8.0,22.0,352,3.0,334
1364,827,631,9.914920634920636,11.818956916099776,8.0,11.0,212,2.0,196
1365,827,632,9.914920634920636,12.213696145124715,8.0,9.0,219,2.0,195
1366,827,848,9.914920634920636,11.77251700680272,8.0,6.0,83,2.0,21
1367,848,442,11.77251700680272,13.653333333333334,6.0,21.0,414,2.0,406
1368,848,499,11.77251700680272,14.55891156462585,6.0,24.0,369,3.0,349
1369,848,636,11.77251700680272,13.653333333333334,6.0,11.0,227,2.0,212
1370,841,469,21.757097505668934,23.591473922902487,9.0,24.0,380,2.0,372
1371,841,469,21.757097505668934,24.05587301587301,9.0,25.0,385,2.0,372
1372,841,825,21.757097505668934,23.243174603174605,9.0,7.0,66,1.0,16
1373,841,842,21.757097505668934,24.05587301587301,9.0,6.0,99,2.0,1
1374,858,469,22.15183673469388,23.591473922902487,7.0,24.0,394,1.0,389
1375,858,469,22.15183673469388,24.05587301587301,7.0,25.0,398,2.0,389
1376,858,825,22.15183673469388,23.243174603174605,7.0,7.0,57,1.0,33
1377,858,842,22.15183673469388,24.05587301587301,7.0,6.0,84,2.0,16
1378,825,327,23.243174603174605,24.636371882086173,7.0,29.0,502,1.0,498
1379,825,469,23.243174603174605,25.890249433106572,7.0,23.0,374,3.0,356
1380,842,469,24.05587301587301,25.890249433106572,6.0,23.0,381,2.0,373
1381,842,469,24.05587301587301,26.935147392290247,6.0,23.0,393,3.0,373
1382,842,615,24.05587301587301,26.493968253968248,6.0,13.0,250,2.0,227
1383,842,827,24.05587301587301,26.51718820861678,6.0,7.0,107,2.0,15
1384,827,469,26.51718820861678,28.44444444444445,7.0,23.0,367,2.0,358
1385,827,626,26.51718820861678,28.630204081632648,7.0,7.0,221,2.0,201
1386,853,469,30.627120181405893,32.80979591836735,6.0,22.0,395,2.0,384
1387,853,484,30.627120181405893,33.529614512471646,6.0,21.0,390,3.0,369
1388,853,628,30.627120181405893,31.695238095238093,6.0,8.0,230,1.0,225
1389,853,804,30.627120181405893,32.80979591836735,6.0,6.0,106,2.0,49
1390,846,469,34.319092970521545,36.176689342403634,6.0,23.0,385,2.0,377
1391,846,460,34.319092970521545,36.98938775510205,6.0,22.0,403,3.0,386
1392,846,627,34.319092970521545,36.52498866213153,6.0,6.0,239,2.0,219
1393,846,627,34.319092970521545,36.98938775510205,6.0,7.0,247,3.0,219
1394,846,469,36.176689342403634,38.35936507936508,6.0,23.0,389,2.0,377
1395,846,627,36.176689342403634,38.35936507936508,6.0,7.0,238,2.0,219
1396,842,469,57.28362811791385,58.328526077097514,7.0,24.0,376,1.0,373
1397,842,470,57.28362811791385,59.11800453514739,7.0,24.0,380,2.0,372
